county,time,date,cases,est_cases,est_omicron_cases,est_other_cases,tests,est_tests,est_omicron_tests,est_other_tests,hospitalizations
Alameda,0.42857142857142855,2021-12-16,883,897,303,594,44595,45336,14856,30480,104
Amador,0.42857142857142855,2021-12-16,16,16,6,10,916,931,303,628,8
Butte,0.42857142857142855,2021-12-16,72,73,24,49,2078,2113,685,1428,30
Calaveras,0.42857142857142855,2021-12-16,25,25,8,17,842,856,282,574,4
Colusa,0.42857142857142855,2021-12-16,5,5,2,3,238,243,88,155,0
Contra Costa,0.42857142857142855,2021-12-16,537,546,189,357,21559,21918,7280,14638,45
Del Norte,0.42857142857142855,2021-12-16,8,8,2,6,655,667,221,446,0
El Dorado,0.42857142857142855,2021-12-16,88,90,31,59,2101,2136,717,1419,12
Fresno,0.42857142857142855,2021-12-16,439,446,147,299,13427,13649,4474,9175,207
Glenn,0.42857142857142855,2021-12-16,6,6,2,4,153,156,51,105,0
Humboldt,0.42857142857142855,2021-12-16,64,64,21,43,1984,2017,684,1333,13
Imperial,0.42857142857142855,2021-12-16,219,222,74,148,2958,3008,1003,2005,63
Inyo,0.42857142857142855,2021-12-16,6,6,2,4,166,169,58,111,1
Kern,0.42857142857142855,2021-12-16,399,405,136,269,14789,15034,5022,10012,122
Kings,0.42857142857142855,2021-12-16,109,111,36,75,3870,3933,1272,2661,20
Lake,0.42857142857142855,2021-12-16,21,21,8,13,666,677,219,458,0
Lassen,0.42857142857142855,2021-12-16,2,2,1,1,988,1004,346,658,0
Los Angeles,0.42857142857142855,2021-12-16,10156,10325,3546,6779,594422,604310,203537,400773,824
Madera,0.42857142857142855,2021-12-16,72,72,23,49,3319,3373,1096,2277,20
Marin,0.42857142857142855,2021-12-16,166,169,56,113,5624,5718,1925,3793,14
Mariposa,0.42857142857142855,2021-12-16,9,9,3,6,224,227,77,150,0
Mendocino,0.42857142857142855,2021-12-16,44,44,14,30,1382,1405,463,942,5
Merced,0.42857142857142855,2021-12-16,124,127,43,84,2670,2714,888,1826,25
Modoc,0.42857142857142855,2021-12-16,1,1,0,1,31,31,11,20,3
Mono,0.42857142857142855,2021-12-16,10,10,3,7,135,138,48,90,0
Monterey,0.42857142857142855,2021-12-16,162,165,55,110,5621,5714,1882,3832,21
Napa,0.42857142857142855,2021-12-16,70,70,25,45,2961,3010,981,2029,6
Nevada,0.42857142857142855,2021-12-16,67,67,23,44,1263,1284,435,849,6
Orange,0.42857142857142855,2021-12-16,1570,1596,542,1054,48965,49780,16759,33021,208
Placer,0.42857142857142855,2021-12-16,190,193,64,129,5434,5525,1851,3674,100
Plumas,0.42857142857142855,2021-12-16,12,12,4,8,244,247,81,166,1
Riverside,0.42857142857142855,2021-12-16,1959,1991,676,1315,38307,38944,13010,25934,327
Sacramento,0.42857142857142855,2021-12-16,877,891,299,592,27964,28429,9413,19016,155
San Benito,0.42857142857142855,2021-12-16,40,40,14,26,1043,1061,352,709,6
San Bernardino,0.42857142857142855,2021-12-16,1704,1732,574,1158,40806,41485,13782,27703,415
San Diego,0.42857142857142855,2021-12-16,3149,3201,1101,2100,71896,73091,24281,48810,384
San Francisco,0.42857142857142855,2021-12-16,878,892,302,590,26140,26575,8916,17659,48
San Joaquin,0.42857142857142855,2021-12-16,403,410,140,270,14390,14628,4724,9904,85
San Luis Obispo,0.42857142857142855,2021-12-16,153,156,52,104,5132,5218,1731,3487,15
San Mateo,0.42857142857142855,2021-12-16,409,415,136,279,25041,25457,8440,17017,25
Santa Barbara,0.42857142857142855,2021-12-16,263,267,89,178,7998,8130,2670,5460,40
Santa Clara,0.42857142857142855,2021-12-16,892,906,306,600,63936,64997,21389,43608,140
Santa Cruz,0.42857142857142855,2021-12-16,159,162,53,109,12062,12262,4023,8239,12
Shasta,0.42857142857142855,2021-12-16,62,62,20,42,3457,3514,1116,2398,32
Siskiyou,0.42857142857142855,2021-12-16,10,10,3,7,250,254,77,177,4
Solano,0.42857142857142855,2021-12-16,176,179,60,119,7400,7523,2454,5069,48
Sonoma,0.42857142857142855,2021-12-16,261,265,87,178,11763,11959,3900,8059,31
Stanislaus,0.42857142857142855,2021-12-16,310,315,105,210,7173,7292,2359,4933,120
Sutter,0.42857142857142855,2021-12-16,39,39,14,25,1157,1176,377,799,0
Tehama,0.42857142857142855,2021-12-16,23,23,7,16,721,733,245,488,8
Trinity,0.42857142857142855,2021-12-16,1,1,0,1,55,55,18,37,0
Tulare,0.42857142857142855,2021-12-16,180,183,61,122,6456,6563,2142,4421,60
Tuolumne,0.42857142857142855,2021-12-16,32,32,11,21,1007,1024,345,679,6
Ventura,0.42857142857142855,2021-12-16,660,672,223,449,19568,19892,6563,13329,76
Yolo,0.42857142857142855,2021-12-16,107,109,35,74,13066,13283,4394,8889,2
Yuba,0.42857142857142855,2021-12-16,45,45,14,31,917,932,311,621,13
Alameda,0.8571428571428571,2021-12-19,1055,1074,646,428,24039,24464,14011,10453,92
Amador,0.8571428571428571,2021-12-19,21,21,12,9,428,436,251,185,4
Butte,0.8571428571428571,2021-12-19,55,55,33,22,1180,1201,698,503,25
Calaveras,0.8571428571428571,2021-12-19,19,19,11,8,383,389,218,171,1
Colusa,0.8571428571428571,2021-12-19,3,3,2,1,97,98,55,43,0
Contra Costa,0.8571428571428571,2021-12-19,620,632,377,255,12136,12351,7153,5198,46
Del Norte,0.8571428571428571,2021-12-19,7,7,4,3,439,447,260,187,0
El Dorado,0.8571428571428571,2021-12-19,91,93,55,38,1348,1372,777,595,9
Fresno,0.8571428571428571,2021-12-19,363,370,217,153,7350,7480,4309,3171,189
Glenn,0.8571428571428571,2021-12-19,8,8,5,3,115,117,68,49,0
Humboldt,0.8571428571428571,2021-12-19,59,59,35,24,992,1010,588,422,13
Imperial,0.8571428571428571,2021-12-19,205,208,123,85,1519,1545,888,657,64
Inyo,0.8571428571428571,2021-12-19,15,15,9,6,94,96,55,41,1
Kern,0.8571428571428571,2021-12-19,319,325,191,134,6777,6897,3970,2927,120
Kings,0.8571428571428571,2021-12-19,70,71,43,28,1724,1754,998,756,19
Lake,0.8571428571428571,2021-12-19,9,9,5,4,384,391,222,169,0
Lassen,0.8571428571428571,2021-12-19,5,5,3,2,844,860,504,356,0
Los Angeles,0.8571428571428571,2021-12-19,11806,12016,7178,4838,257652,262190,146945,115245,822
Madera,0.8571428571428571,2021-12-19,58,58,34,24,1484,1511,853,658,18
Marin,0.8571428571428571,2021-12-19,219,223,138,85,3853,3921,2290,1631,9
Mariposa,0.8571428571428571,2021-12-19,8,8,5,3,160,163,92,71,0
Mendocino,0.8571428571428571,2021-12-19,28,28,16,12,767,781,455,326,5
Merced,0.8571428571428571,2021-12-19,99,101,60,41,1376,1401,798,603,22
Modoc,0.8571428571428571,2021-12-19,2,2,1,1,9,9,5,4,2
Mono,0.8571428571428571,2021-12-19,12,12,6,6,128,130,72,58,1
Monterey,0.8571428571428571,2021-12-19,138,141,82,59,2945,2997,1707,1290,29
Napa,0.8571428571428571,2021-12-19,84,85,50,35,1387,1412,801,611,3
Nevada,0.8571428571428571,2021-12-19,58,58,34,24,719,731,413,318,6
Orange,0.8571428571428571,2021-12-19,1790,1822,1096,726,30287,30824,17827,12997,206
Placer,0.8571428571428571,2021-12-19,228,232,141,91,3224,3281,1902,1379,90
Plumas,0.8571428571428571,2021-12-19,1,1,1,0,101,102,55,47,0
Riverside,0.8571428571428571,2021-12-19,2121,2158,1284,874,23976,24402,14229,10173,338
Sacramento,0.8571428571428571,2021-12-19,741,754,448,306,14832,15095,8716,6379,149
San Benito,0.8571428571428571,2021-12-19,24,24,15,9,420,428,253,175,5
San Bernardino,0.8571428571428571,2021-12-19,1792,1823,1092,731,22492,22889,13125,9764,423
San Diego,0.8571428571428571,2021-12-19,3008,3062,1813,1249,47715,48560,28289,20271,374
San Francisco,0.8571428571428571,2021-12-19,1154,1175,714,461,17813,18129,10489,7640,42
San Joaquin,0.8571428571428571,2021-12-19,275,280,166,114,5742,5843,3313,2530,80
San Luis Obispo,0.8571428571428571,2021-12-19,134,136,79,57,2438,2481,1399,1082,16
San Mateo,0.8571428571428571,2021-12-19,558,568,342,226,12501,12723,7347,5376,22
Santa Barbara,0.8571428571428571,2021-12-19,292,297,176,121,4732,4815,2758,2057,33
Santa Clara,0.8571428571428571,2021-12-19,1151,1172,712,460,34839,35456,20527,14929,149
Santa Cruz,0.8571428571428571,2021-12-19,145,148,89,59,4943,5030,2752,2278,16
Shasta,0.8571428571428571,2021-12-19,64,65,38,27,1102,1122,633,489,38
Siskiyou,0.8571428571428571,2021-12-19,7,7,4,3,106,109,65,44,4
Solano,0.8571428571428571,2021-12-19,176,179,106,73,3721,3787,2162,1625,37
Sonoma,0.8571428571428571,2021-12-19,304,310,187,123,5237,5330,3079,2251,35
Stanislaus,0.8571428571428571,2021-12-19,216,219,131,88,3333,3392,1975,1417,124
Sutter,0.8571428571428571,2021-12-19,42,42,26,16,656,668,387,281,0
Tehama,0.8571428571428571,2021-12-19,20,20,12,8,312,317,181,136,8
Trinity,0.8571428571428571,2021-12-19,0,0,0,0,27,27,16,11,0
Tulare,0.8571428571428571,2021-12-19,126,129,76,53,2862,2912,1663,1249,58
Tuolumne,0.8571428571428571,2021-12-19,44,44,26,18,550,560,326,234,7
Ventura,0.8571428571428571,2021-12-19,798,812,488,324,11169,11367,6546,4821,86
Yolo,0.8571428571428571,2021-12-19,118,121,72,49,7832,7970,4529,3441,6
Yuba,0.8571428571428571,2021-12-19,37,37,22,15,555,565,326,239,8
Alameda,1.2857142857142858,2021-12-22,2667,2719,2113,606,48835,49779,38679,11100,92
Amador,1.2857142857142858,2021-12-22,35,35,27,8,985,1005,777,228,6
Butte,1.2857142857142858,2021-12-22,176,179,139,40,2369,2414,1865,549,29
Calaveras,1.2857142857142858,2021-12-22,39,39,30,9,684,697,537,160,1
Colusa,1.2857142857142858,2021-12-22,4,4,3,1,169,172,134,38,2
Contra Costa,1.2857142857142858,2021-12-22,1547,1577,1227,350,25777,26274,20388,5886,56
Del Norte,1.2857142857142858,2021-12-22,7,7,5,2,709,722,557,165,0
El Dorado,1.2857142857142858,2021-12-22,174,177,138,39,2687,2738,2117,621,10
Fresno,1.2857142857142858,2021-12-22,726,740,575,165,13712,13976,10829,3147,170
Glenn,1.2857142857142858,2021-12-22,27,27,21,6,312,318,243,75,0
Humboldt,1.2857142857142858,2021-12-22,148,151,118,33,2166,2208,1711,497,9
Imperial,1.2857142857142858,2021-12-22,326,332,256,76,3239,3300,2544,756,62
Inyo,1.2857142857142858,2021-12-22,24,24,19,5,256,261,202,59,2
Kern,1.2857142857142858,2021-12-22,595,607,471,136,11932,12162,9380,2782,106
Kings,1.2857142857142858,2021-12-22,158,161,125,36,3429,3496,2691,805,21
Lake,1.2857142857142858,2021-12-22,19,19,15,4,731,745,579,166,0
Lassen,1.2857142857142858,2021-12-22,8,8,6,2,1135,1156,884,272,1
Los Angeles,1.2857142857142858,2021-12-22,33347,33993,26560,7433,406654,414513,322244,92269,912
Madera,1.2857142857142858,2021-12-22,89,91,71,20,2593,2643,2024,619,20
Marin,1.2857142857142858,2021-12-22,540,550,426,124,7598,7744,6027,1717,10
Mariposa,1.2857142857142858,2021-12-22,16,16,12,4,303,308,241,67,0
Mendocino,1.2857142857142858,2021-12-22,45,45,35,10,1699,1732,1343,389,3
Merced,1.2857142857142858,2021-12-22,223,227,175,52,3156,3217,2467,750,20
Modoc,1.2857142857142858,2021-12-22,3,3,2,1,46,47,36,11,3
Mono,1.2857142857142858,2021-12-22,51,52,41,11,296,302,237,65,1
Monterey,1.2857142857142858,2021-12-22,200,203,157,46,5226,5326,4125,1201,28
Napa,1.2857142857142858,2021-12-22,252,257,200,57,3195,3257,2536,721,3
Nevada,1.2857142857142858,2021-12-22,104,107,83,24,1806,1840,1414,426,6
Orange,1.2857142857142858,2021-12-22,4967,5063,3955,1108,60614,61785,48025,13760,227
Placer,1.2857142857142858,2021-12-22,375,382,297,85,6316,6437,4968,1469,92
Plumas,1.2857142857142858,2021-12-22,5,5,4,1,276,281,215,66,0
Riverside,1.2857142857142858,2021-12-22,4526,4614,3588,1026,45496,46374,35933,10441,393
Sacramento,1.2857142857142858,2021-12-22,1627,1659,1291,368,29204,29767,23031,6736,177
San Benito,1.2857142857142858,2021-12-22,110,112,88,24,1311,1337,1037,300,2
San Bernardino,1.2857142857142858,2021-12-22,4221,4303,3349,954,50501,51476,39952,11524,447
San Diego,1.2857142857142858,2021-12-22,9317,9498,7413,2085,95842,97694,75898,21796,373
San Francisco,1.2857142857142858,2021-12-22,2782,2836,2201,635,34474,35140,27331,7809,51
San Joaquin,1.2857142857142858,2021-12-22,782,798,620,178,13220,13475,10397,3078,65
San Luis Obispo,1.2857142857142858,2021-12-22,378,385,301,84,6831,6963,5383,1580,21
San Mateo,1.2857142857142858,2021-12-22,1324,1350,1051,299,24372,24843,19302,5541,31
Santa Barbara,1.2857142857142858,2021-12-22,646,658,510,148,8681,8849,6852,1997,32
Santa Clara,1.2857142857142858,2021-12-22,2856,2912,2262,650,57987,59108,45893,13215,128
Santa Cruz,1.2857142857142858,2021-12-22,294,300,233,67,8502,8667,6742,1925,16
Shasta,1.2857142857142858,2021-12-22,87,89,69,20,3443,3509,2700,809,35
Siskiyou,1.2857142857142858,2021-12-22,5,5,4,1,194,198,152,46,0
Solano,1.2857142857142858,2021-12-22,395,402,313,89,8763,8932,6919,2013,41
Sonoma,1.2857142857142858,2021-12-22,586,597,465,132,11633,11857,9200,2657,28
Stanislaus,1.2857142857142858,2021-12-22,412,420,326,94,6319,6440,4972,1468,115
Sutter,1.2857142857142858,2021-12-22,84,85,65,20,1176,1199,924,275,0
Tehama,1.2857142857142858,2021-12-22,23,23,18,5,724,738,571,167,12
Trinity,1.2857142857142858,2021-12-22,0,0,0,0,62,63,49,14,0
Tulare,1.2857142857142858,2021-12-22,267,273,211,62,7030,7166,5503,1663,43
Tuolumne,1.2857142857142858,2021-12-22,53,53,41,12,1070,1091,844,247,8
Ventura,1.2857142857142858,2021-12-22,1688,1721,1336,385,20853,21255,16421,4834,80
Yolo,1.2857142857142858,2021-12-22,266,271,211,60,13766,14032,10958,3074,7
Yuba,1.2857142857142858,2021-12-22,49,49,38,11,934,952,733,219,8
Alameda,1.7142857142857142,2021-12-25,2081,2125,1825,300,22935,23409,19932,3477,117
Amador,1.7142857142857142,2021-12-25,32,32,27,5,390,398,340,58,4
Butte,1.7142857142857142,2021-12-25,151,154,133,21,1124,1147,977,170,31
Calaveras,1.7142857142857142,2021-12-25,25,25,21,4,215,219,187,32,2
Colusa,1.7142857142857142,2021-12-25,8,8,7,1,45,46,39,7,2
Contra Costa,1.7142857142857142,2021-12-25,1236,1262,1082,180,13013,13282,11313,1969,66
Del Norte,1.7142857142857142,2021-12-25,10,10,9,1,411,420,359,61,0
El Dorado,1.7142857142857142,2021-12-25,159,162,139,23,1138,1162,987,175,12
Fresno,1.7142857142857142,2021-12-25,597,609,523,86,7189,7339,6258,1081,168
Glenn,1.7142857142857142,2021-12-25,10,10,9,1,78,80,69,11,0
Humboldt,1.7142857142857142,2021-12-25,169,172,148,24,670,684,581,103,11
Imperial,1.7142857142857142,2021-12-25,225,230,198,32,1834,1872,1597,275,51
Inyo,1.7142857142857142,2021-12-25,50,50,43,7,140,143,122,21,0
Kern,1.7142857142857142,2021-12-25,503,514,441,73,6173,6301,5377,924,99
Kings,1.7142857142857142,2021-12-25,137,140,121,19,1590,1623,1384,239,20
Lake,1.7142857142857142,2021-12-25,20,20,17,3,323,330,281,49,0
Lassen,1.7142857142857142,2021-12-25,8,8,7,1,937,957,819,138,0
Los Angeles,1.7142857142857142,2021-12-25,25892,26431,22601,3830,203058,207260,176567,30693,1005
Madera,1.7142857142857142,2021-12-25,103,106,91,15,1293,1320,1125,195,18
Marin,1.7142857142857142,2021-12-25,487,497,427,70,5440,5553,4726,827,6
Mariposa,1.7142857142857142,2021-12-25,14,14,12,2,176,179,151,28,0
Mendocino,1.7142857142857142,2021-12-25,32,32,28,4,589,600,510,90,6
Merced,1.7142857142857142,2021-12-25,161,164,141,23,1384,1412,1203,209,18
Modoc,1.7142857142857142,2021-12-25,0,0,0,0,10,10,9,1,2
Mono,1.7142857142857142,2021-12-25,10,10,9,1,56,57,48,9,1
Monterey,1.7142857142857142,2021-12-25,217,221,190,31,2243,2290,1953,337,36
Napa,1.7142857142857142,2021-12-25,271,277,237,40,2097,2140,1822,318,5
Nevada,1.7142857142857142,2021-12-25,77,79,68,11,573,585,498,87,6
Orange,1.7142857142857142,2021-12-25,4817,4917,4213,704,36989,37756,32187,5569,274
Placer,1.7142857142857142,2021-12-25,413,423,363,60,2979,3041,2592,449,92
Plumas,1.7142857142857142,2021-12-25,4,4,3,1,86,87,74,13,0
Riverside,1.7142857142857142,2021-12-25,3914,3996,3427,569,23607,24094,20494,3600,389
Sacramento,1.7142857142857142,2021-12-25,1347,1375,1178,197,14594,14896,12687,2209,180
San Benito,1.7142857142857142,2021-12-25,79,80,68,12,614,627,534,93,5
San Bernardino,1.7142857142857142,2021-12-25,3734,3812,3274,538,23936,24430,20775,3655,449
San Diego,1.7142857142857142,2021-12-25,6777,6918,5903,1015,48326,49324,41972,7352,371
San Francisco,1.7142857142857142,2021-12-25,2140,2185,1873,312,19661,20068,17078,2990,36
San Joaquin,1.7142857142857142,2021-12-25,664,678,582,96,6367,6498,5528,970,78
San Luis Obispo,1.7142857142857142,2021-12-25,248,253,216,37,2767,2824,2403,421,22
San Mateo,1.7142857142857142,2021-12-25,1345,1373,1179,194,13416,13694,11653,2041,30
Santa Barbara,1.7142857142857142,2021-12-25,643,656,564,92,4003,4086,3482,604,37
Santa Clara,1.7142857142857142,2021-12-25,2806,2865,2463,402,30542,31174,26540,4634,134
Santa Cruz,1.7142857142857142,2021-12-25,297,303,261,42,2537,2589,2202,387,14
Shasta,1.7142857142857142,2021-12-25,84,87,75,12,886,905,771,134,37
Siskiyou,1.7142857142857142,2021-12-25,8,8,7,1,115,117,100,17,0
Solano,1.7142857142857142,2021-12-25,333,340,290,50,4276,4365,3718,647,44
Sonoma,1.7142857142857142,2021-12-25,608,621,533,88,5871,5991,5080,911,16
Stanislaus,1.7142857142857142,2021-12-25,374,382,329,53,2930,2991,2556,435,116
Sutter,1.7142857142857142,2021-12-25,73,74,63,11,635,648,553,95,0
Tehama,1.7142857142857142,2021-12-25,35,35,30,5,260,266,227,39,11
Trinity,1.7142857142857142,2021-12-25,2,2,2,0,25,25,21,4,0
Tulare,1.7142857142857142,2021-12-25,233,238,204,34,2758,2815,2399,416,48
Tuolumne,1.7142857142857142,2021-12-25,62,63,54,9,520,531,454,77,5
Ventura,1.7142857142857142,2021-12-25,1558,1591,1368,223,10087,10296,8785,1511,83
Yolo,1.7142857142857142,2021-12-25,211,215,185,30,4675,4771,4037,734,8
Yuba,1.7142857142857142,2021-12-25,54,55,47,8,423,432,369,63,13
Alameda,2.142857142857143,2021-12-28,5495,5626,5074,552,46421,47518,42866,4652,156
Amador,2.142857142857143,2021-12-28,60,61,55,6,724,741,668,73,5
Butte,2.142857142857143,2021-12-28,367,375,338,37,2663,2726,2457,269,36
Calaveras,2.142857142857143,2021-12-28,72,75,67,8,566,580,523,57,2
Colusa,2.142857142857143,2021-12-28,23,23,21,2,128,130,117,13,2
Contra Costa,2.142857142857143,2021-12-28,4407,4511,4069,442,26404,27028,24378,2650,81
Del Norte,2.142857142857143,2021-12-28,21,21,19,2,934,956,862,94,1
El Dorado,2.142857142857143,2021-12-28,351,359,324,35,2309,2363,2133,230,13
Fresno,2.142857142857143,2021-12-28,1763,1805,1629,176,15198,15558,14041,1517,174
Glenn,2.142857142857143,2021-12-28,24,24,22,2,285,292,263,29,0
Humboldt,2.142857142857143,2021-12-28,328,336,303,33,2180,2232,2012,220,10
Imperial,2.142857142857143,2021-12-28,595,608,548,60,3713,3801,3430,371,58
Inyo,2.142857142857143,2021-12-28,72,74,67,7,233,238,215,23,0
Kern,2.142857142857143,2021-12-28,1672,1711,1542,169,14773,15121,13636,1485,115
Kings,2.142857142857143,2021-12-28,380,389,351,38,3647,3733,3372,361,23
Lake,2.142857142857143,2021-12-28,51,51,46,5,564,577,520,57,0
Lassen,2.142857142857143,2021-12-28,14,14,13,1,1192,1220,1100,120,1
Los Angeles,2.142857142857143,2021-12-28,74555,76319,68856,7463,399295,408732,368715,40017,1367
Madera,2.142857142857143,2021-12-28,281,288,260,28,2813,2879,2599,280,13
Marin,2.142857142857143,2021-12-28,1092,1118,1006,112,8818,9025,8129,896,12
Mariposa,2.142857142857143,2021-12-28,27,27,24,3,202,206,186,20,0
Mendocino,2.142857142857143,2021-12-28,152,156,141,15,1455,1489,1344,145,6
Merced,2.142857142857143,2021-12-28,568,582,525,57,3520,3604,3253,351,20
Modoc,2.142857142857143,2021-12-28,3,3,3,0,19,19,17,2,1
Mono,2.142857142857143,2021-12-28,113,115,104,11,246,252,228,24,1
Monterey,2.142857142857143,2021-12-28,502,513,462,51,4713,4825,4354,471,28
Napa,2.142857142857143,2021-12-28,602,615,555,60,4293,4395,3968,427,7
Nevada,2.142857142857143,2021-12-28,149,153,138,15,683,699,631,68,2
Orange,2.142857142857143,2021-12-28,16332,16717,15078,1639,86525,88568,79877,8691,390
Placer,2.142857142857143,2021-12-28,878,899,811,88,6572,6727,6069,658,117
Plumas,2.142857142857143,2021-12-28,10,10,9,1,143,146,132,14,0
Riverside,2.142857142857143,2021-12-28,10730,10983,9901,1082,56553,57888,52203,5685,458
Sacramento,2.142857142857143,2021-12-28,4276,4377,3948,429,32039,32796,29590,3206,203
San Benito,2.142857142857143,2021-12-28,261,267,241,26,1340,1372,1237,135,3
San Bernardino,2.142857142857143,2021-12-28,11884,12164,10972,1192,54292,55579,50164,5415,569
San Diego,2.142857142857143,2021-12-28,21740,22253,20069,2184,106432,108944,98241,10703,454
San Francisco,2.142857142857143,2021-12-28,4138,4235,3816,419,31695,32442,29252,3190,56
San Joaquin,2.142857142857143,2021-12-28,2028,2076,1873,203,14392,14732,13293,1439,92
San Luis Obispo,2.142857142857143,2021-12-28,1026,1050,948,102,7339,7512,6781,731,25
San Mateo,2.142857142857143,2021-12-28,3148,3222,2903,319,23487,24041,21680,2361,36
Santa Barbara,2.142857142857143,2021-12-28,1763,1804,1626,178,10149,10390,9374,1016,47
Santa Clara,2.142857142857143,2021-12-28,7100,7268,6552,716,59516,60920,54938,5982,162
Santa Cruz,2.142857142857143,2021-12-28,717,735,662,73,6850,7012,6327,685,12
Shasta,2.142857142857143,2021-12-28,175,180,162,18,2740,2805,2531,274,45
Siskiyou,2.142857142857143,2021-12-28,20,20,18,2,217,222,200,22,0
Solano,2.142857142857143,2021-12-28,1333,1365,1233,132,10518,10767,9719,1048,45
Sonoma,2.142857142857143,2021-12-28,1417,1450,1306,144,13053,13361,12046,1315,26
Stanislaus,2.142857142857143,2021-12-28,1027,1052,948,104,7477,7653,6901,752,123
Sutter,2.142857142857143,2021-12-28,158,161,145,16,1244,1274,1149,125,0
Tehama,2.142857142857143,2021-12-28,63,64,58,6,603,618,557,61,7
Trinity,2.142857142857143,2021-12-28,1,1,1,0,40,40,36,4,0
Tulare,2.142857142857143,2021-12-28,586,600,541,59,7524,7702,6951,751,59
Tuolumne,2.142857142857143,2021-12-28,103,106,95,11,784,802,723,79,9
Ventura,2.142857142857143,2021-12-28,5027,5145,4637,508,26214,26832,24184,2648,100
Yolo,2.142857142857143,2021-12-28,667,683,616,67,13064,13374,12079,1295,13
Yuba,2.142857142857143,2021-12-28,133,136,123,13,956,978,882,96,13
Alameda,2.5714285714285716,2021-12-31,7380,7572,6919,653,51639,52985,48415,4570,178
Amador,2.5714285714285716,2021-12-31,59,60,55,5,1052,1080,987,93,6
Butte,2.5714285714285716,2021-12-31,388,398,364,34,2794,2868,2621,247,31
Calaveras,2.5714285714285716,2021-12-31,56,57,52,5,544,558,510,48,3
Colusa,2.5714285714285716,2021-12-31,17,17,16,1,159,162,148,14,4
Contra Costa,2.5714285714285716,2021-12-31,5206,5342,4881,461,29789,30565,27927,2638,96
Del Norte,2.5714285714285716,2021-12-31,29,29,27,2,1006,1033,944,89,1
El Dorado,2.5714285714285716,2021-12-31,518,532,486,46,2770,2843,2598,245,20
Fresno,2.5714285714285716,2021-12-31,2467,2531,2313,218,18180,18655,17048,1607,191
Glenn,2.5714285714285716,2021-12-31,42,43,39,4,215,220,201,19,0
Humboldt,2.5714285714285716,2021-12-31,291,299,273,26,2326,2387,2181,206,11
Imperial,2.5714285714285716,2021-12-31,618,634,579,55,4116,4225,3861,364,65
Inyo,2.5714285714285716,2021-12-31,109,112,102,10,340,349,319,30,2
Kern,2.5714285714285716,2021-12-31,1956,2007,1834,173,13758,14117,12902,1215,116
Kings,2.5714285714285716,2021-12-31,378,388,355,33,3557,3651,3337,314,19
Lake,2.5714285714285716,2021-12-31,54,55,50,5,765,785,717,68,1
Lassen,2.5714285714285716,2021-12-31,17,17,16,1,1267,1300,1188,112,2
Los Angeles,2.5714285714285716,2021-12-31,81738,83877,76655,7222,423158,434220,396821,37399,1760
Madera,2.5714285714285716,2021-12-31,311,319,292,27,2711,2781,2541,240,15
Marin,2.5714285714285716,2021-12-31,921,945,863,82,7952,8158,7453,705,17
Mariposa,2.5714285714285716,2021-12-31,38,39,36,3,323,331,303,28,0
Mendocino,2.5714285714285716,2021-12-31,136,140,128,12,1369,1405,1283,122,7
Merced,2.5714285714285716,2021-12-31,543,557,509,48,3627,3722,3401,321,19
Modoc,2.5714285714285716,2021-12-31,4,4,4,0,29,29,26,3,0
Mono,2.5714285714285716,2021-12-31,48,49,45,4,122,125,114,11,4
Monterey,2.5714285714285716,2021-12-31,659,677,619,58,5645,5792,5293,499,30
Napa,2.5714285714285716,2021-12-31,775,795,726,69,5602,5749,5254,495,9
Nevada,2.5714285714285716,2021-12-31,242,248,227,21,1399,1436,1312,124,5
Orange,2.5714285714285716,2021-12-31,19684,20199,18460,1739,97606,100156,91529,8627,490
Placer,2.5714285714285716,2021-12-31,1200,1232,1126,106,6893,7073,6463,610,127
Plumas,2.5714285714285716,2021-12-31,18,18,16,2,187,192,175,17,2
Riverside,2.5714285714285716,2021-12-31,13514,13868,12674,1194,61298,62896,57472,5424,544
Sacramento,2.5714285714285716,2021-12-31,5452,5595,5113,482,36080,37022,33832,3190,255
San Benito,2.5714285714285716,2021-12-31,323,332,303,29,1537,1577,1441,136,5
San Bernardino,2.5714285714285716,2021-12-31,12534,12860,11750,1110,61622,63225,57765,5460,663
San Diego,2.5714285714285716,2021-12-31,25504,26168,23911,2257,109633,112492,102794,9698,610
San Francisco,2.5714285714285716,2021-12-31,4142,4250,3884,366,34788,35697,32623,3074,91
San Joaquin,2.5714285714285716,2021-12-31,2782,2855,2609,246,16428,16857,15404,1453,100
San Luis Obispo,2.5714285714285716,2021-12-31,1009,1035,945,90,6977,7158,6540,618,24
San Mateo,2.5714285714285716,2021-12-31,3329,3417,3123,294,26819,27517,25143,2374,43
Santa Barbara,2.5714285714285716,2021-12-31,1894,1944,1777,167,11303,11600,10603,997,60
Santa Clara,2.5714285714285716,2021-12-31,8478,8700,7952,748,67079,68829,62896,5933,219
Santa Cruz,2.5714285714285716,2021-12-31,867,889,812,77,7757,7957,7268,689,18
Shasta,2.5714285714285716,2021-12-31,195,200,183,17,2455,2518,2300,218,43
Siskiyou,2.5714285714285716,2021-12-31,30,30,27,3,205,210,192,18,0
Solano,2.5714285714285716,2021-12-31,1836,1883,1720,163,11524,11825,10806,1019,74
Sonoma,2.5714285714285716,2021-12-31,1958,2009,1836,173,14057,14423,13177,1246,33
Stanislaus,2.5714285714285716,2021-12-31,1280,1314,1201,113,7626,7825,7150,675,127
Sutter,2.5714285714285716,2021-12-31,173,178,163,15,1193,1224,1119,105,0
Tehama,2.5714285714285716,2021-12-31,64,66,60,6,526,540,493,47,3
Trinity,2.5714285714285716,2021-12-31,6,6,5,1,55,56,51,5,0
Tulare,2.5714285714285716,2021-12-31,698,716,654,62,6758,6935,6338,597,54
Tuolumne,2.5714285714285716,2021-12-31,134,137,125,12,1045,1072,980,92,6
Ventura,2.5714285714285716,2021-12-31,5245,5383,4919,464,26305,26991,24664,2327,109
Yolo,2.5714285714285716,2021-12-31,684,702,641,61,11892,12198,11138,1060,11
Yuba,2.5714285714285716,2021-12-31,162,166,152,14,974,999,913,86,20
Alameda,3,2022-01-03,6559,6761,6178,583,41208,42481,38810,3671,218
Amador,3,2022-01-03,119,123,112,11,819,845,772,73,7
Butte,3,2022-01-03,565,582,532,50,2874,2963,2707,256,36
Calaveras,3,2022-01-03,101,105,96,9,570,588,537,51,1
Colusa,3,2022-01-03,12,12,11,1,153,158,144,14,5
Contra Costa,3,2022-01-03,5340,5504,5030,474,25840,26638,24336,2302,120
Del Norte,3,2022-01-03,44,45,41,4,772,796,727,69,0
El Dorado,3,2022-01-03,502,517,472,45,1987,2048,1871,177,13
Fresno,3,2022-01-03,2564,2643,2415,228,13413,13826,12632,1194,244
Glenn,3,2022-01-03,32,33,30,3,282,290,265,25,0
Humboldt,3,2022-01-03,442,455,416,39,1997,2058,1880,178,12
Imperial,3,2022-01-03,898,926,846,80,3474,3582,3272,310,66
Inyo,3,2022-01-03,116,120,110,10,275,284,259,25,3
Kern,3,2022-01-03,2959,3050,2787,263,15894,16385,14968,1417,134
Kings,3,2022-01-03,523,539,493,46,3055,3149,2877,272,18
Lake,3,2022-01-03,114,118,108,10,681,703,642,61,2
Lassen,3,2022-01-03,32,32,29,3,1361,1402,1281,121,2
Los Angeles,3,2022-01-03,74842,77143,70491,6652,408653,421261,384873,36388,2380
Madera,3,2022-01-03,386,398,364,34,2333,2405,2197,208,29
Marin,3,2022-01-03,960,989,904,85,5977,6161,5630,531,19
Mariposa,3,2022-01-03,45,46,42,4,200,206,188,18,0
Mendocino,3,2022-01-03,238,246,225,21,1438,1483,1355,128,9
Merced,3,2022-01-03,719,741,677,64,3143,3240,2959,281,25
Modoc,3,2022-01-03,9,9,8,1,20,20,18,2,0
Mono,3,2022-01-03,33,34,31,3,120,124,113,11,2
Monterey,3,2022-01-03,683,704,643,61,4793,4941,4514,427,41
Napa,3,2022-01-03,798,822,751,71,4096,4223,3856,367,12
Nevada,3,2022-01-03,297,307,281,26,1304,1344,1228,116,10
Orange,3,2022-01-03,16915,17434,15932,1502,75152,77465,70781,6684,629
Placer,3,2022-01-03,1125,1160,1060,100,5087,5244,4791,453,154
Plumas,3,2022-01-03,29,29,27,2,134,138,126,12,1
Riverside,3,2022-01-03,12899,13295,12149,1146,48466,49959,45648,4311,707
Sacramento,3,2022-01-03,5385,5551,5072,479,29159,30060,27461,2599,295
San Benito,3,2022-01-03,285,294,269,25,1251,1290,1179,111,5
San Bernardino,3,2022-01-03,12004,12372,11307,1065,43026,44354,40522,3832,743
San Diego,3,2022-01-03,22992,23698,21655,2043,93733,96614,88285,8329,708
San Francisco,3,2022-01-03,4800,4947,4522,425,29133,30031,27439,2592,105
San Joaquin,3,2022-01-03,3104,3199,2924,275,13083,13487,12322,1165,114
San Luis Obispo,3,2022-01-03,1013,1045,955,90,5735,5913,5401,512,31
San Mateo,3,2022-01-03,4062,4186,3826,360,25841,26638,24338,2300,55
Santa Barbara,3,2022-01-03,2444,2519,2302,217,12008,12378,11310,1068,60
Santa Clara,3,2022-01-03,10881,11213,10249,964,71419,73623,67264,6359,278
Santa Cruz,3,2022-01-03,1140,1175,1074,101,10734,11067,10109,958,18
Shasta,3,2022-01-03,321,331,303,28,2578,2658,2428,230,47
Siskiyou,3,2022-01-03,31,32,29,3,272,280,256,24,0
Solano,3,2022-01-03,1298,1338,1222,116,8066,8315,7596,719,82
Sonoma,3,2022-01-03,1835,1892,1729,163,12546,12935,11816,1119,29
Stanislaus,3,2022-01-03,1515,1562,1428,134,6821,7031,6425,606,160
Sutter,3,2022-01-03,301,310,283,27,1237,1276,1166,110,0
Tehama,3,2022-01-03,123,127,116,11,657,677,618,59,6
Trinity,3,2022-01-03,6,6,5,1,38,39,36,3,0
Tulare,3,2022-01-03,988,1018,930,88,5968,6154,5621,533,65
Tuolumne,3,2022-01-03,192,198,181,17,1168,1204,1100,104,9
Ventura,3,2022-01-03,5108,5265,4812,453,22021,22700,20740,1960,171
Yolo,3,2022-01-03,1258,1297,1186,111,13999,14430,13185,1245,11
Yuba,3,2022-01-03,234,242,221,21,878,905,827,78,23
Alameda,3.4285714285714284,2022-01-06,16195,16759,15160,1599,99769,103246,93385,9861,276
Amador,3.4285714285714284,2022-01-06,159,164,148,16,1501,1553,1406,147,6
Butte,3.4285714285714284,2022-01-06,895,926,837,89,5049,5225,4726,499,47
Calaveras,3.4285714285714284,2022-01-06,179,186,168,18,1271,1314,1190,124,2
Colusa,3.4285714285714284,2022-01-06,32,32,29,3,358,370,335,35,5
Contra Costa,3.4285714285714284,2022-01-06,8977,9291,8403,888,51213,53000,47932,5068,158
Del Norte,3.4285714285714284,2022-01-06,72,75,68,7,1412,1462,1321,141,1
El Dorado,3.4285714285714284,2022-01-06,919,952,861,91,4894,5064,4579,485,15
Fresno,3.4285714285714284,2022-01-06,6121,6335,5728,607,30335,31393,28391,3002,303
Glenn,3.4285714285714284,2022-01-06,106,110,99,11,427,442,399,43,3
Humboldt,3.4285714285714284,2022-01-06,665,689,623,66,4233,4381,3961,420,18
Imperial,3.4285714285714284,2022-01-06,1773,1835,1659,176,7415,7673,6940,733,64
Inyo,3.4285714285714284,2022-01-06,237,245,221,24,788,815,736,79,3
Kern,3.4285714285714284,2022-01-06,5309,5494,4969,525,28160,29140,26361,2779,167
Kings,3.4285714285714284,2022-01-06,860,890,805,85,6249,6466,5850,616,22
Lake,3.4285714285714284,2022-01-06,213,220,199,21,1331,1378,1246,132,4
Lassen,3.4285714285714284,2022-01-06,56,59,53,6,1594,1650,1491,159,2
Los Angeles,3.4285714285714284,2022-01-06,168412,174286,157628,16658,956569,989990,895235,94755,3087
Madera,3.4285714285714284,2022-01-06,859,889,804,85,5913,6118,5535,583,29
Marin,3.4285714285714284,2022-01-06,1318,1363,1234,129,10273,10630,9617,1013,22
Mariposa,3.4285714285714284,2022-01-06,105,108,98,10,608,629,569,60,0
Mendocino,3.4285714285714284,2022-01-06,391,405,366,39,3000,3105,2809,296,5
Merced,3.4285714285714284,2022-01-06,1758,1819,1645,174,7261,7514,6796,718,42
Modoc,3.4285714285714284,2022-01-06,7,7,6,1,62,63,57,6,0
Mono,3.4285714285714284,2022-01-06,196,203,184,19,522,540,489,51,2
Monterey,3.4285714285714284,2022-01-06,1759,1820,1645,175,12148,12571,11371,1200,62
Napa,3.4285714285714284,2022-01-06,1386,1435,1299,136,7780,8051,7282,769,14
Nevada,3.4285714285714284,2022-01-06,478,495,447,48,2488,2574,2328,246,12
Orange,3.4285714285714284,2022-01-06,30588,31654,28632,3022,137784,142589,128961,13628,813
Placer,3.4285714285714284,2022-01-06,2403,2487,2249,238,11256,11649,10535,1114,174
Plumas,3.4285714285714284,2022-01-06,46,48,43,5,399,413,374,39,2
Riverside,3.4285714285714284,2022-01-06,23813,24642,22290,2352,92390,95611,86478,9133,832
Sacramento,3.4285714285714284,2022-01-06,13211,13671,12364,1307,64217,66454,60109,6345,342
San Benito,3.4285714285714284,2022-01-06,534,552,499,53,2294,2375,2147,228,6
San Bernardino,3.4285714285714284,2022-01-06,23901,24736,22369,2367,99283,102748,92922,9826,914
San Diego,3.4285714285714284,2022-01-06,44995,46562,42120,4442,174565,180643,163405,17238,871
San Francisco,3.4285714285714284,2022-01-06,7817,8090,7317,773,57049,59041,53393,5648,142
San Joaquin,3.4285714285714284,2022-01-06,7196,7448,6734,714,35056,36278,32811,3467,134
San Luis Obispo,3.4285714285714284,2022-01-06,2392,2475,2238,237,11626,12033,10882,1151,36
San Mateo,3.4285714285714284,2022-01-06,6356,6576,5949,627,49893,51629,46705,4924,79
Santa Barbara,3.4285714285714284,2022-01-06,4134,4278,3869,409,23316,24130,21823,2307,75
Santa Clara,3.4285714285714284,2022-01-06,17549,18161,16424,1737,133681,138354,125106,13248,356
Santa Cruz,3.4285714285714284,2022-01-06,2278,2357,2132,225,21618,22373,20232,2141,17
Shasta,3.4285714285714284,2022-01-06,474,491,444,47,4335,4486,4058,428,46
Siskiyou,3.4285714285714284,2022-01-06,53,55,50,5,406,420,380,40,4
Solano,3.4285714285714284,2022-01-06,3522,3644,3297,347,18879,19536,17674,1862,93
Sonoma,3.4285714285714284,2022-01-06,4436,4590,4153,437,24340,25184,22787,2397,50
Stanislaus,3.4285714285714284,2022-01-06,2935,3038,2747,291,14092,14583,13193,1390,170
Sutter,3.4285714285714284,2022-01-06,494,511,462,49,2372,2454,2220,234,0
Tehama,3.4285714285714284,2022-01-06,249,258,233,25,1280,1325,1198,127,10
Trinity,3.4285714285714284,2022-01-06,15,15,14,1,154,160,145,15,0
Tulare,3.4285714285714284,2022-01-06,2113,2187,1977,210,11880,12294,11117,1177,69
Tuolumne,3.4285714285714284,2022-01-06,320,331,300,31,1991,2060,1863,197,11
Ventura,3.4285714285714284,2022-01-06,8828,9135,8263,872,45451,47033,42544,4489,204
Yolo,3.4285714285714284,2022-01-06,1816,1879,1700,179,25502,26392,23869,2523,9
Yuba,3.4285714285714284,2022-01-06,490,507,458,49,2061,2134,1929,205,27
Alameda,3.857142857142857,2022-01-09,9527,9927,8794,1133,54304,56585,50136,6449,356
Amador,3.857142857142857,2022-01-09,125,131,116,15,628,655,579,76,8
Butte,3.857142857142857,2022-01-09,649,676,598,78,2860,2982,2637,345,48
Calaveras,3.857142857142857,2022-01-09,188,195,173,22,708,737,654,83,2
Colusa,3.857142857142857,2022-01-09,37,38,34,4,154,161,143,18,5
Contra Costa,3.857142857142857,2022-01-09,6018,6273,5549,724,29710,30961,27424,3537,202
Del Norte,3.857142857142857,2022-01-09,59,62,55,7,1826,1901,1688,213,1
El Dorado,3.857142857142857,2022-01-09,620,646,572,74,2309,2406,2130,276,18
Fresno,3.857142857142857,2022-01-09,4325,4508,3991,517,17869,18622,16492,2130,323
Glenn,3.857142857142857,2022-01-09,52,54,48,6,196,204,181,23,2
Humboldt,3.857142857142857,2022-01-09,491,512,453,59,2446,2550,2256,294,16
Imperial,3.857142857142857,2022-01-09,863,899,797,102,3454,3597,3192,405,73
Inyo,3.857142857142857,2022-01-09,71,75,66,9,207,216,192,24,3
Kern,3.857142857142857,2022-01-09,3441,3588,3171,417,15274,15918,14098,1820,199
Kings,3.857142857142857,2022-01-09,713,744,658,86,3528,3677,3255,422,29
Lake,3.857142857142857,2022-01-09,151,158,140,18,647,675,598,77,2
Lassen,3.857142857142857,2022-01-09,61,64,56,8,968,1010,893,117,2
Los Angeles,3.857142857142857,2022-01-09,98149,102271,90611,11660,538444,560964,497272,63692,3645
Madera,3.857142857142857,2022-01-09,622,648,573,75,2487,2593,2295,298,32
Marin,3.857142857142857,2022-01-09,998,1040,919,121,6593,6873,6082,791,27
Mariposa,3.857142857142857,2022-01-09,43,45,40,5,314,327,290,37,0
Mendocino,3.857142857142857,2022-01-09,253,264,233,31,1232,1284,1136,148,7
Merced,3.857142857142857,2022-01-09,787,820,728,92,3152,3284,2913,371,45
Modoc,3.857142857142857,2022-01-09,2,2,2,0,20,21,19,2,0
Mono,3.857142857142857,2022-01-09,69,72,64,8,211,220,195,25,1
Monterey,3.857142857142857,2022-01-09,1030,1074,951,123,5998,6250,5538,712,56
Napa,3.857142857142857,2022-01-09,733,764,677,87,3600,3750,3325,425,17
Nevada,3.857142857142857,2022-01-09,356,371,329,42,1314,1369,1214,155,13
Orange,3.857142857142857,2022-01-09,16800,17510,15504,2006,75206,78369,69421,8948,992
Placer,3.857142857142857,2022-01-09,1490,1553,1374,179,6116,6374,5645,729,199
Plumas,3.857142857142857,2022-01-09,23,23,20,3,141,147,130,17,4
Riverside,3.857142857142857,2022-01-09,14350,14958,13239,1719,52336,54543,48298,6245,921
Sacramento,3.857142857142857,2022-01-09,6802,7088,6279,809,31398,32713,28994,3719,449
San Benito,3.857142857142857,2022-01-09,306,320,282,38,1188,1240,1094,146,6
San Bernardino,3.857142857142857,2022-01-09,13552,14125,12504,1621,52288,54484,48273,6211,977
San Diego,3.857142857142857,2022-01-09,23221,24202,21426,2776,94124,98094,86865,11229,1013
San Francisco,3.857142857142857,2022-01-09,4738,4940,4370,570,32419,33785,29921,3864,183
San Joaquin,3.857142857142857,2022-01-09,3971,4138,3664,474,16563,17262,15284,1978,160
San Luis Obispo,3.857142857142857,2022-01-09,1081,1126,999,127,5349,5571,4943,628,37
San Mateo,3.857142857142857,2022-01-09,4265,4447,3933,514,27166,28312,25072,3240,120
Santa Barbara,3.857142857142857,2022-01-09,2481,2587,2288,299,14152,14749,13060,1689,87
Santa Clara,3.857142857142857,2022-01-09,10987,11455,10129,1326,75475,78663,69647,9016,445
Santa Cruz,3.857142857142857,2022-01-09,1374,1433,1266,167,11438,11918,10562,1356,22
Shasta,3.857142857142857,2022-01-09,309,323,286,37,1861,1938,1717,221,46
Siskiyou,3.857142857142857,2022-01-09,33,34,30,4,238,248,220,28,6
Solano,3.857142857142857,2022-01-09,1907,1987,1759,228,10128,10553,9349,1204,106
Sonoma,3.857142857142857,2022-01-09,2434,2536,2247,289,12502,13025,11547,1478,78
Stanislaus,3.857142857142857,2022-01-09,2214,2309,2043,266,8540,8901,7880,1021,196
Sutter,3.857142857142857,2022-01-09,427,445,393,52,1410,1470,1301,169,0
Tehama,3.857142857142857,2022-01-09,143,149,132,17,573,597,529,68,12
Trinity,3.857142857142857,2022-01-09,15,15,13,2,79,82,73,9,0
Tulare,3.857142857142857,2022-01-09,1382,1441,1275,166,5926,6174,5471,703,69
Tuolumne,3.857142857142857,2022-01-09,270,281,248,33,1243,1295,1146,149,15
Ventura,3.857142857142857,2022-01-09,5256,5477,4849,628,23976,24981,22137,2844,254
Yolo,3.857142857142857,2022-01-09,1129,1177,1041,136,14568,15186,13440,1746,9
Yuba,3.857142857142857,2022-01-09,310,323,286,37,1122,1170,1036,134,46
Alameda,4.285714285714286,2022-01-12,13541,14307,12129,2178,94186,99505,84388,15117,421
Amador,4.285714285714286,2022-01-12,256,270,229,41,2519,2662,2254,408,9
Butte,4.285714285714286,2022-01-12,1106,1169,991,178,5492,5801,4924,877,65
Calaveras,4.285714285714286,2022-01-12,354,375,318,57,1656,1750,1483,267,2
Colusa,4.285714285714286,2022-01-12,78,83,70,13,477,504,427,77,2
Contra Costa,4.285714285714286,2022-01-12,8231,8699,7372,1327,49854,52678,44657,8021,243
Del Norte,4.285714285714286,2022-01-12,101,106,90,16,2746,2906,2455,451,3
El Dorado,4.285714285714286,2022-01-12,1030,1088,923,165,5082,5368,4555,813,14
Fresno,4.285714285714286,2022-01-12,8463,8945,7577,1368,35421,37429,31726,5703,395
Glenn,4.285714285714286,2022-01-12,174,184,156,28,635,671,570,101,2
Humboldt,4.285714285714286,2022-01-12,689,729,618,111,4838,5115,4331,784,30
Imperial,4.285714285714286,2022-01-12,2006,2118,1799,319,7982,8429,7156,1273,88
Inyo,4.285714285714286,2022-01-12,255,269,228,41,813,859,729,130,4
Kern,4.285714285714286,2022-01-12,6751,7132,6050,1082,34549,36488,30975,5513,244
Kings,4.285714285714286,2022-01-12,1863,1968,1670,298,9174,9694,8217,1477,39
Lake,4.285714285714286,2022-01-12,204,216,184,32,1344,1419,1206,213,3
Lassen,4.285714285714286,2022-01-12,136,144,122,22,1981,2092,1777,315,0
Los Angeles,4.285714285714286,2022-01-12,125779,132868,112721,20147,927441,980050,830625,149425,4339
Madera,4.285714285714286,2022-01-12,1181,1248,1058,190,6327,6687,5666,1021,39
Marin,4.285714285714286,2022-01-12,1276,1348,1145,203,9303,9826,8340,1486,30
Mariposa,4.285714285714286,2022-01-12,108,113,96,17,639,675,573,102,0
Mendocino,4.285714285714286,2022-01-12,541,572,486,86,3196,3375,2865,510,11
Merced,4.285714285714286,2022-01-12,2219,2345,1988,357,8027,8479,7195,1284,44
Modoc,4.285714285714286,2022-01-12,5,5,4,1,69,73,62,11,0
Mono,4.285714285714286,2022-01-12,157,166,140,26,484,512,433,79,0
Monterey,4.285714285714286,2022-01-12,2157,2279,1932,347,12149,12829,10896,1933,69
Napa,4.285714285714286,2022-01-12,1003,1059,901,158,6289,6643,5636,1007,25
Nevada,4.285714285714286,2022-01-12,661,699,592,107,3410,3602,3058,544,15
Orange,4.285714285714286,2022-01-12,25273,26690,22660,4030,128507,135729,115198,20531,1100
Placer,4.285714285714286,2022-01-12,2475,2614,2219,395,12066,12741,10820,1921,226
Plumas,4.285714285714286,2022-01-12,69,72,61,11,461,486,413,73,6
Riverside,4.285714285714286,2022-01-12,23839,25179,21368,3811,93996,99283,84254,15029,1019
Sacramento,4.285714285714286,2022-01-12,12284,12975,11010,1965,63083,66627,56550,10077,504
San Benito,4.285714285714286,2022-01-12,481,508,431,77,2327,2457,2087,370,9
San Bernardino,4.285714285714286,2022-01-12,21929,23168,19647,3521,95861,101288,85870,15418,1130
San Diego,4.285714285714286,2022-01-12,36540,38604,32741,5863,146411,154685,131174,23511,1171
San Francisco,4.285714285714286,2022-01-12,5210,5507,4665,842,45789,48391,41004,7387,230
San Joaquin,4.285714285714286,2022-01-12,7854,8294,7042,1252,36294,38327,32546,5781,224
San Luis Obispo,4.285714285714286,2022-01-12,2324,2455,2082,373,13274,14024,11893,2131,46
San Mateo,4.285714285714286,2022-01-12,5620,5938,5036,902,48340,51072,43311,7761,141
Santa Barbara,4.285714285714286,2022-01-12,4192,4427,3758,669,24825,26217,22258,3959,98
Santa Clara,4.285714285714286,2022-01-12,16974,17930,15211,2719,140195,148105,125628,22477,473
Santa Cruz,4.285714285714286,2022-01-12,2031,2144,1822,322,22499,23740,20202,3538,36
Shasta,4.285714285714286,2022-01-12,639,676,573,103,5873,6204,5263,941,60
Siskiyou,4.285714285714286,2022-01-12,84,89,75,14,675,714,606,108,3
Solano,4.285714285714286,2022-01-12,3170,3349,2841,508,18003,19016,16139,2877,135
Sonoma,4.285714285714286,2022-01-12,4652,4914,4169,745,27794,29359,24911,4448,94
Stanislaus,4.285714285714286,2022-01-12,3816,4032,3419,613,16922,17873,15167,2706,214
Sutter,4.285714285714286,2022-01-12,696,735,624,111,2891,3052,2593,459,0
Tehama,4.285714285714286,2022-01-12,343,363,308,55,1567,1655,1406,249,18
Trinity,4.285714285714286,2022-01-12,22,23,19,4,140,149,126,23,0
Tulare,4.285714285714286,2022-01-12,3759,3970,3368,602,16377,17296,14683,2613,81
Tuolumne,4.285714285714286,2022-01-12,397,420,356,64,2445,2582,2191,391,16
Ventura,4.285714285714286,2022-01-12,7592,8016,6809,1207,44072,46547,39510,7037,295
Yolo,4.285714285714286,2022-01-12,1598,1689,1433,256,23344,24671,20906,3765,16
Yuba,4.285714285714286,2022-01-12,596,629,534,95,2243,2369,2011,358,40
Alameda,4.714285714285714,2022-01-15,10539,11390,9147,2243,71093,76813,61718,15095,442
Amador,4.714285714285714,2022-01-15,153,166,132,34,1135,1226,985,241,9
Butte,4.714285714285714,2022-01-15,692,749,601,148,3302,3569,2867,702,58
Calaveras,4.714285714285714,2022-01-15,199,215,173,42,912,985,792,193,5
Colusa,4.714285714285714,2022-01-15,74,80,64,16,273,294,237,57,2
Contra Costa,4.714285714285714,2022-01-15,6226,6734,5400,1334,35966,38872,31215,7657,261
Del Norte,4.714285714285714,2022-01-15,70,76,61,15,1065,1150,925,225,3
El Dorado,4.714285714285714,2022-01-15,609,658,528,130,2978,3218,2584,634,16
Fresno,4.714285714285714,2022-01-15,6929,7495,6009,1486,27646,29889,23988,5901,446
Glenn,4.714285714285714,2022-01-15,114,124,100,24,380,411,330,81,2
Humboldt,4.714285714285714,2022-01-15,381,412,330,82,3110,3358,2701,657,37
Imperial,4.714285714285714,2022-01-15,1237,1335,1076,259,5246,5660,4560,1100,94
Inyo,4.714285714285714,2022-01-15,117,126,101,25,392,422,340,82,3
Kern,4.714285714285714,2022-01-15,4165,4500,3617,883,19653,21224,17069,4155,264
Kings,4.714285714285714,2022-01-15,1195,1290,1038,252,6285,6787,5460,1327,46
Lake,4.714285714285714,2022-01-15,177,191,154,37,1094,1180,951,229,4
Lassen,4.714285714285714,2022-01-15,66,71,57,14,1398,1509,1216,293,1
Los Angeles,4.714285714285714,2022-01-15,87758,94872,76148,18724,692630,748022,601515,146507,4673
Madera,4.714285714285714,2022-01-15,891,965,772,193,4091,4423,3550,873,38
Marin,4.714285714285714,2022-01-15,1014,1096,880,216,7650,8264,6645,1619,37
Mariposa,4.714285714285714,2022-01-15,60,64,51,13,529,571,459,112,0
Mendocino,4.714285714285714,2022-01-15,293,317,255,62,1707,1846,1482,364,25
Merced,4.714285714285714,2022-01-15,1464,1580,1272,308,5200,5610,4520,1090,53
Modoc,4.714285714285714,2022-01-15,5,5,4,1,31,33,27,6,0
Mono,4.714285714285714,2022-01-15,92,100,80,20,335,363,291,72,1
Monterey,4.714285714285714,2022-01-15,1715,1855,1487,368,9162,9896,7956,1940,75
Napa,4.714285714285714,2022-01-15,609,658,528,130,4081,4407,3544,863,24
Nevada,4.714285714285714,2022-01-15,485,524,421,103,2045,2209,1775,434,23
Orange,4.714285714285714,2022-01-15,16461,17802,14278,3524,85774,92702,74446,18256,1223
Placer,4.714285714285714,2022-01-15,1616,1749,1401,348,7514,8120,6522,1598,222
Plumas,4.714285714285714,2022-01-15,39,41,33,8,251,271,218,53,4
Riverside,4.714285714285714,2022-01-15,16031,17332,13910,3422,65700,71022,57011,14011,1047
Sacramento,4.714285714285714,2022-01-15,8136,8798,7059,1739,39992,43202,34727,8475,545
San Benito,4.714285714285714,2022-01-15,271,293,236,57,1453,1568,1263,305,8
San Bernardino,4.714285714285714,2022-01-15,13098,14156,11367,2789,67390,72809,58506,14303,1145
San Diego,4.714285714285714,2022-01-15,23543,25455,20427,5028,101864,110126,88394,21732,1230
San Francisco,4.714285714285714,2022-01-15,4007,4332,3477,855,35843,38738,31107,7631,243
San Joaquin,4.714285714285714,2022-01-15,4788,5170,4159,1011,23643,25520,20544,4976,245
San Luis Obispo,4.714285714285714,2022-01-15,1447,1561,1258,303,8015,8643,6971,1672,44
San Mateo,4.714285714285714,2022-01-15,3744,4047,3249,798,32613,35225,28321,6904,126
Santa Barbara,4.714285714285714,2022-01-15,2550,2754,2213,541,16411,17721,14253,3468,123
Santa Clara,4.714285714285714,2022-01-15,10527,11384,9133,2251,89746,96934,77943,18991,516
Santa Cruz,4.714285714285714,2022-01-15,1624,1756,1409,347,19971,21557,17354,4203,35
Shasta,4.714285714285714,2022-01-15,465,503,404,99,3261,3518,2834,684,83
Siskiyou,4.714285714285714,2022-01-15,58,62,50,12,261,282,227,55,5
Solano,4.714285714285714,2022-01-15,2383,2575,2068,507,12545,13555,10890,2665,146
Sonoma,4.714285714285714,2022-01-15,2776,2999,2411,588,15945,17212,13856,3356,96
Stanislaus,4.714285714285714,2022-01-15,2646,2858,2296,562,10974,11855,9528,2327,234
Sutter,4.714285714285714,2022-01-15,465,504,404,100,1764,1907,1530,377,0
Tehama,4.714285714285714,2022-01-15,186,200,161,39,894,965,777,188,15
Trinity,4.714285714285714,2022-01-15,9,9,7,2,116,126,101,25,0
Tulare,4.714285714285714,2022-01-15,2377,2570,2063,507,10150,10960,8815,2145,98
Tuolumne,4.714285714285714,2022-01-15,327,354,283,71,1634,1767,1418,349,9
Ventura,4.714285714285714,2022-01-15,4377,4734,3797,937,26129,28220,22693,5527,346
Yolo,4.714285714285714,2022-01-15,922,997,800,197,16182,17483,14047,3436,18
Yuba,4.714285714285714,2022-01-15,365,395,317,78,1369,1480,1188,292,57
Alameda,5.142857142857143,2022-01-18,8233,9864,7175,2689,62290,74968,54421,20547,488
Amador,5.142857142857143,2022-01-18,141,168,123,45,1376,1671,1207,464,16
Butte,5.142857142857143,2022-01-18,698,835,608,227,3834,4577,3334,1243,64
Calaveras,5.142857142857143,2022-01-18,181,217,158,59,917,1102,800,302,6
Colusa,5.142857142857143,2022-01-18,36,42,31,11,194,232,169,63,3
Contra Costa,5.142857142857143,2022-01-18,5399,6436,4696,1740,30997,37123,27017,10106,311
Del Norte,5.142857142857143,2022-01-18,84,100,73,27,1461,1760,1276,484,1
El Dorado,5.142857142857143,2022-01-18,437,520,380,140,2829,3388,2465,923,13
Fresno,5.142857142857143,2022-01-18,6499,7780,5660,2120,25627,30714,22333,8381,515
Glenn,5.142857142857143,2022-01-18,110,132,96,36,466,556,404,152,1
Humboldt,5.142857142857143,2022-01-18,420,501,366,135,2951,3528,2571,957,20
Imperial,5.142857142857143,2022-01-18,1268,1518,1104,414,4921,5899,4287,1612,103
Inyo,5.142857142857143,2022-01-18,53,62,45,17,272,324,236,88,1
Kern,5.142857142857143,2022-01-18,3644,4370,3179,1191,19313,23253,16875,6378,307
Kings,5.142857142857143,2022-01-18,1608,1953,1412,541,6805,8261,5973,2288,45
Lake,5.142857142857143,2022-01-18,194,234,170,64,999,1193,868,325,4
Lassen,5.142857142857143,2022-01-18,134,161,117,44,1635,1968,1429,539,0
Los Angeles,5.142857142857143,2022-01-18,61761,74075,53869,20206,478906,577521,418821,158700,4982
Madera,5.142857142857143,2022-01-18,947,1142,828,314,5040,6096,4413,1683,50
Marin,5.142857142857143,2022-01-18,832,991,723,268,6507,7790,5670,2120,50
Mariposa,5.142857142857143,2022-01-18,52,63,46,17,337,408,295,113,0
Mendocino,5.142857142857143,2022-01-18,327,392,285,107,1964,2367,1717,650,28
Merced,5.142857142857143,2022-01-18,1347,1609,1171,438,5086,6105,4434,1671,66
Modoc,5.142857142857143,2022-01-18,5,5,4,1,47,57,41,16,0
Mono,5.142857142857143,2022-01-18,30,36,26,10,183,220,160,60,0
Monterey,5.142857142857143,2022-01-18,1702,2040,1484,556,10170,12205,8871,3334,112
Napa,5.142857142857143,2022-01-18,620,745,541,204,4123,4977,3607,1370,26
Nevada,5.142857142857143,2022-01-18,427,509,370,139,2152,2566,1868,698,25
Orange,5.142857142857143,2022-01-18,13347,15869,11589,4280,74691,89094,64942,24152,1260
Placer,5.142857142857143,2022-01-18,1649,1964,1432,532,7719,9227,6717,2510,230
Plumas,5.142857142857143,2022-01-18,54,64,47,17,293,351,255,96,3
Riverside,5.142857142857143,2022-01-18,13960,16636,12136,4500,60054,71751,52267,19484,1167
Sacramento,5.142857142857143,2022-01-18,7351,8802,6404,2398,38780,46595,33841,12754,609
San Benito,5.142857142857143,2022-01-18,405,479,351,128,1792,2132,1556,576,8
San Bernardino,5.142857142857143,2022-01-18,10005,11999,8727,3272,55515,66801,48501,18300,1230
San Diego,5.142857142857143,2022-01-18,16454,19563,14288,5275,93434,111667,81345,30322,1328
San Francisco,5.142857142857143,2022-01-18,3742,4450,3250,1200,32293,38618,28125,10493,278
San Joaquin,5.142857142857143,2022-01-18,4544,5480,3972,1508,24207,29145,21143,8002,294
San Luis Obispo,5.142857142857143,2022-01-18,1488,1783,1296,487,8743,10517,7632,2885,59
San Mateo,5.142857142857143,2022-01-18,3350,3996,2915,1081,32063,38575,28013,10562,146
Santa Barbara,5.142857142857143,2022-01-18,2736,3263,2380,883,17564,21051,15312,5739,144
Santa Clara,5.142857142857143,2022-01-18,8665,10307,7529,2778,86540,103703,75454,28249,566
Santa Cruz,5.142857142857143,2022-01-18,1685,2008,1465,543,13820,16392,11988,4404,30
Shasta,5.142857142857143,2022-01-18,525,629,457,172,4218,5074,3682,1392,81
Siskiyou,5.142857142857143,2022-01-18,70,84,61,23,347,417,303,114,2
Solano,5.142857142857143,2022-01-18,1926,2307,1678,629,11638,13977,10154,3823,151
Sonoma,5.142857142857143,2022-01-18,2891,3454,2517,937,17190,20644,15000,5644,105
Stanislaus,5.142857142857143,2022-01-18,2567,3062,2233,829,11693,13946,10168,3778,294
Sutter,5.142857142857143,2022-01-18,433,516,377,139,2149,2567,1869,698,0
Tehama,5.142857142857143,2022-01-18,237,285,207,78,1031,1241,900,341,17
Trinity,5.142857142857143,2022-01-18,7,8,6,2,68,82,59,23,0
Tulare,5.142857142857143,2022-01-18,2861,3434,2494,940,12082,14489,10528,3961,117
Tuolumne,5.142857142857143,2022-01-18,257,307,224,83,1440,1729,1257,472,17
Ventura,5.142857142857143,2022-01-18,4015,4799,3495,1304,25249,30367,22047,8320,362
Yolo,5.142857142857143,2022-01-18,857,1024,746,278,14589,17486,12723,4763,24
Yuba,5.142857142857143,2022-01-18,373,446,325,121,1606,1923,1399,524,67
Alameda,5.571428571428571,2022-01-21,4695,9050,6056,2994,43210,84600,56535,28065,486
Amador,5.571428571428571,2022-01-21,79,171,113,58,1309,2282,1542,740,12
Butte,5.571428571428571,2022-01-21,461,832,560,272,2061,3704,2494,1210,76
Calaveras,5.571428571428571,2022-01-21,109,263,173,90,419,867,577,290,7
Colusa,5.571428571428571,2022-01-21,62,142,94,48,280,489,330,159,5
Contra Costa,5.571428571428571,2022-01-21,3363,6799,4532,2267,22903,45274,30229,15045,340
Del Norte,5.571428571428571,2022-01-21,93,175,117,58,730,1303,878,425,1
El Dorado,5.571428571428571,2022-01-21,334,632,424,208,1903,3727,2491,1236,29
Fresno,5.571428571428571,2022-01-21,4658,8534,5734,2800,18806,35291,23665,11626,567
Glenn,5.571428571428571,2022-01-21,36,68,45,23,140,262,176,86,0
Humboldt,5.571428571428571,2022-01-21,204,409,273,136,1195,2313,1548,765,18
Imperial,5.571428571428571,2022-01-21,1199,2581,1713,868,3850,8094,5381,2713,86
Inyo,5.571428571428571,2022-01-21,34,56,38,18,82,169,113,56,1
Kern,5.571428571428571,2022-01-21,2554,4773,3202,1571,13189,24974,16740,8234,325
Kings,5.571428571428571,2022-01-21,688,1291,866,425,3869,7870,5244,2626,46
Lake,5.571428571428571,2022-01-21,127,268,178,90,573,1215,807,408,7
Lassen,5.571428571428571,2022-01-21,96,181,121,60,911,1740,1166,574,1
Los Angeles,5.571428571428571,2022-01-21,47004,88207,59157,29050,286173,454276,309561,144715,4852
Madera,5.571428571428571,2022-01-21,480,909,609,300,2499,4777,3199,1578,62
Marin,5.571428571428571,2022-01-21,552,1097,732,365,4964,9679,6471,3208,50
Mariposa,5.571428571428571,2022-01-21,16,29,19,10,71,142,95,47,0
Mendocino,5.571428571428571,2022-01-21,145,316,209,107,735,1585,1052,533,24
Merced,5.571428571428571,2022-01-21,636,1128,760,368,2361,4404,2954,1450,65
Modoc,5.571428571428571,2022-01-21,4,7,5,2,24,40,27,13,0
Mono,5.571428571428571,2022-01-21,8,16,11,5,59,120,80,40,2
Monterey,5.571428571428571,2022-01-21,1114,2194,1465,729,6537,13437,8948,4489,112
Napa,5.571428571428571,2022-01-21,440,812,546,266,2462,4659,3123,1536,24
Nevada,5.571428571428571,2022-01-21,168,325,217,108,745,1449,969,480,25
Orange,5.571428571428571,2022-01-21,10352,20349,13597,6752,66038,133411,88956,44455,1187
Placer,5.571428571428571,2022-01-21,982,1832,1229,603,4672,9011,6032,2979,277
Plumas,5.571428571428571,2022-01-21,81,178,118,60,371,865,571,294,5
Riverside,5.571428571428571,2022-01-21,9898,18015,12112,5903,47340,88261,59219,29042,1112
Sacramento,5.571428571428571,2022-01-21,4535,8443,5665,2778,23969,44419,29821,14598,657
San Benito,5.571428571428571,2022-01-21,200,404,269,135,1116,2371,1574,797,9
San Bernardino,5.571428571428571,2022-01-21,9109,17269,11573,5696,47522,92504,61858,30646,1290
San Diego,5.571428571428571,2022-01-21,4622,6838,4697,2141,81003,163207,108844,54363,1326
San Francisco,5.571428571428571,2022-01-21,2907,5901,3932,1969,28485,59253,39419,19834,288
San Joaquin,5.571428571428571,2022-01-21,2068,3886,2605,1281,10846,20223,13568,6655,324
San Luis Obispo,5.571428571428571,2022-01-21,509,984,659,325,4022,8028,5360,2668,51
San Mateo,5.571428571428571,2022-01-21,2457,4831,3227,1604,25672,49918,33381,16537,156
Santa Barbara,5.571428571428571,2022-01-21,1725,3536,2356,1180,14246,30000,19943,10057,151
Santa Clara,5.571428571428571,2022-01-21,7946,15343,10262,5081,73060,138902,93028,45874,563
Santa Cruz,5.571428571428571,2022-01-21,2008,4324,2866,1458,20853,48677,32114,16563,48
Shasta,5.571428571428571,2022-01-21,436,773,521,252,2481,4107,2785,1322,83
Siskiyou,5.571428571428571,2022-01-21,36,64,43,21,241,417,282,135,7
Solano,5.571428571428571,2022-01-21,1309,2410,1618,792,7253,13663,9159,4504,176
Sonoma,5.571428571428571,2022-01-21,1696,3144,2110,1034,10970,20229,13583,6646,119
Stanislaus,5.571428571428571,2022-01-21,1643,3108,2082,1026,6432,11997,8049,3948,305
Sutter,5.571428571428571,2022-01-21,274,603,400,203,1180,2429,1617,812,0
Tehama,5.571428571428571,2022-01-21,117,190,129,61,429,709,481,228,21
Trinity,5.571428571428571,2022-01-21,16,30,20,10,71,134,90,44,0
Tulare,5.571428571428571,2022-01-21,2131,3866,2599,1267,8230,15690,10509,5181,143
Tuolumne,5.571428571428571,2022-01-21,169,355,236,119,838,1721,1146,575,14
Ventura,5.571428571428571,2022-01-21,2766,5044,3390,1654,20408,38594,25869,12725,385
Yolo,5.571428571428571,2022-01-21,418,789,529,260,5556,9638,6513,3125,27
Yuba,5.571428571428571,2022-01-21,258,541,360,181,1011,2082,1386,696,59
