county,time,date,cases,est_cases,est_omicron_cases,est_other_cases,hospitalizations
Alameda,0.42857142857142855,2021-12-14,674,686,123,563,90
Amador,0.42857142857142855,2021-12-14,16,16,4,12,8
Butte,0.42857142857142855,2021-12-14,61,61,11,50,28
Calaveras,0.42857142857142855,2021-12-14,25,25,5,20,5
Colusa,0.42857142857142855,2021-12-14,11,11,3,8,2
Contra Costa,0.42857142857142855,2021-12-14,416,424,74,350,51
Del Norte,0.42857142857142855,2021-12-14,7,7,2,5,1
El Dorado,0.42857142857142855,2021-12-14,80,81,14,67,10
Fresno,0.42857142857142855,2021-12-14,392,400,70,330,200
Glenn,0.42857142857142855,2021-12-14,4,4,2,2,0
Humboldt,0.42857142857142855,2021-12-14,70,71,14,57,16
Imperial,0.42857142857142855,2021-12-14,277,283,48,235,72
Inyo,0.42857142857142855,2021-12-14,11,11,2,9,2
Kern,0.42857142857142855,2021-12-14,356,362,64,298,118
Kings,0.42857142857142855,2021-12-14,110,112,21,91,27
Lake,0.42857142857142855,2021-12-14,10,10,3,7,1
Lassen,0.42857142857142855,2021-12-14,3,3,1,2,0
Los Angeles,0.42857142857142855,2021-12-14,6702,6829,1221,5608,868
Madera,0.42857142857142855,2021-12-14,63,65,13,52,22
Marin,0.42857142857142855,2021-12-14,147,150,27,123,8
Mariposa,0.42857142857142855,2021-12-14,5,5,2,3,0
Mendocino,0.42857142857142855,2021-12-14,33,33,7,26,3
Merced,0.42857142857142855,2021-12-14,87,89,17,72,23
Modoc,0.42857142857142855,2021-12-14,1,1,1,0,4
Mono,0.42857142857142855,2021-12-14,5,5,2,3,0
Monterey,0.42857142857142855,2021-12-14,113,115,21,94,24
Napa,0.42857142857142855,2021-12-14,73,74,13,61,8
Nevada,0.42857142857142855,2021-12-14,59,59,11,48,8
Orange,0.42857142857142855,2021-12-14,1211,1234,216,1018,208
Placer,0.42857142857142855,2021-12-14,183,186,31,155,90
Plumas,0.42857142857142855,2021-12-14,14,14,3,11,0
Riverside,0.42857142857142855,2021-12-14,1668,1700,289,1411,357
Sacramento,0.42857142857142855,2021-12-14,671,683,123,560,169
San Benito,0.42857142857142855,2021-12-14,43,43,8,35,5
San Bernardino,0.42857142857142855,2021-12-14,1534,1563,270,1293,407
San Diego,0.42857142857142855,2021-12-14,2146,2187,385,1802,371
San Francisco,0.42857142857142855,2021-12-14,666,679,120,559,42
San Joaquin,0.42857142857142855,2021-12-14,311,317,56,261,84
San Luis Obispo,0.42857142857142855,2021-12-14,118,120,22,98,13
San Mateo,0.42857142857142855,2021-12-14,319,325,59,266,29
Santa Barbara,0.42857142857142855,2021-12-14,192,196,37,159,43
Santa Clara,0.42857142857142855,2021-12-14,745,759,130,629,143
Santa Cruz,0.42857142857142855,2021-12-14,126,128,24,104,12
Shasta,0.42857142857142855,2021-12-14,63,64,12,52,27
Siskiyou,0.42857142857142855,2021-12-14,10,10,3,7,4
Solano,0.42857142857142855,2021-12-14,150,153,28,125,30
Sonoma,0.42857142857142855,2021-12-14,236,241,44,197,31
Stanislaus,0.42857142857142855,2021-12-14,262,267,49,218,116
Sutter,0.42857142857142855,2021-12-14,27,27,5,22,0
Tehama,0.42857142857142855,2021-12-14,25,25,6,19,4
Trinity,0.42857142857142855,2021-12-14,2,2,1,1,0
Tulare,0.42857142857142855,2021-12-14,172,175,30,145,72
Tuolumne,0.42857142857142855,2021-12-14,36,36,7,29,7
Ventura,0.42857142857142855,2021-12-14,494,503,94,409,67
Yolo,0.42857142857142855,2021-12-14,112,114,21,93,2
Yuba,0.42857142857142855,2021-12-14,43,43,8,35,20
Alameda,0.8571428571428571,2021-12-17,968,988,435,553,96
Amador,0.8571428571428571,2021-12-17,20,20,10,10,7
Butte,0.8571428571428571,2021-12-17,68,69,29,40,30
Calaveras,0.8571428571428571,2021-12-17,26,26,12,14,1
Colusa,0.8571428571428571,2021-12-17,3,3,2,1,0
Contra Costa,0.8571428571428571,2021-12-17,612,625,276,349,43
Del Norte,0.8571428571428571,2021-12-17,7,7,4,3,0
El Dorado,0.8571428571428571,2021-12-17,100,103,46,57,11
Fresno,0.8571428571428571,2021-12-17,450,459,199,260,196
Glenn,0.8571428571428571,2021-12-17,3,3,2,1,0
Humboldt,0.8571428571428571,2021-12-17,59,60,28,32,13
Imperial,0.8571428571428571,2021-12-17,222,227,101,126,67
Inyo,0.8571428571428571,2021-12-17,9,9,5,4,1
Kern,0.8571428571428571,2021-12-17,414,423,185,238,124
Kings,0.8571428571428571,2021-12-17,89,91,39,52,22
Lake,0.8571428571428571,2021-12-17,23,23,10,13,0
Lassen,0.8571428571428571,2021-12-17,4,4,3,1,0
Los Angeles,0.8571428571428571,2021-12-17,11542,11778,5157,6621,835
Madera,0.8571428571428571,2021-12-17,72,74,33,41,18
Marin,0.8571428571428571,2021-12-17,153,156,68,88,14
Mariposa,0.8571428571428571,2021-12-17,9,9,5,4,0
Mendocino,0.8571428571428571,2021-12-17,41,42,18,24,5
Merced,0.8571428571428571,2021-12-17,125,128,56,72,21
Modoc,0.8571428571428571,2021-12-17,0,0,1,-1,3
Mono,0.8571428571428571,2021-12-17,17,17,9,8,0
Monterey,0.8571428571428571,2021-12-17,179,182,79,103,24
Napa,0.8571428571428571,2021-12-17,87,90,40,50,5
Nevada,0.8571428571428571,2021-12-17,73,75,33,42,7
Orange,0.8571428571428571,2021-12-17,1699,1733,756,977,200
Placer,0.8571428571428571,2021-12-17,205,210,92,118,98
Plumas,0.8571428571428571,2021-12-17,8,8,4,4,1
Riverside,0.8571428571428571,2021-12-17,2179,2223,976,1247,329
Sacramento,0.8571428571428571,2021-12-17,882,900,389,511,164
San Benito,0.8571428571428571,2021-12-17,38,38,16,22,4
San Bernardino,0.8571428571428571,2021-12-17,1767,1803,783,1020,425
San Diego,0.8571428571428571,2021-12-17,3504,3576,1553,2023,391
San Francisco,0.8571428571428571,2021-12-17,965,985,433,552,50
San Joaquin,0.8571428571428571,2021-12-17,398,406,174,232,83
San Luis Obispo,0.8571428571428571,2021-12-17,173,176,78,98,14
San Mateo,0.8571428571428571,2021-12-17,449,458,203,255,22
Santa Barbara,0.8571428571428571,2021-12-17,297,304,135,169,38
Santa Clara,0.8571428571428571,2021-12-17,949,968,422,546,154
Santa Cruz,0.8571428571428571,2021-12-17,152,155,66,89,15
Shasta,0.8571428571428571,2021-12-17,72,74,33,41,33
Siskiyou,0.8571428571428571,2021-12-17,7,7,4,3,3
Solano,0.8571428571428571,2021-12-17,176,179,80,99,45
Sonoma,0.8571428571428571,2021-12-17,264,270,120,150,29
Stanislaus,0.8571428571428571,2021-12-17,277,283,123,160,111
Sutter,0.8571428571428571,2021-12-17,44,44,20,24,0
Tehama,0.8571428571428571,2021-12-17,18,18,9,9,6
Trinity,0.8571428571428571,2021-12-17,1,1,1,0,0
Tulare,0.8571428571428571,2021-12-17,171,174,74,100,59
Tuolumne,0.8571428571428571,2021-12-17,40,40,19,21,8
Ventura,0.8571428571428571,2021-12-17,705,719,317,402,77
Yolo,0.8571428571428571,2021-12-17,108,111,51,60,4
Yuba,0.8571428571428571,2021-12-17,43,43,19,24,9
Alameda,1.2857142857142858,2021-12-20,1522,1557,1081,476,95
Amador,1.2857142857142858,2021-12-20,25,25,18,7,5
Butte,1.2857142857142858,2021-12-20,90,91,64,27,25
Calaveras,1.2857142857142858,2021-12-20,27,27,20,7,1
Colusa,1.2857142857142858,2021-12-20,3,3,3,0,1
Contra Costa,1.2857142857142858,2021-12-20,871,890,617,273,51
Del Norte,1.2857142857142858,2021-12-20,8,8,7,1,0
El Dorado,1.2857142857142858,2021-12-20,109,112,78,34,7
Fresno,1.2857142857142858,2021-12-20,436,445,308,137,191
Glenn,1.2857142857142858,2021-12-20,11,11,8,3,0
Humboldt,1.2857142857142858,2021-12-20,73,74,52,22,13
Imperial,1.2857142857142858,2021-12-20,247,252,175,77,67
Inyo,1.2857142857142858,2021-12-20,19,19,14,5,1
Kern,1.2857142857142858,2021-12-20,373,382,265,117,112
Kings,1.2857142857142858,2021-12-20,106,108,76,32,18
Lake,1.2857142857142858,2021-12-20,14,14,11,3,0
Lassen,1.2857142857142858,2021-12-20,6,6,5,1,0
Los Angeles,1.2857142857142858,2021-12-20,16292,16664,11512,5152,830
Madera,1.2857142857142858,2021-12-20,55,56,39,17,20
Marin,1.2857142857142858,2021-12-20,341,349,242,107,12
Mariposa,1.2857142857142858,2021-12-20,11,11,9,2,0
Mendocino,1.2857142857142858,2021-12-20,34,34,24,10,7
Merced,1.2857142857142858,2021-12-20,155,159,112,47,23
Modoc,1.2857142857142858,2021-12-20,3,3,3,0,2
Mono,1.2857142857142858,2021-12-20,8,8,6,2,1
Monterey,1.2857142857142858,2021-12-20,151,155,107,48,31
Napa,1.2857142857142858,2021-12-20,127,131,92,39,4
Nevada,1.2857142857142858,2021-12-20,68,69,49,20,6
Orange,1.2857142857142858,2021-12-20,2536,2594,1796,798,195
Placer,1.2857142857142858,2021-12-20,271,277,192,85,90
Plumas,1.2857142857142858,2021-12-20,4,4,4,0,0
Riverside,1.2857142857142858,2021-12-20,2745,2807,1939,868,349
Sacramento,1.2857142857142858,2021-12-20,939,960,663,297,157
San Benito,1.2857142857142858,2021-12-20,42,43,31,12,4
San Bernardino,1.2857142857142858,2021-12-20,2399,2454,1697,757,424
San Diego,1.2857142857142858,2021-12-20,4278,4376,3040,1336,363
San Francisco,1.2857142857142858,2021-12-20,1648,1686,1169,517,44
San Joaquin,1.2857142857142858,2021-12-20,416,426,299,127,78
San Luis Obispo,1.2857142857142858,2021-12-20,167,172,122,50,17
San Mateo,1.2857142857142858,2021-12-20,757,775,536,239,23
Santa Barbara,1.2857142857142858,2021-12-20,392,401,280,121,34
Santa Clara,1.2857142857142858,2021-12-20,1706,1745,1208,537,147
Santa Cruz,1.2857142857142858,2021-12-20,199,203,141,62,16
Shasta,1.2857142857142858,2021-12-20,70,71,50,21,36
Siskiyou,1.2857142857142858,2021-12-20,9,9,7,2,4
Solano,1.2857142857142858,2021-12-20,220,225,155,70,38
Sonoma,1.2857142857142858,2021-12-20,383,391,269,122,29
Stanislaus,1.2857142857142858,2021-12-20,268,274,191,83,125
Sutter,1.2857142857142858,2021-12-20,68,69,49,20,0
Tehama,1.2857142857142858,2021-12-20,20,20,14,6,7
Trinity,1.2857142857142858,2021-12-20,0,0,1,-1,0
Tulare,1.2857142857142858,2021-12-20,171,175,122,53,50
Tuolumne,1.2857142857142858,2021-12-20,41,41,29,12,7
Ventura,1.2857142857142858,2021-12-20,1098,1122,776,346,80
Yolo,1.2857142857142858,2021-12-20,143,147,102,45,5
Yuba,1.2857142857142858,2021-12-20,39,39,28,11,7
Alameda,1.7142857142857142,2021-12-23,2687,2755,2219,536,95
Amador,1.7142857142857142,2021-12-23,36,36,30,6,5
Butte,1.7142857142857142,2021-12-23,171,176,142,34,29
Calaveras,1.7142857142857142,2021-12-23,32,32,27,5,1
Colusa,1.7142857142857142,2021-12-23,4,4,4,0,2
Contra Costa,1.7142857142857142,2021-12-23,1634,1675,1353,322,59
Del Norte,1.7142857142857142,2021-12-23,3,3,3,0,0
El Dorado,1.7142857142857142,2021-12-23,181,186,151,35,10
Fresno,1.7142857142857142,2021-12-23,744,764,617,147,165
Glenn,1.7142857142857142,2021-12-23,29,29,24,5,0
Humboldt,1.7142857142857142,2021-12-23,168,173,141,32,10
Imperial,1.7142857142857142,2021-12-23,279,286,230,56,62
Inyo,1.7142857142857142,2021-12-23,33,33,28,5,1
Kern,1.7142857142857142,2021-12-23,635,651,527,124,107
Kings,1.7142857142857142,2021-12-23,145,148,120,28,19
Lake,1.7142857142857142,2021-12-23,16,16,14,2,0
Lassen,1.7142857142857142,2021-12-23,9,9,8,1,1
Los Angeles,1.7142857142857142,2021-12-23,37638,38590,31151,7439,955
Madera,1.7142857142857142,2021-12-23,103,106,87,19,17
Marin,1.7142857142857142,2021-12-23,585,600,485,115,9
Mariposa,1.7142857142857142,2021-12-23,17,17,15,2,0
Mendocino,1.7142857142857142,2021-12-23,37,37,31,6,7
Merced,1.7142857142857142,2021-12-23,200,205,167,38,22
Modoc,1.7142857142857142,2021-12-23,2,2,3,-1,3
Mono,1.7142857142857142,2021-12-23,48,49,40,9,1
Monterey,1.7142857142857142,2021-12-23,221,227,185,42,28
Napa,1.7142857142857142,2021-12-23,302,309,251,58,5
Nevada,1.7142857142857142,2021-12-23,97,100,81,19,7
Orange,1.7142857142857142,2021-12-23,5818,5966,4828,1138,239
Placer,1.7142857142857142,2021-12-23,427,438,355,83,84
Plumas,1.7142857142857142,2021-12-23,5,5,5,0,0
Riverside,1.7142857142857142,2021-12-23,4861,4984,4027,957,403
Sacramento,1.7142857142857142,2021-12-23,1769,1813,1464,349,187
San Benito,1.7142857142857142,2021-12-23,138,141,115,26,2
San Bernardino,1.7142857142857142,2021-12-23,4536,4651,3753,898,437
San Diego,1.7142857142857142,2021-12-23,10431,10695,8640,2055,358
San Francisco,1.7142857142857142,2021-12-23,2901,2974,2395,579,43
San Joaquin,1.7142857142857142,2021-12-23,788,808,653,155,67
San Luis Obispo,1.7142857142857142,2021-12-23,427,438,355,83,22
San Mateo,1.7142857142857142,2021-12-23,1477,1514,1223,291,34
Santa Barbara,1.7142857142857142,2021-12-23,679,697,564,133,35
Santa Clara,1.7142857142857142,2021-12-23,3044,3121,2520,601,141
Santa Cruz,1.7142857142857142,2021-12-23,298,306,248,58,15
Shasta,1.7142857142857142,2021-12-23,78,81,66,15,37
Siskiyou,1.7142857142857142,2021-12-23,5,5,5,0,0
Solano,1.7142857142857142,2021-12-23,430,442,359,83,42
Sonoma,1.7142857142857142,2021-12-23,684,702,569,133,22
Stanislaus,1.7142857142857142,2021-12-23,409,420,340,80,121
Sutter,1.7142857142857142,2021-12-23,79,82,67,15,0
Tehama,1.7142857142857142,2021-12-23,28,28,24,4,9
Trinity,1.7142857142857142,2021-12-23,0,0,1,-1,0
Tulare,1.7142857142857142,2021-12-23,268,274,222,52,42
Tuolumne,1.7142857142857142,2021-12-23,57,59,49,10,7
Ventura,1.7142857142857142,2021-12-23,1706,1749,1413,336,77
Yolo,1.7142857142857142,2021-12-23,258,265,214,51,8
Yuba,1.7142857142857142,2021-12-23,50,50,41,9,9
Alameda,2.142857142857143,2021-12-26,2231,2296,2007,289,120
Amador,2.142857142857143,2021-12-26,37,38,34,4,4
Butte,2.142857142857143,2021-12-26,194,200,176,24,38
Calaveras,2.142857142857143,2021-12-26,43,44,40,4,2
Colusa,2.142857142857143,2021-12-26,12,12,11,1,2
Contra Costa,2.142857142857143,2021-12-26,1407,1448,1268,180,69
Del Norte,2.142857142857143,2021-12-26,17,17,16,1,0
El Dorado,2.142857142857143,2021-12-26,148,152,133,19,10
Fresno,2.142857142857143,2021-12-26,618,635,556,79,170
Glenn,2.142857142857143,2021-12-26,11,11,11,0,0
Humboldt,2.142857142857143,2021-12-26,182,187,164,23,11
Imperial,2.142857142857143,2021-12-26,256,263,231,32,55
Inyo,2.142857142857143,2021-12-26,51,53,47,6,0
Kern,2.142857142857143,2021-12-26,606,623,547,76,105
Kings,2.142857142857143,2021-12-26,171,175,154,21,19
Lake,2.142857142857143,2021-12-26,23,23,21,2,0
Lassen,2.142857142857143,2021-12-26,5,5,5,0,0
Los Angeles,2.142857142857143,2021-12-26,24553,25263,22053,3210,1078
Madera,2.142857142857143,2021-12-26,110,113,100,13,14
Marin,2.142857142857143,2021-12-26,607,625,549,76,6
Mariposa,2.142857142857143,2021-12-26,13,13,12,1,0
Mendocino,2.142857142857143,2021-12-26,60,61,55,6,6
Merced,2.142857142857143,2021-12-26,186,191,168,23,18
Modoc,2.142857142857143,2021-12-26,0,0,1,-1,3
Mono,2.142857142857143,2021-12-26,7,7,7,0,1
Monterey,2.142857142857143,2021-12-26,220,227,200,27,36
Napa,2.142857142857143,2021-12-26,251,258,226,32,6
Nevada,2.142857142857143,2021-12-26,77,80,71,9,6
Orange,2.142857142857143,2021-12-26,5406,5562,4865,697,303
Placer,2.142857142857143,2021-12-26,390,401,351,50,95
Plumas,2.142857142857143,2021-12-26,3,3,4,-1,0
Riverside,2.142857142857143,2021-12-26,4343,4469,3911,558,391
Sacramento,2.142857142857143,2021-12-26,1485,1528,1338,190,191
San Benito,2.142857142857143,2021-12-26,89,91,81,10,4
San Bernardino,2.142857142857143,2021-12-26,4149,4270,3736,534,466
San Diego,2.142857142857143,2021-12-26,6328,6513,5707,806,404
San Francisco,2.142857142857143,2021-12-26,2143,2206,1928,278,45
San Joaquin,2.142857142857143,2021-12-26,711,732,641,91,81
San Luis Obispo,2.142857142857143,2021-12-26,228,235,207,28,22
San Mateo,2.142857142857143,2021-12-26,1569,1614,1412,202,36
Santa Barbara,2.142857142857143,2021-12-26,745,767,672,95,39
Santa Clara,2.142857142857143,2021-12-26,3130,3221,2816,405,143
Santa Cruz,2.142857142857143,2021-12-26,346,356,312,44,14
Shasta,2.142857142857143,2021-12-26,83,86,76,10,40
Siskiyou,2.142857142857143,2021-12-26,8,8,8,0,0
Solano,2.142857142857143,2021-12-26,269,277,243,34,42
Sonoma,2.142857142857143,2021-12-26,705,725,636,89,22
Stanislaus,2.142857142857143,2021-12-26,444,456,400,56,116
Sutter,2.142857142857143,2021-12-26,78,80,71,9,0
Tehama,2.142857142857143,2021-12-26,39,40,36,4,11
Trinity,2.142857142857143,2021-12-26,3,3,4,-1,0
Tulare,2.142857142857143,2021-12-26,256,264,232,32,48
Tuolumne,2.142857142857143,2021-12-26,71,73,65,8,6
Ventura,2.142857142857143,2021-12-26,2077,2137,1872,265,84
Yolo,2.142857142857143,2021-12-26,248,255,224,31,8
Yuba,2.142857142857143,2021-12-26,61,63,56,7,11
Alameda,2.5714285714285716,2021-12-29,7523,7773,7077,696,151
Amador,2.5714285714285716,2021-12-29,59,61,56,5,6
Butte,2.5714285714285716,2021-12-29,412,426,388,38,40
Calaveras,2.5714285714285716,2021-12-29,59,62,57,5,2
Colusa,2.5714285714285716,2021-12-29,25,25,24,1,2
Contra Costa,2.5714285714285716,2021-12-29,5720,5910,5378,532,86
Del Norte,2.5714285714285716,2021-12-29,20,20,19,1,1
El Dorado,2.5714285714285716,2021-12-29,495,511,466,45,12
Fresno,2.5714285714285716,2021-12-29,2408,2489,2267,222,178
Glenn,2.5714285714285716,2021-12-29,41,42,39,3,0
Humboldt,2.5714285714285716,2021-12-29,366,378,344,34,11
Imperial,2.5714285714285716,2021-12-29,744,769,700,69,61
Inyo,2.5714285714285716,2021-12-29,109,113,104,9,0
Kern,2.5714285714285716,2021-12-29,1983,2049,1863,186,117
Kings,2.5714285714285716,2021-12-29,437,452,412,40,22
Lake,2.5714285714285716,2021-12-29,54,56,52,4,0
Lassen,2.5714285714285716,2021-12-29,20,20,19,1,1
Los Angeles,2.5714285714285716,2021-12-29,94049,97156,88340,8816,1508
Madera,2.5714285714285716,2021-12-29,358,370,337,33,16
Marin,2.5714285714285716,2021-12-29,1163,1202,1094,108,14
Mariposa,2.5714285714285716,2021-12-29,32,32,30,2,0
Mendocino,2.5714285714285716,2021-12-29,173,179,164,15,7
Merced,2.5714285714285716,2021-12-29,709,733,667,66,22
Modoc,2.5714285714285716,2021-12-29,4,4,5,-1,0
Mono,2.5714285714285716,2021-12-29,130,135,124,11,0
Monterey,2.5714285714285716,2021-12-29,631,652,594,58,28
Napa,2.5714285714285716,2021-12-29,805,832,758,74,7
Nevada,2.5714285714285716,2021-12-29,207,214,196,18,4
Orange,2.5714285714285716,2021-12-29,21014,21709,19745,1964,437
Placer,2.5714285714285716,2021-12-29,1161,1200,1093,107,115
Plumas,2.5714285714285716,2021-12-29,11,11,11,0,2
Riverside,2.5714285714285716,2021-12-29,13564,14014,12748,1266,464
Sacramento,2.5714285714285716,2021-12-29,5549,5733,5217,516,214
San Benito,2.5714285714285716,2021-12-29,338,350,320,30,4
San Bernardino,2.5714285714285716,2021-12-29,14932,15425,14030,1395,592
San Diego,2.5714285714285716,2021-12-29,27577,28490,25917,2573,496
San Francisco,2.5714285714285716,2021-12-29,4610,4762,4329,433,69
San Joaquin,2.5714285714285716,2021-12-29,2711,2801,2549,252,98
San Luis Obispo,2.5714285714285716,2021-12-29,1383,1429,1300,129,28
San Mateo,2.5714285714285716,2021-12-29,3521,3638,3308,330,39
Santa Barbara,2.5714285714285716,2021-12-29,2027,2093,1903,190,51
Santa Clara,2.5714285714285716,2021-12-29,8635,8921,8113,808,180
Santa Cruz,2.5714285714285716,2021-12-29,919,949,864,85,12
Shasta,2.5714285714285716,2021-12-29,217,225,205,20,42
Siskiyou,2.5714285714285716,2021-12-29,26,26,25,1,0
Solano,2.5714285714285716,2021-12-29,1936,2000,1822,178,63
Sonoma,2.5714285714285716,2021-12-29,1875,1937,1765,172,25
Stanislaus,2.5714285714285716,2021-12-29,1280,1322,1204,118,124
Sutter,2.5714285714285716,2021-12-29,166,172,157,15,0
Tehama,2.5714285714285716,2021-12-29,62,64,59,5,6
Trinity,2.5714285714285716,2021-12-29,2,2,3,-1,0
Tulare,2.5714285714285716,2021-12-29,715,739,673,66,46
Tuolumne,2.5714285714285716,2021-12-29,115,118,108,10,8
Ventura,2.5714285714285716,2021-12-29,5819,6012,5468,544,99
Yolo,2.5714285714285716,2021-12-29,873,902,821,81,12
Yuba,2.5714285714285716,2021-12-29,154,159,146,13,13
Alameda,3,2022-01-01,4978,5171,4821,350,181
Amador,3,2022-01-01,59,62,59,3,8
Butte,3,2022-01-01,318,330,309,21,30
Calaveras,3,2022-01-01,60,63,60,3,3
Colusa,3,2022-01-01,16,16,16,0,4
Contra Costa,3,2022-01-01,3689,3833,3579,254,113
Del Norte,3,2022-01-01,32,32,31,1,0
El Dorado,3,2022-01-01,365,379,355,24,17
Fresno,3,2022-01-01,1684,1749,1631,118,209
Glenn,3,2022-01-01,17,17,17,0,0
Humboldt,3,2022-01-01,234,243,228,15,10
Imperial,3,2022-01-01,456,474,444,30,57
Inyo,3,2022-01-01,75,78,74,4,3
Kern,3,2022-01-01,1701,1769,1655,114,126
Kings,3,2022-01-01,330,344,323,21,17
Lake,3,2022-01-01,52,54,51,3,2
Lassen,3,2022-01-01,20,20,20,0,2
Los Angeles,3,2022-01-01,58730,61026,56973,4053,1933
Madera,3,2022-01-01,221,230,216,14,19
Marin,3,2022-01-01,647,672,628,44,25
Mariposa,3,2022-01-01,31,32,31,1,0
Mendocino,3,2022-01-01,104,108,102,6,6
Merced,3,2022-01-01,374,389,364,25,22
Modoc,3,2022-01-01,8,8,8,0,0
Mono,3,2022-01-01,35,36,34,2,2
Monterey,3,2022-01-01,504,524,490,34,29
Napa,3,2022-01-01,542,563,526,37,10
Nevada,3,2022-01-01,203,210,197,13,6
Orange,3,2022-01-01,14546,15114,14109,1005,540
Placer,3,2022-01-01,915,951,889,62,142
Plumas,3,2022-01-01,19,19,19,0,2
Riverside,3,2022-01-01,9871,10255,9570,685,578
Sacramento,3,2022-01-01,4061,4219,3938,281,271
San Benito,3,2022-01-01,197,205,192,13,5
San Bernardino,3,2022-01-01,8821,9165,8555,610,668
San Diego,3,2022-01-01,17784,18476,17237,1239,645
San Francisco,3,2022-01-01,3328,3458,3231,227,89
San Joaquin,3,2022-01-01,2218,2305,2154,151,98
San Luis Obispo,3,2022-01-01,605,628,586,42,19
San Mateo,3,2022-01-01,2730,2838,2653,185,41
Santa Barbara,3,2022-01-01,1598,1660,1551,109,57
Santa Clara,3,2022-01-01,6889,7160,6693,467,224
Santa Cruz,3,2022-01-01,668,695,651,44,21
Shasta,3,2022-01-01,174,181,170,11,13
Siskiyou,3,2022-01-01,24,24,23,1,0
Solano,3,2022-01-01,1124,1167,1089,78,77
Sonoma,3,2022-01-01,1308,1359,1268,91,30
Stanislaus,3,2022-01-01,1041,1082,1012,70,129
Sutter,3,2022-01-01,179,185,174,11,0
Tehama,3,2022-01-01,74,77,73,4,4
Trinity,3,2022-01-01,5,5,6,-1,0
Tulare,3,2022-01-01,574,596,558,38,55
Tuolumne,3,2022-01-01,130,135,127,8,6
Ventura,3,2022-01-01,3854,4005,3742,263,129
Yolo,3,2022-01-01,550,572,536,36,10
Yuba,3,2022-01-01,149,155,146,9,22
Alameda,3.4285714285714284,2022-01-04,11594,12206,11753,453,231
Amador,3.4285714285714284,2022-01-04,147,154,149,5,7
Butte,3.4285714285714284,2022-01-04,753,793,763,30,40
Calaveras,3.4285714285714284,2022-01-04,138,145,141,4,3
Colusa,3.4285714285714284,2022-01-04,15,15,15,0,5
Contra Costa,3.4285714285714284,2022-01-04,7368,7753,7459,294,139
Del Norte,3.4285714285714284,2022-01-04,52,54,53,1,0
El Dorado,3.4285714285714284,2022-01-04,670,705,679,26,15
Fresno,3.4285714285714284,2022-01-04,4245,4469,4303,166,258
Glenn,3.4285714285714284,2022-01-04,59,62,61,1,0
Humboldt,3.4285714285714284,2022-01-04,506,531,511,20,16
Imperial,3.4285714285714284,2022-01-04,1385,1457,1404,53,66
Inyo,3.4285714285714284,2022-01-04,155,163,158,5,3
Kern,3.4285714285714284,2022-01-04,4141,4358,4194,164,145
Kings,3.4285714285714284,2022-01-04,692,728,701,27,19
Lake,3.4285714285714284,2022-01-04,180,189,183,6,3
Lassen,3.4285714285714284,2022-01-04,36,38,38,0,1
Los Angeles,3.4285714285714284,2022-01-04,121371,127756,122973,4783,2649
Madera,3.4285714285714284,2022-01-04,561,591,570,21,32
Marin,3.4285714285714284,2022-01-04,1342,1412,1359,53,20
Mariposa,3.4285714285714284,2022-01-04,73,77,75,2,0
Mendocino,3.4285714285714284,2022-01-04,348,366,353,13,8
Merced,3.4285714285714284,2022-01-04,1221,1286,1239,47,33
Modoc,3.4285714285714284,2022-01-04,8,8,9,-1,0
Mono,3.4285714285714284,2022-01-04,142,149,145,4,1
Monterey,3.4285714285714284,2022-01-04,1131,1191,1148,43,50
Napa,3.4285714285714284,2022-01-04,1189,1251,1205,46,15
Nevada,3.4285714285714284,2022-01-04,346,363,350,13,11
Orange,3.4285714285714284,2022-01-04,25074,26385,25387,998,702
Placer,3.4285714285714284,2022-01-04,1611,1695,1632,63,145
Plumas,3.4285714285714284,2022-01-04,40,42,41,1,1
Riverside,3.4285714285714284,2022-01-04,19484,20503,19726,777,771
Sacramento,3.4285714285714284,2022-01-04,9202,9688,9331,357,313
San Benito,3.4285714285714284,2022-01-04,432,454,437,17,5
San Bernardino,3.4285714285714284,2022-01-04,17001,17893,17220,673,787
San Diego,3.4285714285714284,2022-01-04,34713,36532,35153,1379,750
San Francisco,3.4285714285714284,2022-01-04,6203,6526,6277,249,123
San Joaquin,3.4285714285714284,2022-01-04,4437,4671,4498,173,126
San Luis Obispo,3.4285714285714284,2022-01-04,1698,1788,1723,65,31
San Mateo,3.4285714285714284,2022-01-04,5230,5502,5292,210,59
Santa Barbara,3.4285714285714284,2022-01-04,3404,3580,3444,136,64
Santa Clara,3.4285714285714284,2022-01-04,13799,14517,13961,556,316
Santa Cruz,3.4285714285714284,2022-01-04,1587,1671,1609,62,17
Shasta,3.4285714285714284,2022-01-04,367,386,372,14,52
Siskiyou,3.4285714285714284,2022-01-04,49,51,50,1,2
Solano,3.4285714285714284,2022-01-04,2317,2440,2351,89,83
Sonoma,3.4285714285714284,2022-01-04,3212,3382,3258,124,35
Stanislaus,3.4285714285714284,2022-01-04,1992,2096,2018,78,167
Sutter,3.4285714285714284,2022-01-04,380,399,385,14,0
Tehama,3.4285714285714284,2022-01-04,164,172,166,6,5
Trinity,3.4285714285714284,2022-01-04,8,8,9,-1,0
Tulare,3.4285714285714284,2022-01-04,1348,1419,1367,52,73
Tuolumne,3.4285714285714284,2022-01-04,268,282,272,10,15
Ventura,3.4285714285714284,2022-01-04,6855,7213,6940,273,176
Yolo,3.4285714285714284,2022-01-04,1623,1708,1643,65,12
Yuba,3.4285714285714284,2022-01-04,282,297,287,10,22
Alameda,3.857142857142857,2022-01-07,15270,16375,16045,330,327
Amador,3.857142857142857,2022-01-07,135,145,143,2,6
Butte,3.857142857142857,2022-01-07,836,897,880,17,46
Calaveras,3.857142857142857,2022-01-07,234,251,247,4,2
Colusa,3.857142857142857,2022-01-07,45,49,49,0,7
Contra Costa,3.857142857142857,2022-01-07,8500,9114,8931,183,176
Del Norte,3.857142857142857,2022-01-07,81,87,86,1,2
El Dorado,3.857142857142857,2022-01-07,883,946,928,18,13
Fresno,3.857142857142857,2022-01-07,6230,6680,6546,134,315
Glenn,3.857142857142857,2022-01-07,104,111,110,1,2
Humboldt,3.857142857142857,2022-01-07,652,698,685,13,17
Imperial,3.857142857142857,2022-01-07,1731,1856,1820,36,71
Inyo,3.857142857142857,2022-01-07,199,213,209,4,3
Kern,3.857142857142857,2022-01-07,4515,4838,4740,98,186
Kings,3.857142857142857,2022-01-07,871,935,918,17,23
Lake,3.857142857142857,2022-01-07,166,178,176,2,3
Lassen,3.857142857142857,2022-01-07,57,61,61,0,2
Los Angeles,3.857142857142857,2022-01-07,154496,165620,162246,3374,3361
Madera,3.857142857142857,2022-01-07,797,854,838,16,34
Marin,3.857142857142857,2022-01-07,1067,1143,1120,23,29
Mariposa,3.857142857142857,2022-01-07,81,87,86,1,0
Mendocino,3.857142857142857,2022-01-07,323,347,341,6,6
Merced,3.857142857142857,2022-01-07,1678,1800,1764,36,41
Modoc,3.857142857142857,2022-01-07,4,4,5,-1,0
Mono,3.857142857142857,2022-01-07,110,118,116,2,1
Monterey,3.857142857142857,2022-01-07,1677,1798,1763,35,60
Napa,3.857142857142857,2022-01-07,1202,1287,1261,26,16
Nevada,3.857142857142857,2022-01-07,490,526,517,9,12
Orange,3.857142857142857,2022-01-07,26160,28039,27466,573,905
Placer,3.857142857142857,2022-01-07,2182,2339,2292,47,177
Plumas,3.857142857142857,2022-01-07,37,40,40,0,4
Riverside,3.857142857142857,2022-01-07,21904,23480,23002,478,861
Sacramento,3.857142857142857,2022-01-07,11767,12612,12355,257,394
San Benito,3.857142857142857,2022-01-07,469,502,492,10,6
San Bernardino,3.857142857142857,2022-01-07,21197,22723,22261,462,952
San Diego,3.857142857142857,2022-01-07,36176,38766,37968,798,929
San Francisco,3.857142857142857,2022-01-07,7203,7722,7566,156,165
San Joaquin,3.857142857142857,2022-01-07,6534,7005,6864,141,156
San Luis Obispo,3.857142857142857,2022-01-07,2168,2323,2277,46,34
San Mateo,3.857142857142857,2022-01-07,5637,6046,5925,121,93
Santa Barbara,3.857142857142857,2022-01-07,3695,3960,3880,80,105
Santa Clara,3.857142857142857,2022-01-07,15468,16581,16244,337,411
Santa Cruz,3.857142857142857,2022-01-07,1920,2058,2017,41,20
Shasta,3.857142857142857,2022-01-07,356,382,375,7,44
Siskiyou,3.857142857142857,2022-01-07,40,43,43,0,4
Solano,3.857142857142857,2022-01-07,3013,3229,3164,65,85
Sonoma,3.857142857142857,2022-01-07,4047,4337,4249,88,64
Stanislaus,3.857142857142857,2022-01-07,2831,3037,2977,60,176
Sutter,3.857142857142857,2022-01-07,472,506,497,9,0
Tehama,3.857142857142857,2022-01-07,231,248,244,4,13
Trinity,3.857142857142857,2022-01-07,13,13,14,-1,0
Tulare,3.857142857142857,2022-01-07,1987,2129,2086,43,65
Tuolumne,3.857142857142857,2022-01-07,290,311,306,5,15
Ventura,3.857142857142857,2022-01-07,7246,7768,7610,158,222
Yolo,3.857142857142857,2022-01-07,1522,1631,1599,32,11
Yuba,3.857142857142857,2022-01-07,468,502,493,9,32
Alameda,4.285714285714286,2022-01-10,8150,9232,9169,63,363
Amador,4.285714285714286,2022-01-10,135,153,153,0,9
Butte,4.285714285714286,2022-01-10,648,735,731,4,60
Calaveras,4.285714285714286,2022-01-10,149,170,170,0,2
Colusa,4.285714285714286,2022-01-10,34,39,40,-1,5
Contra Costa,4.285714285714286,2022-01-10,5797,6566,6522,44,207
Del Norte,4.285714285714286,2022-01-10,59,67,68,-1,2
El Dorado,4.285714285714286,2022-01-10,547,622,619,3,16
Fresno,4.285714285714286,2022-01-10,4466,5068,5035,33,369
Glenn,4.285714285714286,2022-01-10,81,92,92,0,2
Humboldt,4.285714285714286,2022-01-10,448,509,507,2,21
Imperial,4.285714285714286,2022-01-10,968,1110,1105,5,83
Inyo,4.285714285714286,2022-01-10,135,156,156,0,4
Kern,4.285714285714286,2022-01-10,3660,4163,4137,26,218
Kings,4.285714285714286,2022-01-10,961,1097,1091,6,38
Lake,4.285714285714286,2022-01-10,155,175,175,0,1
Lassen,4.285714285714286,2022-01-10,73,84,85,-1,1
Los Angeles,4.285714285714286,2022-01-10,74395,84160,83566,594,3913
Madera,4.285714285714286,2022-01-10,559,635,632,3,28
Marin,4.285714285714286,2022-01-10,935,1055,1048,7,26
Mariposa,4.285714285714286,2022-01-10,58,67,68,-1,0
Mendocino,4.285714285714286,2022-01-10,333,379,378,1,10
Merced,4.285714285714286,2022-01-10,905,1038,1033,5,44
Modoc,4.285714285714286,2022-01-10,2,2,3,-1,0
Mono,4.285714285714286,2022-01-10,74,83,83,0,1
Monterey,4.285714285714286,2022-01-10,1158,1320,1313,7,59
Napa,4.285714285714286,2022-01-10,735,838,834,4,18
Nevada,4.285714285714286,2022-01-10,342,389,387,2,13
Orange,4.285714285714286,2022-01-10,13995,15870,15764,106,1034
Placer,4.285714285714286,2022-01-10,1614,1834,1823,11,222
Plumas,4.285714285714286,2022-01-10,35,41,42,-1,5
Riverside,4.285714285714286,2022-01-10,12794,14510,14413,97,938
Sacramento,4.285714285714286,2022-01-10,6924,7868,7817,51,491
San Benito,4.285714285714286,2022-01-10,378,430,428,2,5
San Bernardino,4.285714285714286,2022-01-10,11118,12602,12517,85,1010
San Diego,4.285714285714286,2022-01-10,17307,19614,19481,133,1087
San Francisco,4.285714285714286,2022-01-10,3830,4327,4297,30,202
San Joaquin,4.285714285714286,2022-01-10,4345,4965,4936,29,202
San Luis Obispo,4.285714285714286,2022-01-10,1018,1164,1158,6,39
San Mateo,4.285714285714286,2022-01-10,3769,4271,4243,28,124
Santa Barbara,4.285714285714286,2022-01-10,2800,3185,3166,19,94
Santa Clara,4.285714285714286,2022-01-10,11032,12516,12433,83,456
Santa Cruz,4.285714285714286,2022-01-10,1475,1671,1661,10,27
Shasta,4.285714285714286,2022-01-10,247,282,281,1,49
Siskiyou,4.285714285714286,2022-01-10,34,39,40,-1,4
Solano,4.285714285714286,2022-01-10,1849,2099,2086,13,121
Sonoma,4.285714285714286,2022-01-10,2448,2788,2771,17,80
Stanislaus,4.285714285714286,2022-01-10,2048,2333,2319,14,212
Sutter,4.285714285714286,2022-01-10,489,555,552,3,0
Tehama,4.285714285714286,2022-01-10,160,182,182,0,14
Trinity,4.285714285714286,2022-01-10,9,10,11,-1,0
Tulare,4.285714285714286,2022-01-10,1733,1981,1970,11,78
Tuolumne,4.285714285714286,2022-01-10,276,313,312,1,14
Ventura,4.285714285714286,2022-01-10,4640,5273,5239,34,270
Yolo,4.285714285714286,2022-01-10,1050,1190,1183,7,7
Yuba,4.285714285714286,2022-01-10,330,375,374,1,49
Alameda,4.714285714285714,2022-01-11,4123,5138,5124,14,366
Amador,4.714285714285714,2022-01-11,56,70,71,-1,9
Butte,4.714285714285714,2022-01-11,304,379,379,0,64
Calaveras,4.714285714285714,2022-01-11,68,85,86,-1,2
Colusa,4.714285714285714,2022-01-11,23,29,30,-1,4
Contra Costa,4.714285714285714,2022-01-11,2528,3150,3142,8,233
Del Norte,4.714285714285714,2022-01-11,26,32,33,-1,4
El Dorado,4.714285714285714,2022-01-11,314,391,391,0,16
Fresno,4.714285714285714,2022-01-11,2600,3240,3232,8,375
Glenn,4.714285714285714,2022-01-11,56,70,71,-1,2
Humboldt,4.714285714285714,2022-01-11,224,279,279,0,19
Imperial,4.714285714285714,2022-01-11,558,695,694,1,86
Inyo,4.714285714285714,2022-01-11,48,60,61,-1,4
Kern,4.714285714285714,2022-01-11,2127,2650,2643,7,236
Kings,4.714285714285714,2022-01-11,615,766,765,1,38
Lake,4.714285714285714,2022-01-11,46,57,58,-1,2
Lassen,4.714285714285714,2022-01-11,20,25,26,-1,1
Los Angeles,4.714285714285714,2022-01-11,32274,40217,40103,114,4071
Madera,4.714285714285714,2022-01-11,358,446,446,0,40
Marin,4.714285714285714,2022-01-11,346,431,431,0,23
Mariposa,4.714285714285714,2022-01-11,45,56,57,-1,0
Mendocino,4.714285714285714,2022-01-11,165,206,206,0,10
Merced,4.714285714285714,2022-01-11,635,791,790,1,48
Modoc,4.714285714285714,2022-01-11,2,2,3,-1,0
Mono,4.714285714285714,2022-01-11,63,79,80,-1,0
Monterey,4.714285714285714,2022-01-11,493,614,613,1,65
Napa,4.714285714285714,2022-01-11,231,288,288,0,22
Nevada,4.714285714285714,2022-01-11,194,242,242,0,12
Orange,4.714285714285714,2022-01-11,5368,6689,6671,18,1093
Placer,4.714285714285714,2022-01-11,688,857,856,1,229
Plumas,4.714285714285714,2022-01-11,20,25,26,-1,6
Riverside,4.714285714285714,2022-01-11,5086,6338,6321,17,996
Sacramento,4.714285714285714,2022-01-11,3584,4466,4454,12,479
San Benito,4.714285714285714,2022-01-11,152,189,189,0,7
San Bernardino,4.714285714285714,2022-01-11,5458,6801,6782,19,1077
San Diego,4.714285714285714,2022-01-11,6653,8290,8267,23,1103
San Francisco,4.714285714285714,2022-01-11,1430,1782,1778,4,222
San Joaquin,4.714285714285714,2022-01-11,2525,3146,3138,8,229
San Luis Obispo,4.714285714285714,2022-01-11,713,888,886,2,43
San Mateo,4.714285714285714,2022-01-11,1849,2304,2298,6,129
Santa Barbara,4.714285714285714,2022-01-11,1149,1432,1429,3,98
Santa Clara,4.714285714285714,2022-01-11,5115,6374,6357,17,486
Santa Cruz,4.714285714285714,2022-01-11,827,1031,1029,2,34
Shasta,4.714285714285714,2022-01-11,181,226,226,0,51
Siskiyou,4.714285714285714,2022-01-11,31,39,40,-1,4
Solano,4.714285714285714,2022-01-11,826,1029,1027,2,135
Sonoma,4.714285714285714,2022-01-11,1281,1596,1592,4,83
Stanislaus,4.714285714285714,2022-01-11,1164,1450,1447,3,205
Sutter,4.714285714285714,2022-01-11,209,260,260,0,0
Tehama,4.714285714285714,2022-01-11,106,132,133,-1,19
Trinity,4.714285714285714,2022-01-11,1,1,2,-1,0
Tulare,4.714285714285714,2022-01-11,1108,1381,1378,3,85
Tuolumne,4.714285714285714,2022-01-11,88,110,111,-1,10
Ventura,4.714285714285714,2022-01-11,2085,2598,2592,6,268
Yolo,4.714285714285714,2022-01-11,495,617,616,1,12
Yuba,4.714285714285714,2022-01-11,234,292,292,0,40
