county,time,date,cases,est_cases,est_omicron_cases,est_other_cases,tests,est_tests,est_omicron_tests,est_other_tests,hospitalizations
Alameda,1,2021-12-25,5417,5429,2694,2735,83120,83318,40980,42338,86
Amador,1,2021-12-25,76,76,27,49,1474,1478,528,950,4
Butte,1,2021-12-25,347,347,187,160,3808,3818,2032,1786,31
Calaveras,1,2021-12-25,72,72,29,43,965,967,381,586,2
Colusa,1,2021-12-25,15,15,6,9,239,239,97,142,2
Contra Costa,1,2021-12-25,3265,3274,1256,2018,43045,43147,16363,26784,49
Del Norte,1,2021-12-25,20,20,9,11,1225,1228,524,704,0
El Dorado,1,2021-12-25,386,386,151,235,4121,4131,1583,2548,11
Fresno,1,2021-12-25,1526,1531,560,971,22560,22615,8171,14444,152
Glenn,1,2021-12-25,37,37,15,22,412,412,170,242,0
Humboldt,1,2021-12-25,334,334,140,194,3141,3149,1279,1870,10
Imperial,1,2021-12-25,659,659,254,405,5420,5434,2088,3346,51
Inyo,1,2021-12-25,81,81,39,42,419,419,196,223,0
Kern,1,2021-12-25,1205,1207,499,708,19629,19676,8044,11632,98
Kings,1,2021-12-25,352,352,131,221,5355,5367,1958,3409,20
Lake,1,2021-12-25,43,43,15,28,1144,1148,399,749,0
Lassen,1,2021-12-25,19,19,9,10,2322,2329,1068,1261,0
Los Angeles,1,2021-12-25,66394,66553,48260,18293,660095,661672,477636,184036,904
Madera,1,2021-12-25,209,209,78,131,4152,4162,1508,2654,12
Marin,1,2021-12-25,1161,1163,460,703,14380,14414,5674,8740,4
Mariposa,1,2021-12-25,31,31,11,20,504,504,183,321,0
Mendocino,1,2021-12-25,86,86,25,61,2497,2502,714,1788,6
Merced,1,2021-12-25,428,428,172,256,4860,4871,1939,2932,2
Modoc,1,2021-12-25,5,5,2,3,57,57,24,33,2
Mono,1,2021-12-25,93,93,30,63,356,356,111,245,1
Monterey,1,2021-12-25,722,722,197,525,12220,12250,3274,8976,35
Napa,1,2021-12-25,559,559,237,322,5566,5579,2341,3238,5
Nevada,1,2021-12-25,204,204,72,132,2513,2518,871,1647,6
Orange,1,2021-12-25,10813,10840,4592,6248,106596,106851,44782,62069,256
Placer,1,2021-12-25,920,920,314,606,10314,10339,3471,6868,82
Plumas,1,2021-12-25,11,11,4,7,395,395,140,255,0
Riverside,1,2021-12-25,9321,9342,3369,5973,76506,76688,27287,49401,357
Sacramento,1,2021-12-25,3400,3409,1423,1986,47935,48050,19833,28217,158
San Benito,1,2021-12-25,204,204,96,108,2097,2101,978,1123,5
San Bernardino,1,2021-12-25,8894,8916,4387,4529,79722,79912,38892,41020,421
San Diego,1,2021-12-25,17475,17517,12215,5302,156996,157372,109236,48136,355
San Francisco,1,2021-12-25,5595,5608,1807,3801,62128,62276,19934,42342,34
San Joaquin,1,2021-12-25,1556,1561,616,945,20818,20868,8113,12755,74
San Luis Obispo,1,2021-12-25,718,718,326,392,10144,10168,4570,5598,22
San Mateo,1,2021-12-25,3547,3555,1866,1689,50458,50578,26285,24293,18
Santa Barbara,1,2021-12-25,1417,1421,595,826,13837,13870,5711,8159,37
Santa Clara,1,2021-12-25,6165,6179,4281,1898,97870,98104,67453,30651,114
Santa Cruz,1,2021-12-25,655,655,316,339,11583,11610,5508,6102,14
Shasta,1,2021-12-25,198,198,71,127,4589,4598,1617,2981,37
Siskiyou,1,2021-12-25,15,15,7,8,344,344,161,183,0
Solano,1,2021-12-25,846,847,359,488,15109,15145,6369,8776,29
Sonoma,1,2021-12-25,1330,1332,563,769,18924,18970,7899,11071,16
Stanislaus,1,2021-12-25,881,881,278,603,10381,10406,3227,7179,104
Sutter,1,2021-12-25,177,177,70,107,2013,2017,787,1230,0
Tehama,1,2021-12-25,64,64,19,45,1047,1050,303,747,11
Trinity,1,2021-12-25,3,3,1,2,96,96,32,64,0
Tulare,1,2021-12-25,561,561,172,389,10434,10458,3135,7323,47
Tuolumne,1,2021-12-25,133,133,49,84,1743,1747,631,1116,5
Ventura,1,2021-12-25,3580,3587,1911,1676,34020,34102,17972,16130,74
Yolo,1,2021-12-25,544,544,258,286,20050,20099,9400,10699,7
Yuba,1,2021-12-25,116,116,49,67,1501,1505,623,882,11
Alameda,2,2022-01-01,13871,13906,7895,6011,102090,102346,57926,44420,150
Amador,2,2022-01-01,148,148,64,84,1850,1854,797,1057,7
Butte,2,2022-01-01,900,900,548,352,5681,5694,3447,2247,30
Calaveras,2,2022-01-01,170,170,80,90,1148,1151,538,613,3
Colusa,2,2022-01-01,53,53,26,27,299,299,144,155,4
Contra Costa,2,2022-01-01,11110,11137,5049,6088,59679,59828,27022,32806,85
Del Norte,2,2022-01-01,61,61,31,30,1963,1968,982,986,0
El Dorado,2,2022-01-01,1002,1004,462,542,5333,5346,2445,2901,17
Fresno,2,2022-01-01,5028,5041,2192,2849,34827,34915,15131,19784,188
Glenn,2,2022-01-01,68,68,33,35,517,517,251,266,0
Humboldt,2,2022-01-01,721,721,349,372,4664,4675,2252,2423,10
Imperial,2,2022-01-01,1499,1503,688,815,8193,8214,3754,4460,57
Inyo,2,2022-01-01,207,207,113,94,598,598,324,274,3
Kern,2,2022-01-01,4272,4283,2083,2200,30062,30138,14532,15606,121
Kings,2,2022-01-01,872,872,383,489,7435,7455,3262,4193,17
Lake,2,2022-01-01,144,144,61,83,1470,1474,618,856,1
Lassen,2,2022-01-01,45,45,24,21,2511,2517,1332,1185,2
Los Angeles,2,2022-01-01,175197,175638,136694,38944,912091,914388,711227,203161,1792
Madera,2,2022-01-01,661,661,289,372,5686,5700,2475,3225,13
Marin,2,2022-01-01,2211,2216,1024,1192,17587,17631,8134,9497,19
Mariposa,2,2022-01-01,73,73,32,41,533,533,232,301,0
Mendocino,2,2022-01-01,325,325,114,211,2901,2907,1018,1889,6
Merced,2,2022-01-01,1223,1227,580,647,7403,7423,3509,3914,22
Modoc,2,2022-01-01,11,11,6,5,52,52,26,26,0
Mono,2,2022-01-01,170,170,64,106,386,386,146,240,2
Monterey,2,2022-01-01,1975,1980,658,1322,17496,17538,5798,11740,29
Napa,2,2022-01-01,1518,1522,750,772,10129,10154,4992,5162,10
Nevada,2,2022-01-01,472,472,201,271,2183,2189,925,1264,6
Orange,2,2022-01-01,39445,39545,19516,20029,199487,199989,98479,101510,522
Placer,2,2022-01-01,2381,2387,978,1409,14038,14073,5715,8358,124
Plumas,2,2022-01-01,36,36,16,20,352,352,150,202,2
Riverside,2,2022-01-01,26665,26731,11469,15262,125616,125933,53805,72128,545
Sacramento,2,2022-01-01,11300,11328,5544,5784,71510,71690,34936,36754,243
San Benito,2,2022-01-01,617,617,333,284,3032,3040,1639,1401,5
San Bernardino,2,2022-01-01,28026,28096,15798,12298,122892,123201,69166,54035,624
San Diego,2,2022-01-01,53226,53359,40250,13109,229966,230545,173720,56825,628
San Francisco,2,2022-01-01,9653,9677,3762,5915,74984,75174,29136,46038,84
San Joaquin,2,2022-01-01,5515,5530,2579,2951,32321,32403,14994,17409,94
San Luis Obispo,2,2022-01-01,2118,2122,1111,1011,14801,14839,7768,7071,19
San Mateo,2,2022-01-01,8994,9017,5351,3666,67506,67676,40078,27598,34
Santa Barbara,2,2022-01-01,4182,4193,2048,2145,22303,22360,10888,11472,57
Santa Clara,2,2022-01-01,17643,17688,13274,4414,134012,134349,100537,33812,198
Santa Cruz,2,2022-01-01,1857,1863,1031,832,15281,15319,8417,6902,21
Shasta,2,2022-01-01,439,439,189,250,5442,5457,2311,3146,13
Siskiyou,2,2022-01-01,57,57,31,26,456,456,247,209,0
Solano,2,2022-01-01,3488,3496,1731,1765,24086,24147,11913,12234,62
Sonoma,2,2022-01-01,3698,3707,1825,1882,27935,28005,13707,14298,29
Stanislaus,2,2022-01-01,2635,2642,1010,1632,15970,16010,6055,9955,120
Sutter,2,2022-01-01,402,402,188,214,2617,2623,1215,1408,0
Tehama,2,2022-01-01,169,169,61,108,1173,1176,414,762,4
Trinity,2,2022-01-01,9,9,4,5,101,101,40,61,0
Tulare,2,2022-01-01,1604,1609,597,1012,14668,14705,5393,9312,53
Tuolumne,2,2022-01-01,284,284,124,160,1902,1907,827,1080,6
Ventura,2,2022-01-01,11375,11404,6864,4540,55655,55795,33481,22314,124
Yolo,2,2022-01-01,1627,1632,892,740,25313,25376,13729,11647,10
Yuba,2,2022-01-01,358,358,177,181,2056,2061,1009,1052,22
Alameda,3,2022-01-08,31033,31117,19939,11178,191099,191613,122660,68953,307
Amador,3,2022-01-08,374,374,189,185,2778,2786,1397,1389,6
Butte,3,2022-01-08,1924,1931,1305,626,9996,10022,6768,3254,47
Calaveras,3,2022-01-08,454,454,249,205,2435,2441,1329,1112,2
Colusa,3,2022-01-08,76,76,43,33,658,658,365,293,5
Contra Costa,3,2022-01-08,18931,18982,10023,8959,102130,102404,54104,48300,172
Del Norte,3,2022-01-08,161,161,93,68,3855,3865,2244,1621,2
El Dorado,3,2022-01-08,2116,2121,1131,990,8873,8897,4741,4156,18
Fresno,3,2022-01-08,12022,12055,6162,5893,57974,58131,29645,28486,284
Glenn,3,2022-01-08,181,181,103,78,872,873,491,382,2
Humboldt,3,2022-01-08,1413,1418,793,625,8252,8275,4627,3648,16
Imperial,3,2022-01-08,3416,3426,1824,1602,13729,13766,7326,6440,74
Inyo,3,2022-01-08,392,392,240,152,1243,1246,766,480,4
Kern,3,2022-01-08,10962,10992,6148,4844,55468,55618,31037,24581,191
Kings,3,2022-01-08,1949,1954,1005,949,11902,11934,6126,5808,22
Lake,3,2022-01-08,456,456,225,231,2672,2679,1318,1361,2
Lassen,3,2022-01-08,119,119,72,47,3627,3636,2182,1454,2
Los Angeles,3,2022-01-08,333552,334451,276435,58016,1909188,1914330,1582510,331820,3364
Madera,3,2022-01-08,1701,1707,876,831,10067,10095,5150,4945,26
Marin,3,2022-01-08,3076,3084,1663,1421,21669,21728,11728,10000,23
Mariposa,3,2022-01-08,181,181,92,89,1104,1107,566,541,0
Mendocino,3,2022-01-08,807,807,342,465,5478,5492,2321,3171,7
Merced,3,2022-01-08,3162,3171,1744,1427,13340,13376,7342,6034,39
Modoc,3,2022-01-08,16,16,9,7,95,95,54,41,0
Mono,3,2022-01-08,261,261,118,143,841,842,382,460,1
Monterey,3,2022-01-08,4464,4476,1797,2679,32076,32163,12874,19289,56
Napa,3,2022-01-08,2692,2698,1526,1172,14849,14888,8416,6472,15
Nevada,3,2022-01-08,1102,1104,548,556,4899,4912,2428,2484,15
Orange,3,2022-01-08,61465,61630,34967,26663,312998,313840,178269,135571,907
Placer,3,2022-01-08,4818,4830,2335,2495,21304,21362,10299,11063,165
Plumas,3,2022-01-08,120,120,60,60,784,784,390,394,4
Riverside,3,2022-01-08,47597,47725,24008,23717,185244,185741,93417,92324,851
Sacramento,3,2022-01-08,26621,26692,15062,11630,119987,120309,67753,52556,399
San Benito,3,2022-01-08,964,966,591,375,4320,4332,2653,1679,6
San Bernardino,3,2022-01-08,47406,47532,30181,17351,188408,188915,119998,68917,923
San Diego,3,2022-01-08,85942,86174,69412,16762,343335,344259,277324,66935,943
San Francisco,3,2022-01-08,16272,16316,7524,8792,121372,121699,56233,65466,156
San Joaquin,3,2022-01-08,12928,12964,6999,5965,59817,59978,32322,27656,150
San Luis Obispo,3,2022-01-08,4269,4281,2569,1712,21780,21839,13088,8751,40
San Mateo,3,2022-01-08,15105,15146,10038,5108,114145,114454,75799,38655,97
Santa Barbara,3,2022-01-08,8331,8354,4690,3664,45769,45892,25790,20102,77
Santa Clara,3,2022-01-08,34981,35075,28093,6982,262209,262915,210613,52302,391
Santa Cruz,3,2022-01-08,4357,4369,2729,1640,41800,41913,26150,15763,18
Shasta,3,2022-01-08,992,992,497,495,8244,8266,4122,4144,54
Siskiyou,3,2022-01-08,106,106,65,41,874,875,535,340,5
Solano,3,2022-01-08,6545,6563,3747,2816,35747,35844,20425,15419,88
Sonoma,3,2022-01-08,8374,8397,4764,3633,46913,47038,26608,20430,71
Stanislaus,3,2022-01-08,5965,5981,2718,3263,27067,27140,12282,14858,168
Sutter,3,2022-01-08,1088,1089,590,499,4671,4684,2525,2159,0
Tehama,3,2022-01-08,460,460,197,263,2393,2398,1020,1378,12
Trinity,3,2022-01-08,32,32,15,17,263,263,125,138,0
Tulare,3,2022-01-08,4320,4332,1921,2411,22500,22561,9952,12609,62
Tuolumne,3,2022-01-08,702,702,358,344,4033,4045,2053,1992,14
Ventura,3,2022-01-08,17627,17674,11868,5806,87050,87283,58615,28668,228
Yolo,3,2022-01-08,3967,3979,2455,1524,50700,50837,31349,19488,8
Yuba,3,2022-01-08,925,925,524,401,3807,3819,2160,1659,35
Alameda,4,2022-01-15,26998,27077,19072,8005,185873,186412,131292,55120,402
Amador,4,2022-01-15,491,491,283,208,3823,3834,2204,1630,9
Butte,4,2022-01-15,2114,2121,1562,559,9634,9662,7104,2558,55
Calaveras,4,2022-01-15,612,612,376,236,2724,2731,1680,1051,5
Colusa,4,2022-01-15,165,165,103,62,799,801,499,302,2
Contra Costa,4,2022-01-15,16560,16608,9962,6646,95669,95947,57576,38371,238
Del Norte,4,2022-01-15,201,201,129,72,3970,3982,2553,1429,3
El Dorado,4,2022-01-15,2178,2185,1316,869,9015,9041,5450,3591,16
Fresno,4,2022-01-15,16754,16802,9798,7004,68077,68274,39763,28511,430
Glenn,4,2022-01-15,307,307,195,112,1061,1065,674,391,2
Humboldt,4,2022-01-15,1259,1263,793,470,8891,8916,5607,3309,24
Imperial,4,2022-01-15,3729,3741,2256,1485,14294,14336,8654,5682,94
Inyo,4,2022-01-15,397,397,269,128,1238,1242,842,400,3
Kern,4,2022-01-15,13184,13222,8306,4916,59454,59626,37437,22189,256
Kings,4,2022-01-15,3495,3506,2052,1454,16569,16618,9737,6881,46
Lake,4,2022-01-15,590,590,334,256,3193,3202,1816,1386,4
Lassen,4,2022-01-15,279,279,186,93,3783,3794,2536,1258,1
Los Angeles,4,2022-01-15,249879,250604,216484,34120,1800839,1806070,1561105,244965,4507
Madera,4,2022-01-15,2429,2435,1424,1011,11172,11204,6537,4667,32
Marin,4,2022-01-15,2675,2682,1639,1043,19352,19409,11866,7543,34
Mariposa,4,2022-01-15,189,189,109,80,1227,1232,717,515,0
Mendocino,4,2022-01-15,983,984,488,496,5575,5592,2771,2821,22
Merced,4,2022-01-15,4152,4163,2580,1583,14974,15017,9300,5717,53
Modoc,4,2022-01-15,10,10,6,4,110,110,70,40,0
Mono,4,2022-01-15,235,235,123,112,856,857,452,405,1
Monterey,4,2022-01-15,6067,6085,2884,3201,30168,30256,14276,15980,74
Napa,4,2022-01-15,2193,2199,1396,803,13379,13418,8517,4901,24
Nevada,4,2022-01-15,1317,1322,750,572,5720,5738,3250,2488,23
Orange,4,2022-01-15,47131,47267,30078,17189,282157,282975,180278,102697,1200
Placer,4,2022-01-15,4744,4757,2632,2125,21334,21396,11840,9556,207
Plumas,4,2022-01-15,186,186,105,81,806,808,458,350,4
Riverside,4,2022-01-15,45499,45631,26244,19387,182746,183276,105504,77772,1006
Sacramento,4,2022-01-15,23582,23651,14968,8683,111607,111932,70813,41119,533
San Benito,4,2022-01-15,944,945,639,306,4434,4447,3015,1432,8
San Bernardino,4,2022-01-15,42260,42382,29604,12778,181705,182234,127484,54750,1100
San Diego,4,2022-01-15,67476,67671,57331,10340,286884,287717,243847,43870,1206
San Francisco,4,2022-01-15,11800,11833,6334,5499,100550,100843,53987,46856,230
San Joaquin,4,2022-01-15,14288,14331,8722,5609,65099,65287,39731,25556,239
San Luis Obispo,4,2022-01-15,4101,4112,2743,1369,22531,22596,15071,7525,42
San Mateo,4,2022-01-15,13882,13923,10083,3840,109047,109363,79199,30164,111
Santa Barbara,4,2022-01-15,7602,7625,4808,2817,44892,45021,28418,16603,122
Santa Clara,4,2022-01-15,31569,31662,26694,4968,252854,253587,213841,39746,494
Santa Cruz,4,2022-01-15,4369,4380,3022,1358,45082,45212,31209,14003,34
Shasta,4,2022-01-15,1315,1320,759,561,9714,9742,5575,4167,74
Siskiyou,4,2022-01-15,160,160,109,51,1051,1054,712,342,5
Solano,4,2022-01-15,7019,7039,4513,2526,38497,38609,24727,13882,129
Sonoma,4,2022-01-15,8151,8174,5196,2978,46853,46988,29863,17125,91
Stanislaus,4,2022-01-15,7652,7675,4032,3643,30904,30994,16252,14742,219
Sutter,4,2022-01-15,1370,1375,838,537,5158,5172,3149,2023,0
Tehama,4,2022-01-15,634,634,317,317,2607,2614,1300,1314,15
Trinity,4,2022-01-15,43,43,23,20,272,272,148,124,0
Tulare,4,2022-01-15,7576,7598,3912,3686,28155,28236,14507,13729,96
Tuolumne,4,2022-01-15,941,941,547,394,4438,4451,2581,1870,9
Ventura,4,2022-01-15,13864,13903,10163,3740,76331,76553,55987,20566,338
Yolo,4,2022-01-15,3129,3139,2143,996,43892,44018,30092,13926,18
Yuba,4,2022-01-15,1105,1108,702,406,4012,4023,2546,1477,37
Alameda,5,2022-01-22,20511,20574,15673,4901,161677,162182,123673,38509,446
Amador,5,2022-01-22,561,561,363,198,4340,4354,2824,1530,11
Butte,5,2022-01-22,1953,1958,1545,413,8698,8727,6887,1840,88
Calaveras,5,2022-01-22,594,594,406,188,2441,2447,1671,776,7
Colusa,5,2022-01-22,160,160,110,50,810,811,560,251,5
Contra Costa,5,2022-01-22,13208,13249,8852,4397,81279,81534,54561,26973,302
Del Norte,5,2022-01-22,298,298,211,87,3830,3841,2711,1130,2
El Dorado,5,2022-01-22,1546,1551,1042,509,7237,7260,4880,2380,28
Fresno,5,2022-01-22,17605,17659,11500,6159,67808,68020,44326,23694,554
Glenn,5,2022-01-22,253,253,177,76,927,929,648,281,0
Humboldt,5,2022-01-22,981,984,683,301,7465,7488,5207,2281,22
Imperial,5,2022-01-22,3536,3547,2387,1160,12788,12828,8632,4196,85
Inyo,5,2022-01-22,158,158,117,41,609,609,449,160,1
Kern,5,2022-01-22,10702,10736,7465,3271,50520,50678,35259,15419,319
Kings,5,2022-01-22,4081,4094,2682,1412,16943,16997,11151,5846,43
Lake,5,2022-01-22,684,684,435,249,3179,3188,2021,1167,9
Lassen,5,2022-01-22,431,431,315,116,3492,3502,2554,948,1
Los Angeles,5,2022-01-22,171875,172411,154350,18061,1532762,1537554,1377608,159946,4569
Madera,5,2022-01-22,2758,2766,1809,957,11431,11468,7486,3982,54
Marin,5,2022-01-22,1958,1965,1333,632,17028,17080,11607,5473,51
Mariposa,5,2022-01-22,149,149,97,52,940,942,614,328,0
Mendocino,5,2022-01-22,963,966,550,416,4825,4840,2758,2082,22
Merced,5,2022-01-22,3177,3187,2187,1000,12393,12432,8539,3893,61
Modoc,5,2022-01-22,16,16,11,5,104,104,73,31,0
Mono,5,2022-01-22,97,97,58,39,462,462,276,186,1
Monterey,5,2022-01-22,5325,5341,2914,2427,31409,31508,17221,14287,102
Napa,5,2022-01-22,1704,1709,1198,511,11814,11852,8318,3534,24
Nevada,5,2022-01-22,1045,1048,668,380,4756,4770,3037,1733,26
Orange,5,2022-01-22,29983,30077,21103,8974,225858,226564,159418,67146,1162
Placer,5,2022-01-22,3820,3832,2397,1435,18211,18267,11429,6838,257
Plumas,5,2022-01-22,218,218,138,80,883,885,562,323,6
Riverside,5,2022-01-22,33750,33856,21857,11999,156237,156724,101316,55408,1048
Sacramento,5,2022-01-22,17944,18000,12575,5425,94893,95188,66564,28624,614
San Benito,5,2022-01-22,853,854,631,223,3958,3970,2939,1031,8
San Bernardino,5,2022-01-22,28513,28603,21671,6932,147874,148337,112537,35800,1207
San Diego,5,2022-01-22,53887,54056,47675,6381,247071,247843,218688,29155,1309
San Francisco,5,2022-01-22,8879,8907,5394,3513,86772,87044,52885,34159,278
San Joaquin,5,2022-01-22,11253,11288,7643,3645,56094,56268,38101,18167,296
San Luis Obispo,5,2022-01-22,3595,3607,2628,979,20759,20823,15189,5634,51
San Mateo,5,2022-01-22,9291,9320,7259,2061,90614,90898,70952,19946,154
Santa Barbara,5,2022-01-22,6569,6590,4596,1994,41115,41245,28792,12453,141
Santa Clara,5,2022-01-22,23344,23418,20578,2840,220206,220895,194211,26684,515
Santa Cruz,5,2022-01-22,5315,5331,4013,1318,48508,48661,36692,11969,43
Shasta,5,2022-01-22,1452,1457,937,520,9453,9482,6095,3387,81
Siskiyou,5,2022-01-22,156,156,115,41,821,823,606,217,6
Solano,5,2022-01-22,5039,5055,3566,1489,30893,30991,21863,9128,155
Sonoma,5,2022-01-22,7218,7240,5080,2160,41260,41389,29049,12340,106
Stanislaus,5,2022-01-22,6689,6710,4010,2700,27827,27914,16682,11232,303
Sutter,5,2022-01-22,1109,1114,754,360,4983,4999,3387,1612,0
Tehama,5,2022-01-22,578,578,330,248,2446,2452,1402,1050,20
Trinity,5,2022-01-22,66,66,41,25,311,311,192,119,0
Tulare,5,2022-01-22,7842,7866,4616,3250,28376,28464,16711,11753,130
Tuolumne,5,2022-01-22,889,890,580,310,3587,3599,2344,1255,17
Ventura,5,2022-01-22,9890,9921,7799,2122,64464,64666,50900,13766,355
Yolo,5,2022-01-22,2315,2323,1726,597,38320,38440,28636,9804,24
Yuba,5,2022-01-22,939,943,659,284,3727,3740,2614,1126,65
Alameda,6,2022-01-29,12535,12578,10184,2394,143343,143835,116553,27282,417
Amador,6,2022-01-29,364,364,258,106,3262,3273,2326,947,18
Butte,6,2022-01-29,1279,1284,1070,214,7910,7937,6611,1326,101
Calaveras,6,2022-01-29,282,282,208,74,1919,1924,1426,498,4
Colusa,6,2022-01-29,118,118,88,30,685,687,514,173,2
Contra Costa,6,2022-01-29,8236,8264,6010,2254,72227,72474,52842,19632,285
Del Norte,6,2022-01-29,357,357,272,85,4128,4142,3155,987,9
El Dorado,6,2022-01-29,840,842,616,226,6180,6200,4542,1658,20
Fresno,6,2022-01-29,12083,12125,8652,3473,58419,58619,41843,16776,586
Glenn,6,2022-01-29,208,208,157,51,762,763,576,187,4
Humboldt,6,2022-01-29,614,614,462,152,6164,6186,4654,1532,26
Imperial,6,2022-01-29,2541,2550,1863,687,12253,12295,9005,3290,103
Inyo,6,2022-01-29,66,66,52,14,507,508,400,108,4
Kern,6,2022-01-29,6423,6443,4844,1599,43960,44112,33201,10911,304
Kings,6,2022-01-29,2773,2782,1992,790,15067,15119,10830,4289,52
Lake,6,2022-01-29,560,561,391,170,3392,3403,2379,1024,10
Lassen,6,2022-01-29,347,347,272,75,3643,3656,2857,799,5
Los Angeles,6,2022-01-29,88324,88626,81451,7175,1339094,1343687,1235736,107951,3852
Madera,6,2022-01-29,1818,1823,1303,520,9844,9878,7053,2825,52
Marin,6,2022-01-29,1223,1228,906,322,14261,14310,10567,3743,48
Mariposa,6,2022-01-29,106,106,76,30,867,870,622,248,0
Mendocino,6,2022-01-29,541,541,344,197,3603,3615,2307,1308,14
Merced,6,2022-01-29,2293,2300,1711,589,10959,10996,8193,2803,64
Modoc,6,2022-01-29,12,12,9,3,98,98,74,24,2
Mono,6,2022-01-29,42,42,28,14,344,344,230,114,0
Monterey,6,2022-01-29,3862,3876,2387,1489,26896,26988,16644,10344,113
Napa,6,2022-01-29,1126,1131,857,274,9855,9890,7496,2394,22
Nevada,6,2022-01-29,677,678,474,204,4139,4154,2908,1246,30
Orange,6,2022-01-29,14348,14397,10917,3480,185329,185963,141290,44673,967
Placer,6,2022-01-29,2576,2585,1782,803,15846,15899,10975,4924,215
Plumas,6,2022-01-29,154,154,107,47,750,751,524,227,2
Riverside,6,2022-01-29,19213,19278,13635,5643,127209,127644,90511,37133,952
Sacramento,6,2022-01-29,11764,11805,8911,2894,81559,81838,61873,19965,588
San Benito,6,2022-01-29,528,528,417,111,3369,3380,2677,703,7
San Bernardino,6,2022-01-29,15557,15611,12581,3030,122427,122848,99203,23645,1004
San Diego,6,2022-01-29,29256,29356,26667,2689,193234,193896,176227,17669,1210
San Francisco,6,2022-01-29,4944,4961,3327,1634,75167,75426,50819,24607,259
San Joaquin,6,2022-01-29,6492,6513,4793,1720,45318,45472,33472,12000,306
San Luis Obispo,6,2022-01-29,2305,2312,1805,507,17373,17431,13631,3800,67
San Mateo,6,2022-01-29,5102,5119,4220,899,79526,79799,65886,13913,155
Santa Barbara,6,2022-01-29,4285,4300,3238,1062,36540,36665,27665,9000,112
Santa Clara,6,2022-01-29,15814,15867,14378,1489,209911,210631,191005,19626,518
Santa Cruz,6,2022-01-29,3560,3573,2861,712,46905,47066,37813,9253,45
Shasta,6,2022-01-29,1081,1085,765,320,8675,8704,6138,2566,82
Siskiyou,6,2022-01-29,125,125,99,26,699,701,553,148,13
Solano,6,2022-01-29,4154,4168,3180,988,29982,30086,22934,7152,165
Sonoma,6,2022-01-29,4219,4233,3203,1030,33733,33848,25647,8201,101
Stanislaus,6,2022-01-29,4096,4110,2728,1382,22822,22901,15219,7682,321
Sutter,6,2022-01-29,702,703,518,185,3940,3954,2912,1042,0
Tehama,6,2022-01-29,406,406,259,147,2160,2166,1385,781,22
Trinity,6,2022-01-29,39,39,27,12,221,221,150,71,0
Tulare,6,2022-01-29,5362,5380,3518,1862,24539,24624,16120,8504,149
Tuolumne,6,2022-01-29,828,831,591,240,3418,3430,2445,985,19
Ventura,6,2022-01-29,5571,5590,4639,951,55430,55619,46210,9409,312
Yolo,6,2022-01-29,1572,1578,1252,326,37793,37923,30191,7732,21
Yuba,6,2022-01-29,611,611,461,150,3072,3083,2330,753,75
Alameda,7,2022-02-05,6829,6856,5831,1025,121428,121903,103820,18083,347
Amador,7,2022-02-05,239,239,182,57,3060,3072,2353,719,16
Butte,7,2022-02-05,865,868,755,113,6582,6608,5749,859,85
Calaveras,7,2022-02-05,212,212,168,44,1565,1571,1244,327,2
Colusa,7,2022-02-05,89,89,71,18,569,571,455,116,4
Contra Costa,7,2022-02-05,4511,4528,3542,986,57647,57874,45328,12546,239
Del Norte,7,2022-02-05,240,240,195,45,3891,3907,3166,741,7
El Dorado,7,2022-02-05,501,501,393,108,5151,5171,4062,1109,29
Fresno,7,2022-02-05,7103,7132,5487,1645,45935,46116,35510,10606,561
Glenn,7,2022-02-05,138,138,111,27,641,642,516,126,4
Humboldt,7,2022-02-05,492,492,395,97,5034,5054,4059,995,21
Imperial,7,2022-02-05,1283,1288,1011,277,8881,8916,7006,1910,81
Inyo,7,2022-02-05,52,52,43,9,448,448,373,75,3
Kern,7,2022-02-05,3917,3932,3156,776,36332,36474,29298,7176,233
Kings,7,2022-02-05,1509,1514,1168,346,10783,10825,8359,2466,57
Lake,7,2022-02-05,385,385,291,94,2746,2758,2088,670,9
Lassen,7,2022-02-05,156,156,129,27,3202,3214,2659,555,5
Los Angeles,7,2022-02-05,43768,43939,41232,2707,1182340,1186965,1114489,72476,2841
Madera,7,2022-02-05,1235,1240,955,285,8417,8450,6511,1939,51
Marin,7,2022-02-05,719,720,569,151,12077,12124,9589,2535,33
Mariposa,7,2022-02-05,56,56,43,13,624,626,482,144,0
Mendocino,7,2022-02-05,353,353,248,105,2985,2996,2107,889,18
Merced,7,2022-02-05,1337,1342,1068,274,8425,8457,6738,1719,64
Modoc,7,2022-02-05,22,22,18,4,159,159,129,30,3
Mono,7,2022-02-05,46,46,33,13,270,270,196,74,0
Monterey,7,2022-02-05,2483,2494,1703,791,23043,23134,15797,7337,96
Napa,7,2022-02-05,791,794,641,153,8029,8060,6509,1551,23
Nevada,7,2022-02-05,396,396,300,96,3288,3302,2504,798,27
Orange,7,2022-02-05,7348,7377,5965,1412,156194,156805,126943,29862,627
Placer,7,2022-02-05,1508,1514,1133,381,12788,12838,9613,3225,184
Plumas,7,2022-02-05,99,99,75,24,575,576,434,142,1
Riverside,7,2022-02-05,9476,9513,7276,2237,100180,100571,77017,23554,720
Sacramento,7,2022-02-05,6923,6950,5602,1348,66341,66600,53704,12896,502
San Benito,7,2022-02-05,332,332,277,55,2818,2829,2365,464,8
San Bernardino,7,2022-02-05,7956,7987,6773,1214,94382,94751,80449,14302,720
San Diego,7,2022-02-05,15752,15814,14712,1102,158229,158849,147843,11006,991
San Francisco,7,2022-02-05,2646,2656,1951,705,57579,57805,42524,15281,225
San Joaquin,7,2022-02-05,3811,3826,3020,806,38104,38254,30205,8049,250
San Luis Obispo,7,2022-02-05,1430,1436,1189,247,13454,13506,11189,2317,40
San Mateo,7,2022-02-05,2842,2852,2463,389,64200,64452,55699,8753,125
Santa Barbara,7,2022-02-05,2702,2713,2183,530,33543,33673,27119,6554,102
Santa Clara,7,2022-02-05,9073,9108,8456,652,179010,179711,166908,12803,452
Santa Cruz,7,2022-02-05,2105,2112,1781,331,39283,39437,33263,6174,38
Shasta,7,2022-02-05,731,733,560,173,7223,7250,5526,1724,75
Siskiyou,7,2022-02-05,103,103,86,17,704,707,589,118,8
Solano,7,2022-02-05,2521,2531,2049,482,24720,24817,20116,4701,121
Sonoma,7,2022-02-05,2310,2319,1873,446,28055,28166,22756,5410,79
Stanislaus,7,2022-02-05,2801,2812,2042,770,19664,19740,14336,5404,285
Sutter,7,2022-02-05,429,429,338,91,3483,3497,2761,736,0
Tehama,7,2022-02-05,328,328,230,98,1720,1727,1214,513,24
Trinity,7,2022-02-05,24,24,18,6,151,151,111,40,0
Tulare,7,2022-02-05,3135,3148,2257,891,18699,18772,13474,5298,164
Tuolumne,7,2022-02-05,406,406,311,95,2680,2691,2069,622,13
Ventura,7,2022-02-05,3006,3018,2620,398,43481,43651,37905,5746,244
Yolo,7,2022-02-05,917,920,771,149,32577,32704,27444,5260,14
Yuba,7,2022-02-05,388,388,312,76,2519,2530,2039,491,58
Alameda,8,2022-02-12,4000,4017,3553,464,103059,103501,91622,11879,256
Amador,8,2022-02-12,112,112,91,21,2427,2437,1986,451,15
Butte,8,2022-02-12,542,543,489,54,5547,5570,5013,557,76
Calaveras,8,2022-02-12,114,114,95,19,1319,1324,1108,216,6
Colusa,8,2022-02-12,46,46,39,7,518,520,437,83,3
Contra Costa,8,2022-02-12,2701,2714,2248,466,46549,46748,38773,7975,172
Del Norte,8,2022-02-12,253,253,215,38,3671,3688,3136,552,9
El Dorado,8,2022-02-12,303,303,252,51,4674,4694,3900,794,25
Fresno,8,2022-02-12,4273,4292,3510,782,37075,37234,30462,6772,459
Glenn,8,2022-02-12,60,60,51,9,480,481,407,74,4
Humboldt,8,2022-02-12,396,396,335,61,4504,4522,3823,699,19
Imperial,8,2022-02-12,697,699,580,119,6674,6703,5571,1132,68
Inyo,8,2022-02-12,28,28,24,4,409,410,357,53,2
Kern,8,2022-02-12,2417,2427,2052,375,30141,30271,25602,4669,205
Kings,8,2022-02-12,915,918,752,166,8410,8446,6921,1525,52
Lake,8,2022-02-12,260,260,210,50,2426,2437,1966,471,10
Lassen,8,2022-02-12,140,140,122,18,3018,3030,2623,407,3
Los Angeles,8,2022-02-12,24931,25038,23874,1164,1084490,1089126,1038833,50293,2086
Madera,8,2022-02-12,708,710,581,129,7087,7118,5825,1293,44
Marin,8,2022-02-12,427,427,356,71,10398,10443,8730,1713,28
Mariposa,8,2022-02-12,28,28,23,5,436,436,357,79,0
Mendocino,8,2022-02-12,234,234,178,56,2482,2492,1895,597,18
Merced,8,2022-02-12,854,858,721,137,7279,7309,6142,1167,47
Modoc,8,2022-02-12,21,21,18,3,189,189,160,29,0
Mono,8,2022-02-12,14,14,11,3,180,180,140,40,0
Monterey,8,2022-02-12,1441,1448,1075,373,18800,18879,14011,4868,88
Napa,8,2022-02-12,474,474,402,72,6888,6917,5873,1044,17
Nevada,8,2022-02-12,206,206,166,40,2702,2714,2191,523,20
Orange,8,2022-02-12,4476,4496,3824,672,136320,136902,116416,20486,456
Placer,8,2022-02-12,759,762,608,154,10566,10610,8490,2120,141
Plumas,8,2022-02-12,49,49,39,10,441,442,355,87,2
Riverside,8,2022-02-12,5409,5432,4422,1010,79676,80018,65189,14829,503
Sacramento,8,2022-02-12,3945,3962,3358,604,55929,56168,47649,8519,427
San Benito,8,2022-02-12,212,212,184,28,2309,2319,2023,296,7
San Bernardino,8,2022-02-12,4425,4443,3920,523,77414,77744,68656,9088,511
San Diego,8,2022-02-12,9539,9580,9074,506,132344,132911,125927,6984,751
San Francisco,8,2022-02-12,1824,1832,1441,391,49105,49314,38896,10418,183
San Joaquin,8,2022-02-12,2295,2305,1924,381,32469,32607,27200,5407,189
San Luis Obispo,8,2022-02-12,879,883,765,118,10689,10735,9303,1432,30
San Mateo,8,2022-02-12,1563,1570,1405,165,56677,56919,50957,5962,75
Santa Barbara,8,2022-02-12,1282,1288,1091,197,23530,23631,20039,3592,78
Santa Clara,8,2022-02-12,5400,5424,5129,295,159885,160569,151898,8671,366
Santa Cruz,8,2022-02-12,1174,1179,1035,144,34161,34307,30128,4179,33
Shasta,8,2022-02-12,509,510,414,96,6178,6204,5033,1171,78
Siskiyou,8,2022-02-12,79,79,69,10,589,590,513,77,5
Solano,8,2022-02-12,1369,1375,1171,204,20374,20461,17426,3035,96
Sonoma,8,2022-02-12,1370,1376,1167,209,23426,23526,19980,3546,60
Stanislaus,8,2022-02-12,1640,1647,1285,362,16388,16459,12849,3610,242
Sutter,8,2022-02-12,248,248,207,41,2995,3009,2511,498,0
Tehama,8,2022-02-12,197,197,150,47,1453,1459,1112,347,19
Trinity,8,2022-02-12,21,21,17,4,162,162,128,34,0
Tulare,8,2022-02-12,1785,1794,1386,408,16306,16376,12680,3696,146
Tuolumne,8,2022-02-12,221,221,180,41,2349,2359,1928,431,12
Ventura,8,2022-02-12,1809,1817,1632,185,38395,38559,34648,3911,190
Yolo,8,2022-02-12,600,601,525,76,28981,29106,25483,3623,15
Yuba,8,2022-02-12,246,246,208,38,2191,2201,1866,335,41
Alameda,9,2022-02-19,2251,2262,2061,201,90478,90916,82906,8010,191
Amador,9,2022-02-19,91,91,78,13,2160,2169,1855,314,9
Butte,9,2022-02-19,307,307,284,23,4630,4652,4297,355,71
Calaveras,9,2022-02-19,52,52,45,7,957,962,840,122,6
Colusa,9,2022-02-19,29,29,25,4,381,382,335,47,6
Contra Costa,9,2022-02-19,1639,1647,1426,221,39867,40059,34726,5333,117
Del Norte,9,2022-02-19,154,154,136,18,3067,3081,2725,356,9
El Dorado,9,2022-02-19,169,169,147,22,4003,4023,3495,528,10
Fresno,9,2022-02-19,2464,2476,2123,353,30248,30394,26078,4316,360
Glenn,9,2022-02-19,33,33,29,4,405,406,357,49,2
Humboldt,9,2022-02-19,237,237,209,28,3796,3815,3359,456,20
Imperial,9,2022-02-19,456,456,396,60,5342,5368,4667,701,47
Inyo,9,2022-02-19,13,13,12,1,379,380,342,38,1
Kern,9,2022-02-19,1403,1411,1243,168,25883,26008,22918,3090,124
Kings,9,2022-02-19,571,573,493,80,7347,7382,6351,1031,33
Lake,9,2022-02-19,225,225,191,34,2194,2204,1872,332,9
Lassen,9,2022-02-19,143,143,128,15,2379,2390,2142,248,4
Los Angeles,9,2022-02-19,14102,14169,13674,495,986386,991153,956701,34452,1391
Madera,9,2022-02-19,415,416,357,59,5895,5924,5084,840,35
Marin,9,2022-02-19,262,262,228,34,9939,9987,8715,1272,20
Mariposa,9,2022-02-19,20,20,17,3,408,408,350,58,0
Mendocino,9,2022-02-19,142,142,115,27,2244,2256,1829,427,10
Merced,9,2022-02-19,555,556,487,69,5981,6009,5265,744,8
Modoc,9,2022-02-19,10,10,9,1,72,72,64,8,1
Mono,9,2022-02-19,8,8,7,1,172,172,142,30,0
Monterey,9,2022-02-19,901,906,721,185,14923,14995,11925,3070,61
Napa,9,2022-02-19,303,303,267,36,5768,5796,5121,675,10
Nevada,9,2022-02-19,130,130,110,20,2374,2387,2027,360,21
Orange,9,2022-02-19,2863,2876,2542,334,126999,127612,112841,14771,352
Placer,9,2022-02-19,380,380,320,60,9381,9425,7951,1474,114
Plumas,9,2022-02-19,25,25,21,4,384,385,325,60,1
Riverside,9,2022-02-19,2968,2983,2548,435,67142,67467,57722,9745,351
Sacramento,9,2022-02-19,2386,2397,2115,282,48770,49006,43254,5752,319
San Benito,9,2022-02-19,134,134,121,13,2050,2060,1859,201,4
San Bernardino,9,2022-02-19,2308,2318,2109,209,65986,66304,60378,5926,366
San Diego,9,2022-02-19,5509,5536,5315,221,111121,111657,107224,4433,589
San Francisco,9,2022-02-19,1133,1139,948,191,45319,45539,37974,7565,140
San Joaquin,9,2022-02-19,1294,1300,1132,168,27652,27786,24208,3578,129
San Luis Obispo,9,2022-02-19,585,588,527,61,9115,9160,8218,942,26
San Mateo,9,2022-02-19,894,898,825,73,49776,50017,46004,4013,60
Santa Barbara,9,2022-02-19,754,758,668,90,21656,21759,19190,2569,56
Santa Clara,9,2022-02-19,3002,3017,2893,124,139672,140345,134620,5725,296
Santa Cruz,9,2022-02-19,664,667,604,63,28324,28460,25806,2654,24
Shasta,9,2022-02-19,323,323,275,48,5418,5445,4641,804,65
Siskiyou,9,2022-02-19,53,53,48,5,534,535,481,54,11
Solano,9,2022-02-19,775,779,689,90,16727,16808,14885,1923,70
Sonoma,9,2022-02-19,786,790,697,93,18960,19052,16832,2220,40
Stanislaus,9,2022-02-19,914,920,760,160,13531,13597,11251,2346,187
Sutter,9,2022-02-19,156,156,136,20,2410,2423,2110,313,0
Tehama,9,2022-02-19,119,119,96,23,1255,1260,1022,238,14
Trinity,9,2022-02-19,16,16,13,3,224,224,187,37,0
Tulare,9,2022-02-19,963,968,794,174,12434,12496,10259,2237,99
Tuolumne,9,2022-02-19,123,123,105,18,1956,1964,1683,281,7
Ventura,9,2022-02-19,1020,1026,947,79,30886,31035,28631,2404,131
Yolo,9,2022-02-19,334,334,302,32,24100,24217,21905,2312,10
Yuba,9,2022-02-19,159,159,140,19,1791,1800,1587,213,29
Alameda,10,2022-02-26,1496,1504,1403,101,68945,69305,64713,4592,144
Amador,10,2022-02-26,65,65,58,7,1993,2003,1782,221,10
Butte,10,2022-02-26,191,191,180,11,3990,4011,3780,231,48
Calaveras,10,2022-02-26,35,35,32,3,1064,1068,965,103,0
Colusa,10,2022-02-26,11,11,10,1,362,363,329,34,3
Contra Costa,10,2022-02-26,968,973,874,99,31615,31778,28554,3224,85
Del Norte,10,2022-02-26,88,88,80,8,2691,2707,2469,238,6
El Dorado,10,2022-02-26,116,116,104,12,3361,3378,3039,339,9
Fresno,10,2022-02-26,1345,1353,1205,148,25157,25289,22531,2758,268
Glenn,10,2022-02-26,21,21,19,2,376,377,342,35,0
Humboldt,10,2022-02-26,137,137,124,13,2765,2780,2526,254,8
Imperial,10,2022-02-26,268,268,241,27,4539,4562,4104,458,24
Inyo,10,2022-02-26,10,10,9,1,326,327,302,25,0
Kern,10,2022-02-26,883,889,808,81,22362,22478,20432,2046,101
Kings,10,2022-02-26,257,257,229,28,5894,5924,5285,639,21
Lake,10,2022-02-26,126,126,111,15,1809,1817,1606,211,3
Lassen,10,2022-02-26,59,59,54,5,1995,2005,1846,159,1
Los Angeles,10,2022-02-26,8513,8557,8333,224,925249,930094,906132,23962,975
Madera,10,2022-02-26,206,206,184,22,4162,4184,3730,454,26
Marin,10,2022-02-26,146,146,132,14,7105,7141,6444,697,14
Mariposa,10,2022-02-26,34,34,30,4,324,324,288,36,0
Mendocino,10,2022-02-26,77,77,65,12,1713,1721,1467,254,10
Merced,10,2022-02-26,281,281,254,27,4724,4747,4297,450,31
Modoc,10,2022-02-26,6,6,5,1,50,50,45,5,1
Mono,10,2022-02-26,5,5,4,1,166,166,144,22,0
Monterey,10,2022-02-26,415,415,347,68,12742,12808,10757,2051,32
Napa,10,2022-02-26,173,173,158,15,4942,4968,4528,440,8
Nevada,10,2022-02-26,78,78,69,9,1985,1997,1766,231,12
Orange,10,2022-02-26,1856,1867,1701,166,114639,115239,105150,10089,252
Placer,10,2022-02-26,270,270,237,33,7931,7971,7006,965,99
Plumas,10,2022-02-26,26,26,23,3,342,342,301,41,0
Riverside,10,2022-02-26,1789,1798,1597,201,59326,59636,53004,6632,258
Sacramento,10,2022-02-26,1207,1214,1105,109,41223,41438,37733,3705,224
San Benito,10,2022-02-26,60,60,56,4,1583,1591,1473,118,1
San Bernardino,10,2022-02-26,1275,1282,1194,88,56427,56722,52879,3843,221
San Diego,10,2022-02-26,3389,3407,3305,102,93896,94385,91587,2798,450
San Francisco,10,2022-02-26,866,871,758,113,36444,36634,31933,4701,99
San Joaquin,10,2022-02-26,733,737,664,73,23401,23522,21206,2316,90
San Luis Obispo,10,2022-02-26,318,318,293,25,7644,7685,7087,598,16
San Mateo,10,2022-02-26,546,547,514,33,35218,35402,33268,2134,46
Santa Barbara,10,2022-02-26,412,412,375,37,19323,19424,17677,1747,44
Santa Clara,10,2022-02-26,1768,1776,1722,54,83548,83985,81437,2548,241
Santa Cruz,10,2022-02-26,480,481,447,34,23772,23896,22216,1680,19
Shasta,10,2022-02-26,173,173,153,20,4571,4595,4072,523,49
Siskiyou,10,2022-02-26,29,29,27,2,396,397,367,30,6
Solano,10,2022-02-26,491,491,448,43,14219,14293,13047,1246,65
Sonoma,10,2022-02-26,464,465,424,41,15053,15131,13789,1342,25
Stanislaus,10,2022-02-26,512,513,444,69,11907,11970,10370,1600,154
Sutter,10,2022-02-26,103,103,93,10,2209,2221,2003,218,0
Tehama,10,2022-02-26,58,58,49,9,1108,1113,949,164,10
Trinity,10,2022-02-26,6,6,5,1,111,111,97,14,0
Tulare,10,2022-02-26,505,507,436,71,11091,11149,9604,1545,82
Tuolumne,10,2022-02-26,82,82,73,9,1430,1435,1277,158,7
Ventura,10,2022-02-26,615,616,580,36,27318,27461,25858,1603,92
Yolo,10,2022-02-26,215,215,199,16,22506,22625,20997,1628,9
Yuba,10,2022-02-26,79,79,72,7,1703,1711,1556,155,20
Alameda,11,2022-03-05,1162,1170,1110,60,73814,74252,70482,3770,108
Amador,11,2022-03-05,75,75,69,6,1384,1392,1272,120,6
Butte,11,2022-03-05,134,134,128,6,3669,3692,3531,161,31
Calaveras,11,2022-03-05,29,29,27,2,1122,1128,1044,84,1
Colusa,11,2022-03-05,10,10,9,1,344,345,320,25,6
Contra Costa,11,2022-03-05,651,655,604,51,31782,31970,29470,2500,66
Del Norte,11,2022-03-05,54,54,50,4,1859,1869,1743,126,6
El Dorado,11,2022-03-05,91,91,84,7,3260,3280,3026,254,6
Fresno,11,2022-03-05,955,960,879,81,22826,22963,21034,1929,175
Glenn,11,2022-03-05,12,12,11,1,366,367,341,26,1
Humboldt,11,2022-03-05,110,110,102,8,3067,3084,2869,215,8
Imperial,11,2022-03-05,172,172,158,14,4544,4570,4218,352,21
Inyo,11,2022-03-05,9,9,8,1,371,373,351,22,1
Kern,11,2022-03-05,515,517,481,36,21595,21722,20203,1519,78
Kings,11,2022-03-05,165,165,151,14,5082,5112,4688,424,13
Lake,11,2022-03-05,69,69,63,6,1823,1834,1670,164,5
Lassen,11,2022-03-05,83,83,78,5,1824,1836,1724,112,0
Los Angeles,11,2022-03-05,6100,6136,6015,121,887151,892404,874956,17448,755
Madera,11,2022-03-05,131,131,120,11,4124,4149,3801,348,14
Marin,11,2022-03-05,169,169,156,13,7697,7743,7161,582,11
Mariposa,11,2022-03-05,14,14,13,1,304,304,278,26,0
Mendocino,11,2022-03-05,75,75,66,9,1773,1785,1580,205,10
Merced,11,2022-03-05,200,200,185,15,4671,4699,4358,341,25
Modoc,11,2022-03-05,1,1,1,0,52,52,48,4,0
Mono,11,2022-03-05,3,3,3,0,130,130,116,14,1
Monterey,11,2022-03-05,268,268,234,34,11526,11594,10140,1454,21
Napa,11,2022-03-05,200,200,186,14,5017,5046,4701,345,9
Nevada,11,2022-03-05,47,47,43,4,1755,1765,1607,158,5
Orange,11,2022-03-05,1336,1343,1253,90,109561,110209,102788,7421,189
Placer,11,2022-03-05,176,176,159,17,7852,7899,7163,736,77
Plumas,11,2022-03-05,4,4,4,0,274,274,248,26,0
Riverside,11,2022-03-05,1095,1102,1007,95,55151,55476,50722,4754,169
Sacramento,11,2022-03-05,847,853,794,59,40176,40413,37639,2774,161
San Benito,11,2022-03-05,37,37,35,2,1537,1546,1458,88,2
San Bernardino,11,2022-03-05,904,910,863,47,54015,54334,51527,2807,145
San Diego,11,2022-03-05,2514,2529,2473,56,96785,97357,95181,2176,314
San Francisco,11,2022-03-05,679,683,614,69,38171,38397,34570,3827,69
San Joaquin,11,2022-03-05,458,459,424,35,21408,21533,19900,1633,60
San Luis Obispo,11,2022-03-05,302,303,285,18,7482,7527,7077,450,9
San Mateo,11,2022-03-05,566,569,543,26,41692,41938,40001,1937,37
Santa Barbara,11,2022-03-05,220,220,205,15,18204,18311,17043,1268,26
Santa Clara,11,2022-03-05,1512,1521,1486,35,116401,117087,114389,2698,197
Santa Cruz,11,2022-03-05,343,343,324,19,25048,25197,23835,1362,17
Shasta,11,2022-03-05,145,145,132,13,4962,4991,4554,437,41
Siskiyou,11,2022-03-05,19,19,18,1,417,418,393,25,1
Solano,11,2022-03-05,386,386,360,26,13954,14036,13094,942,60
Sonoma,11,2022-03-05,375,375,349,26,15512,15604,14542,1062,29
Stanislaus,11,2022-03-05,315,315,282,33,11171,11237,10068,1169,115
Sutter,11,2022-03-05,87,87,80,7,2020,2033,1879,154,0
Tehama,11,2022-03-05,50,50,44,6,1201,1207,1069,138,8
Trinity,11,2022-03-05,6,6,5,1,111,111,100,11,0
Tulare,11,2022-03-05,343,343,306,37,10309,10369,9255,1114,46
Tuolumne,11,2022-03-05,54,54,49,5,1285,1291,1182,109,3
Ventura,11,2022-03-05,414,414,396,18,27235,27397,26181,1216,55
Yolo,11,2022-03-05,169,169,160,9,22593,22726,21466,1260,6
Yuba,11,2022-03-05,68,68,63,5,1618,1628,1516,112,18
Alameda,12,2022-03-12,962,968,931,37,68637,69117,66473,2644,78
Amador,12,2022-03-12,32,32,30,2,1460,1472,1375,97,5
Butte,12,2022-03-12,72,72,70,2,3445,3469,3355,114,19
Calaveras,12,2022-03-12,16,16,15,1,1052,1059,999,60,1
Colusa,12,2022-03-12,6,6,6,0,253,253,239,14,2
Contra Costa,12,2022-03-12,586,591,556,35,29183,29387,27645,1742,31
Del Norte,12,2022-03-12,44,44,42,2,1466,1476,1400,76,5
El Dorado,12,2022-03-12,54,54,51,3,3049,3070,2890,180,7
Fresno,12,2022-03-12,613,618,578,40,21803,21957,20556,1401,145
Glenn,12,2022-03-12,17,17,16,1,320,321,304,17,1
Humboldt,12,2022-03-12,63,63,60,3,2777,2797,2649,148,4
Imperial,12,2022-03-12,88,88,83,5,4680,4713,4436,277,13
Inyo,12,2022-03-12,10,10,10,0,165,165,158,7,0
Kern,12,2022-03-12,316,316,299,17,20080,20221,19154,1067,60
Kings,12,2022-03-12,218,218,204,14,4835,4868,4562,306,16
Lake,12,2022-03-12,65,65,61,4,1599,1609,1499,110,0
Lassen,12,2022-03-12,25,25,24,1,1502,1513,1443,70,0
Los Angeles,12,2022-03-12,4324,4354,4290,64,847960,853901,841422,12479,520
Madera,12,2022-03-12,83,83,78,5,3713,3738,3500,238,15
Marin,12,2022-03-12,163,163,154,9,6639,6686,6305,381,6
Mariposa,12,2022-03-12,7,7,7,0,223,223,209,14,0
Mendocino,12,2022-03-12,41,41,37,4,1481,1493,1362,131,5
Merced,12,2022-03-12,144,144,136,8,4221,4251,4018,233,25
Modoc,12,2022-03-12,3,3,3,0,56,56,53,3,1
Mono,12,2022-03-12,2,2,2,0,106,106,97,9,0
Monterey,12,2022-03-12,181,181,163,18,10340,10412,9407,1005,17
Napa,12,2022-03-12,148,148,140,8,4290,4317,4093,224,7
Nevada,12,2022-03-12,51,51,48,3,1588,1598,1489,109,3
Orange,12,2022-03-12,935,942,894,48,102401,103118,97867,5251,150
Placer,12,2022-03-12,158,158,147,11,7552,7605,7066,539,68
Plumas,12,2022-03-12,10,10,9,1,313,314,292,22,0
Riverside,12,2022-03-12,783,790,738,52,51384,51745,48375,3370,116
Sacramento,12,2022-03-12,625,631,598,33,37175,37435,35487,1948,134
San Benito,12,2022-03-12,27,27,26,1,1449,1458,1396,62,2
San Bernardino,12,2022-03-12,604,609,585,24,51098,51455,49448,2007,119
San Diego,12,2022-03-12,2005,2019,1985,34,96789,97467,95834,1633,225
San Francisco,12,2022-03-12,585,589,544,45,35040,35285,32602,2683,41
San Joaquin,12,2022-03-12,316,317,299,18,20439,20581,19397,1184,41
San Luis Obispo,12,2022-03-12,163,163,156,7,6985,7033,6715,318,6
San Mateo,12,2022-03-12,467,470,454,16,37438,37700,36392,1308,29
Santa Barbara,12,2022-03-12,193,193,183,10,17575,17698,16772,926,20
Santa Clara,12,2022-03-12,1129,1137,1117,20,101372,102081,100323,1758,131
Santa Cruz,12,2022-03-12,248,248,238,10,23057,23219,22272,947,11
Shasta,12,2022-03-12,105,105,98,7,4938,4973,4641,332,21
Siskiyou,12,2022-03-12,17,17,16,1,400,401,383,18,0
Solano,12,2022-03-12,244,244,232,12,12980,13070,12405,665,44
Sonoma,12,2022-03-12,235,235,223,12,13966,14062,13336,726,16
Stanislaus,12,2022-03-12,245,245,226,19,10206,10276,9459,817,106
Sutter,12,2022-03-12,56,56,53,3,1805,1818,1714,104,0
Tehama,12,2022-03-12,27,27,25,2,997,1003,915,88,1
Trinity,12,2022-03-12,2,2,2,0,97,97,90,7,0
Tulare,12,2022-03-12,212,212,194,18,9771,9839,9028,811,37
Tuolumne,12,2022-03-12,29,29,27,2,1246,1255,1174,81,2
Ventura,12,2022-03-12,352,352,340,12,25150,25326,24478,848,40
Yolo,12,2022-03-12,132,132,126,6,21586,21739,20830,909,4
Yuba,12,2022-03-12,44,44,42,2,1446,1456,1380,76,12
Alameda,13,2022-03-19,693,699,679,20,67206,67753,65803,1950,58
Amador,13,2022-03-19,29,29,28,1,1388,1399,1330,69,2
Butte,13,2022-03-19,85,85,83,2,2984,3008,2934,74,17
Calaveras,13,2022-03-19,14,14,13,1,655,660,632,28,0
Colusa,13,2022-03-19,1,1,1,0,241,242,232,10,2
Contra Costa,13,2022-03-19,465,469,448,21,27736,27962,26707,1255,41
Del Norte,13,2022-03-19,19,19,18,1,1282,1293,1243,50,2
El Dorado,13,2022-03-19,41,41,39,2,2826,2849,2723,126,2
Fresno,13,2022-03-19,351,353,336,17,19950,20113,19141,972,101
Glenn,13,2022-03-19,8,8,8,0,339,340,326,14,1
Humboldt,13,2022-03-19,35,35,34,1,2378,2398,2303,95,7
Imperial,13,2022-03-19,62,62,59,3,4066,4099,3918,181,9
Inyo,13,2022-03-19,1,1,1,0,156,156,151,5,0
Kern,13,2022-03-19,218,218,209,9,19390,19548,18768,780,40
Kings,13,2022-03-19,76,76,72,4,4410,4446,4234,212,6
Lake,13,2022-03-19,20,20,19,1,1447,1459,1383,76,0
Lassen,13,2022-03-19,10,10,10,0,1528,1540,1486,54,0
Los Angeles,13,2022-03-19,3978,4011,3967,44,826261,832997,823898,9099,422
Madera,13,2022-03-19,45,45,43,2,3418,3445,3279,166,13
Marin,13,2022-03-19,148,148,142,6,6357,6408,6132,276,7
Mariposa,13,2022-03-19,8,8,8,0,246,247,235,12,0
Mendocino,13,2022-03-19,32,32,30,2,1498,1512,1412,100,5
Merced,13,2022-03-19,97,97,93,4,3902,3934,3771,163,16
Modoc,13,2022-03-19,2,2,2,0,51,51,49,2,0
Mono,13,2022-03-19,2,2,2,0,131,131,123,8,1
Monterey,13,2022-03-19,150,150,139,11,10217,10300,9543,757,19
Napa,13,2022-03-19,65,65,62,3,3532,3560,3421,139,8
Nevada,13,2022-03-19,26,26,25,1,1539,1552,1472,80,1
Orange,13,2022-03-19,753,759,730,29,98284,99085,95279,3806,132
Placer,13,2022-03-19,111,111,105,6,6548,6601,6245,356,40
Plumas,13,2022-03-19,2,2,2,0,223,224,212,12,0
Riverside,13,2022-03-19,672,677,643,34,54657,55103,52381,2722,98
Sacramento,13,2022-03-19,468,473,454,19,32735,33001,31710,1291,113
San Benito,13,2022-03-19,26,26,25,1,1401,1413,1368,45,2
San Bernardino,13,2022-03-19,484,489,475,14,51321,51739,50223,1516,86
San Diego,13,2022-03-19,1536,1549,1529,20,88321,89039,87923,1116,203
San Francisco,13,2022-03-19,653,659,621,38,33549,33822,31872,1950,40
San Joaquin,13,2022-03-19,231,231,221,10,15543,15669,14989,680,34
San Luis Obispo,13,2022-03-19,114,114,110,4,6676,6730,6501,229,3
San Mateo,13,2022-03-19,383,386,376,10,34155,34433,33538,895,28
Santa Barbara,13,2022-03-19,180,180,173,7,16141,16272,15630,642,17
Santa Clara,13,2022-03-19,1020,1028,1015,13,94811,95583,94356,1227,125
Santa Cruz,13,2022-03-19,212,212,205,7,20686,20854,20214,640,10
Shasta,13,2022-03-19,56,56,53,3,4332,4368,4147,221,1
Siskiyou,13,2022-03-19,9,9,9,0,360,363,351,12,1
Solano,13,2022-03-19,195,195,187,8,11622,11717,11269,448,22
Sonoma,13,2022-03-19,225,225,216,9,13337,13445,12924,521,14
Stanislaus,13,2022-03-19,155,155,146,9,8609,8679,8157,522,72
Sutter,13,2022-03-19,31,31,30,1,1488,1501,1436,65,0
Tehama,13,2022-03-19,9,9,8,1,926,932,870,62,1
Trinity,13,2022-03-19,1,1,1,0,96,96,90,6,0
Tulare,13,2022-03-19,129,129,121,8,8465,8534,8000,534,30
Tuolumne,13,2022-03-19,18,18,17,1,1167,1175,1117,58,2
Ventura,13,2022-03-19,288,288,281,7,23841,24034,23430,604,35
Yolo,13,2022-03-19,97,97,94,3,22345,22528,21820,708,4
Yuba,13,2022-03-19,34,34,33,1,1326,1338,1285,53,7
Alameda,14,2022-03-26,872,880,861,19,59336,59902,58609,1293,52
Amador,14,2022-03-26,11,11,11,0,1311,1325,1275,50,3
Butte,14,2022-03-26,68,68,67,1,2731,2758,2707,51,14
Calaveras,14,2022-03-26,14,14,14,0,601,606,587,19,0
Colusa,14,2022-03-26,4,4,4,0,197,197,191,6,0
Contra Costa,14,2022-03-26,506,511,494,17,24834,25070,24224,846,32
Del Norte,14,2022-03-26,17,17,16,1,1036,1047,1017,30,0
El Dorado,14,2022-03-26,51,51,49,2,2789,2817,2723,94,0
Fresno,14,2022-03-26,304,305,294,11,18557,18734,18052,682,95
Glenn,14,2022-03-26,7,7,7,0,308,309,300,9,0
Humboldt,14,2022-03-26,27,27,26,1,2594,2619,2540,79,5
Imperial,14,2022-03-26,54,54,52,2,3712,3747,3622,125,7
Inyo,14,2022-03-26,3,3,3,0,164,164,160,4,1
Kern,14,2022-03-26,154,154,149,5,18451,18627,18067,560,26
Kings,14,2022-03-26,65,65,63,2,4404,4447,4287,160,2
Lake,14,2022-03-26,13,13,12,1,1149,1161,1115,46,0
Lassen,14,2022-03-26,6,6,6,0,1361,1374,1338,36,0
Los Angeles,14,2022-03-26,4345,4386,4350,36,786692,794212,787741,6471,341
Madera,14,2022-03-26,24,24,23,1,3366,3398,3275,123,4
Marin,14,2022-03-26,166,166,161,5,5887,5942,5750,192,3
Mariposa,14,2022-03-26,6,6,6,0,178,178,171,7,0
Mendocino,14,2022-03-26,29,29,28,1,1290,1303,1237,66,0
Merced,14,2022-03-26,64,64,62,2,3337,3369,3264,105,12
Modoc,14,2022-03-26,2,2,2,0,52,52,50,2,0
Mono,14,2022-03-26,3,3,3,0,132,132,126,6,0
Monterey,14,2022-03-26,164,164,155,9,9445,9535,9004,531,19
Napa,14,2022-03-26,62,62,60,2,3328,3359,3260,99,1
Nevada,14,2022-03-26,25,25,24,1,1476,1491,1433,58,1
Orange,14,2022-03-26,798,805,782,23,90139,91002,88378,2624,100
Placer,14,2022-03-26,113,113,108,5,6158,6217,5964,253,33
Plumas,14,2022-03-26,2,2,2,0,272,274,263,11,0
Riverside,14,2022-03-26,519,525,506,19,44554,44979,43311,1668,75
Sacramento,14,2022-03-26,463,468,454,14,31674,31976,31034,942,96
San Benito,14,2022-03-26,10,10,10,0,1305,1318,1286,32,0
San Bernardino,14,2022-03-26,493,498,487,11,41174,41567,40654,913,69
San Diego,14,2022-03-26,1327,1339,1327,12,74031,74738,74039,699,155
San Francisco,14,2022-03-26,770,778,744,34,32748,33062,31623,1439,30
San Joaquin,14,2022-03-26,191,191,185,6,16608,16766,16220,546,31
San Luis Obispo,14,2022-03-26,98,98,95,3,5878,5933,5782,151,5
San Mateo,14,2022-03-26,509,514,504,10,34361,34689,34013,676,28
Santa Barbara,14,2022-03-26,120,120,116,4,8878,8962,8697,265,21
Santa Clara,14,2022-03-26,1221,1233,1221,12,90991,91861,90983,878,102
Santa Cruz,14,2022-03-26,136,136,133,3,18709,18887,18453,434,7
Shasta,14,2022-03-26,41,41,39,2,3902,3939,3789,150,8
Siskiyou,14,2022-03-26,8,8,8,0,305,306,298,8,0
Solano,14,2022-03-26,157,157,153,4,10900,11003,10686,317,26
Sonoma,14,2022-03-26,232,232,225,7,8218,8296,8055,241,14
Stanislaus,14,2022-03-26,127,127,121,6,8025,8102,7734,368,41
Sutter,14,2022-03-26,28,28,27,1,1516,1530,1480,50,0
Tehama,14,2022-03-26,14,14,13,1,808,815,774,41,2
Trinity,14,2022-03-26,0,0,0,0,102,102,97,5,0
Tulare,14,2022-03-26,95,95,90,5,7870,7945,7570,375,19
Tuolumne,14,2022-03-26,9,9,9,0,1113,1124,1083,41,3
Ventura,14,2022-03-26,332,333,327,6,21741,21949,21537,412,23
Yolo,14,2022-03-26,97,97,95,2,17163,17327,16919,408,3
Yuba,14,2022-03-26,34,34,33,1,1254,1266,1229,37,3
Alameda,15,2022-04-02,955,965,950,15,58342,58983,58031,952,37
Amador,15,2022-04-02,4,4,4,0,1178,1192,1158,34,1
Butte,15,2022-04-02,51,51,50,1,2483,2511,2476,35,10
Calaveras,15,2022-04-02,12,12,12,0,586,592,578,14,0
Colusa,15,2022-04-02,4,4,4,0,199,201,196,5,0
Contra Costa,15,2022-04-02,543,550,536,14,24540,24810,24181,629,20
Del Norte,15,2022-04-02,11,11,11,0,1126,1138,1113,25,0
El Dorado,15,2022-04-02,52,52,51,1,2778,2811,2741,70,2
Fresno,15,2022-04-02,197,198,193,5,17046,17233,16761,472,75
Glenn,15,2022-04-02,5,5,5,0,261,262,256,6,0
Humboldt,15,2022-04-02,21,21,21,0,2510,2538,2481,57,5
Imperial,15,2022-04-02,55,55,54,1,3470,3508,3420,88,6
Inyo,15,2022-04-02,8,8,8,0,182,182,179,3,0
Kern,15,2022-04-02,163,163,159,4,17195,17383,16991,392,23
Kings,15,2022-04-02,49,49,48,1,4156,4202,4089,113,3
Lake,15,2022-04-02,12,12,12,0,986,997,968,29,0
Lassen,15,2022-04-02,4,4,4,0,1218,1231,1207,24,0
Los Angeles,15,2022-04-02,5036,5093,5062,31,732327,740423,735961,4462,288
Madera,15,2022-04-02,28,28,27,1,3276,3312,3222,90,5
Marin,15,2022-04-02,155,155,151,4,6555,6628,6467,161,2
Mariposa,15,2022-04-02,5,5,5,0,215,216,210,6,0
Mendocino,15,2022-04-02,26,26,25,1,1252,1266,1217,49,0
Merced,15,2022-04-02,58,58,57,1,3285,3320,3242,78,4
Modoc,15,2022-04-02,4,4,4,0,42,42,41,1,0
Mono,15,2022-04-02,1,1,1,0,154,154,149,5,0
Monterey,15,2022-04-02,127,127,122,5,7539,7622,7302,320,11
Napa,15,2022-04-02,59,59,58,1,3245,3279,3207,72,3
Nevada,15,2022-04-02,28,28,27,1,1401,1417,1376,41,0
Orange,15,2022-04-02,901,911,891,20,88516,89491,87554,1937,72
Placer,15,2022-04-02,124,124,120,4,6578,6650,6447,203,29
Plumas,15,2022-04-02,4,4,4,0,233,234,227,7,0
Riverside,15,2022-04-02,604,611,594,17,39287,39718,38608,1110,51
Sacramento,15,2022-04-02,429,434,424,10,32764,33124,32392,732,63
San Benito,15,2022-04-02,13,13,13,0,1229,1243,1220,23,0
San Bernardino,15,2022-04-02,587,594,584,10,41535,41993,41302,691,35
San Diego,15,2022-04-02,1504,1522,1511,11,65981,66707,66242,465,133
San Francisco,15,2022-04-02,961,972,940,32,28737,29053,28097,956,25
San Joaquin,15,2022-04-02,208,208,203,5,16036,16212,15813,399,16
San Luis Obispo,15,2022-04-02,101,101,99,2,5599,5660,5552,108,4
San Mateo,15,2022-04-02,649,656,647,9,29623,29950,29513,437,16
Santa Barbara,15,2022-04-02,177,177,173,4,15222,15390,15049,341,11
Santa Clara,15,2022-04-02,1400,1417,1407,10,91265,92269,91608,661,102
Santa Cruz,15,2022-04-02,189,190,187,3,20063,20284,19933,351,5
Shasta,15,2022-04-02,25,25,24,1,3526,3564,3462,102,5
Siskiyou,15,2022-04-02,4,4,4,0,313,316,310,6,0
Solano,15,2022-04-02,148,148,145,3,10209,10321,10097,224,26
Sonoma,15,2022-04-02,287,289,283,6,10643,10759,10525,234,9
Stanislaus,15,2022-04-02,101,101,98,3,7810,7897,7625,272,25
Sutter,15,2022-04-02,23,23,22,1,1272,1286,1254,32,0
Tehama,15,2022-04-02,4,4,4,0,746,753,724,29,0
Trinity,15,2022-04-02,1,1,1,0,77,77,75,2,0
Tulare,15,2022-04-02,54,54,52,2,7606,7688,7414,274,15
Tuolumne,15,2022-04-02,11,11,11,0,972,983,956,27,1
Ventura,15,2022-04-02,296,298,294,4,20906,21135,20839,296,22
Yolo,15,2022-04-02,64,64,63,1,28218,28529,28022,507,1
Yuba,15,2022-04-02,12,12,12,0,1023,1035,1012,23,4
Alameda,16,2022-04-09,1385,1402,1385,17,48755,49360,48766,594,49
Amador,16,2022-04-09,7,7,7,0,1099,1113,1089,24,1
Butte,16,2022-04-09,36,36,36,0,2088,2114,2092,22,8
Calaveras,16,2022-04-09,10,10,10,0,643,651,639,12,0
Colusa,16,2022-04-09,4,4,4,0,195,197,193,4,0
Contra Costa,16,2022-04-09,627,635,623,12,19555,19797,19422,375,23
Del Norte,16,2022-04-09,7,7,7,0,982,995,979,16,1
El Dorado,16,2022-04-09,51,51,50,1,2570,2601,2552,49,1
Fresno,16,2022-04-09,196,196,192,4,16687,16893,16547,346,64
Glenn,16,2022-04-09,3,3,3,0,229,230,226,4,0
Humboldt,16,2022-04-09,38,38,37,1,2329,2356,2316,40,7
Imperial,16,2022-04-09,25,25,25,0,3426,3467,3402,65,3
Inyo,16,2022-04-09,5,5,5,0,199,200,197,3,0
Kern,16,2022-04-09,149,149,147,2,17196,17408,17115,293,20
Kings,16,2022-04-09,33,33,32,1,4206,4258,4172,86,3
Lake,16,2022-04-09,19,19,19,0,848,860,841,19,0
Lassen,16,2022-04-09,1,1,1,0,1301,1318,1299,19,1
Los Angeles,16,2022-04-09,6398,6477,6448,29,749803,759109,755677,3432,262
Madera,16,2022-04-09,29,29,28,1,3153,3193,3128,65,3
Marin,16,2022-04-09,187,188,185,3,5445,5511,5411,100,5
Mariposa,16,2022-04-09,7,7,7,0,245,249,244,5,0
Mendocino,16,2022-04-09,30,30,29,1,1152,1167,1133,34,0
Merced,16,2022-04-09,64,64,63,1,3305,3344,3285,59,10
Modoc,16,2022-04-09,1,1,1,0,50,50,49,1,0
Mono,16,2022-04-09,3,3,3,0,135,135,132,3,0
Monterey,16,2022-04-09,115,115,111,4,7161,7250,7021,229,12
Napa,16,2022-04-09,109,109,107,2,3082,3120,3069,51,2
Nevada,16,2022-04-09,34,34,33,1,1508,1528,1495,33,2
Orange,16,2022-04-09,1101,1114,1096,18,54195,54867,53978,889,79
Placer,16,2022-04-09,115,115,112,3,6221,6299,6154,145,23
Plumas,16,2022-04-09,5,5,5,0,260,263,257,6,0
Riverside,16,2022-04-09,727,735,720,15,37719,38186,37386,800,37
Sacramento,16,2022-04-09,494,500,492,8,31224,31610,31087,523,48
San Benito,16,2022-04-09,18,18,18,0,1186,1202,1186,16,0
San Bernardino,16,2022-04-09,814,826,816,10,41868,42387,41867,520,32
San Diego,16,2022-04-09,1820,1842,1832,10,73521,74431,74045,386,111
San Francisco,16,2022-04-09,1147,1161,1132,29,30148,30521,29770,751,27
San Joaquin,16,2022-04-09,232,234,230,4,15607,15799,15508,291,19
San Luis Obispo,16,2022-04-09,109,109,107,2,5010,5071,4998,73,2
San Mateo,16,2022-04-09,832,842,833,9,30505,30881,30545,336,6
Santa Barbara,16,2022-04-09,247,250,246,4,15188,15377,15122,255,9
Santa Clara,16,2022-04-09,1608,1627,1618,9,79311,80294,79866,428,89
Santa Cruz,16,2022-04-09,275,279,275,4,8149,8249,8142,107,6
Shasta,16,2022-04-09,19,19,19,0,3305,3345,3273,72,3
Siskiyou,16,2022-04-09,1,1,1,0,315,319,315,4,0
Solano,16,2022-04-09,226,227,223,4,9620,9739,9582,157,17
Sonoma,16,2022-04-09,403,410,403,7,10563,10695,10521,174,6
Stanislaus,16,2022-04-09,127,127,124,3,7865,7962,7756,206,21
Sutter,16,2022-04-09,23,23,23,0,1324,1340,1315,25,0
Tehama,16,2022-04-09,10,10,10,0,758,767,745,22,0
Trinity,16,2022-04-09,0,0,0,0,82,82,80,2,0
Tulare,16,2022-04-09,46,46,45,1,7907,8004,7789,215,7
Tuolumne,16,2022-04-09,17,17,17,0,1076,1089,1066,23,1
Ventura,16,2022-04-09,300,304,301,3,18067,18290,18099,191,20
Yolo,16,2022-04-09,96,96,95,1,18604,18836,18586,250,1
Yuba,16,2022-04-09,14,14,14,0,1074,1087,1069,18,4
Alameda,17,2022-04-16,1769,1794,1778,16,54508,55276,54779,497,41
Amador,17,2022-04-16,7,7,7,0,1135,1151,1133,18,2
Butte,17,2022-04-16,47,47,47,0,2047,2075,2059,16,5
Calaveras,17,2022-04-16,15,15,15,0,616,625,617,8,0
Colusa,17,2022-04-16,4,4,4,0,169,170,168,2,0
Contra Costa,17,2022-04-16,1008,1021,1007,14,24944,25296,24937,359,29
Del Norte,17,2022-04-16,12,12,12,0,1022,1036,1023,13,0
El Dorado,17,2022-04-16,59,59,58,1,2357,2391,2357,34,0
Fresno,17,2022-04-16,197,198,195,3,13917,14114,13898,216,48
Glenn,17,2022-04-16,3,3,3,0,237,239,236,3,0
Humboldt,17,2022-04-16,78,78,77,1,1974,2002,1977,25,6
Imperial,17,2022-04-16,41,41,40,1,3344,3391,3343,48,3
Inyo,17,2022-04-16,0,0,0,0,152,153,151,2,0
Kern,17,2022-04-16,129,129,127,2,13372,13560,13390,170,19
Kings,17,2022-04-16,38,38,37,1,3615,3665,3610,55,2
Lake,17,2022-04-16,19,19,19,0,815,829,815,14,2
Lassen,17,2022-04-16,2,2,2,0,1316,1333,1318,15,0
Los Angeles,17,2022-04-16,7566,7673,7647,26,370726,375945,374672,1273,213
Madera,17,2022-04-16,23,23,23,0,2603,2639,2599,40,3
Marin,17,2022-04-16,284,290,286,4,6106,6191,6107,84,5
Mariposa,17,2022-04-16,11,11,11,0,257,262,258,4,0
Mendocino,17,2022-04-16,42,42,41,1,1303,1322,1294,28,4
Merced,17,2022-04-16,73,73,72,1,3158,3202,3160,42,9
Modoc,17,2022-04-16,1,1,1,0,36,37,36,1,0
Mono,17,2022-04-16,13,13,13,0,170,172,169,3,0
Monterey,17,2022-04-16,130,130,127,3,6342,6433,6281,152,6
Napa,17,2022-04-16,141,141,139,2,2696,2734,2701,33,1
Nevada,17,2022-04-16,42,42,41,1,1240,1258,1237,21,2
Orange,17,2022-04-16,1339,1359,1343,16,82156,83312,82301,1011,67
Placer,17,2022-04-16,153,153,150,3,4701,4767,4685,82,25
Plumas,17,2022-04-16,7,7,7,0,209,212,208,4,0
Riverside,17,2022-04-16,848,860,847,13,37135,37658,37068,590,45
Sacramento,17,2022-04-16,666,675,667,8,27818,28210,27862,348,53
San Benito,17,2022-04-16,24,24,24,0,1181,1199,1187,12,0
San Bernardino,17,2022-04-16,1020,1034,1025,9,39266,39819,39453,366,43
San Diego,17,2022-04-16,1877,1903,1896,7,68402,69363,69094,269,96
San Francisco,17,2022-04-16,1325,1343,1318,25,30539,30970,30400,570,32
San Joaquin,17,2022-04-16,221,223,220,3,14841,15050,14843,207,13
San Luis Obispo,17,2022-04-16,138,138,137,1,4858,4926,4873,53,3
San Mateo,17,2022-04-16,1057,1071,1062,9,29929,30351,30105,246,11
Santa Barbara,17,2022-04-16,329,335,331,4,14849,15058,14871,187,8
Santa Clara,17,2022-04-16,2050,2079,2071,8,74211,75253,74953,300,74
Santa Cruz,17,2022-04-16,413,417,413,4,12638,12813,12686,127,4
Shasta,17,2022-04-16,27,27,27,0,2836,2878,2832,46,4
Siskiyou,17,2022-04-16,4,4,4,0,321,324,321,3,1
Solano,17,2022-04-16,235,239,236,3,9051,9179,9068,111,10
Sonoma,17,2022-04-16,484,491,485,6,11405,11565,11424,141,15
Stanislaus,17,2022-04-16,145,145,142,3,7857,7967,7813,154,19
Sutter,17,2022-04-16,20,20,20,0,1181,1197,1181,16,0
Tehama,17,2022-04-16,7,7,7,0,649,657,643,14,1
Trinity,17,2022-04-16,0,0,0,0,69,69,68,1,0
Tulare,17,2022-04-16,72,72,71,1,6822,6919,6780,139,13
Tuolumne,17,2022-04-16,26,26,26,0,1060,1076,1059,17,0
Ventura,17,2022-04-16,355,360,357,3,15790,16012,15887,125,9
Yolo,17,2022-04-16,111,111,110,1,18749,19014,18826,188,2
Yuba,17,2022-04-16,21,21,21,0,1004,1018,1005,13,1
Alameda,18,2022-04-23,2249,2285,2270,15,55664,56570,56193,377,53
Amador,18,2022-04-23,18,18,18,0,1320,1341,1325,16,0
Butte,18,2022-04-23,37,37,37,0,2188,2224,2211,13,9
Calaveras,18,2022-04-23,22,22,22,0,611,620,614,6,0
Colusa,18,2022-04-23,3,3,3,0,175,177,175,2,0
Contra Costa,18,2022-04-23,1361,1383,1368,15,25368,25782,25510,272,31
Del Norte,18,2022-04-23,17,17,17,0,1068,1086,1076,10,1
El Dorado,18,2022-04-23,99,99,98,1,2663,2706,2678,28,0
Fresno,18,2022-04-23,327,333,329,4,15694,15949,15767,182,36
Glenn,18,2022-04-23,4,4,4,0,254,258,256,2,0
Humboldt,18,2022-04-23,169,171,169,2,2755,2800,2774,26,4
Imperial,18,2022-04-23,53,53,52,1,3325,3379,3344,35,5
Inyo,18,2022-04-23,6,6,6,0,183,186,185,1,2
Kern,18,2022-04-23,217,222,220,2,16986,17262,17101,161,21
Kings,18,2022-04-23,54,54,53,1,4408,4480,4430,50,2
Lake,18,2022-04-23,15,15,15,0,795,808,798,10,2
Lassen,18,2022-04-23,0,0,0,0,1523,1546,1533,13,0
Los Angeles,18,2022-04-23,10682,10858,10831,27,854442,868327,866149,2178,218
Madera,18,2022-04-23,30,30,30,0,2828,2875,2842,33,2
Marin,18,2022-04-23,348,355,351,4,6081,6180,6118,62,9
Mariposa,18,2022-04-23,15,15,15,0,213,217,214,3,0
Mendocino,18,2022-04-23,64,64,63,1,1192,1211,1192,19,1
Merced,18,2022-04-23,86,86,85,1,2910,2957,2928,29,6
Modoc,18,2022-04-23,1,1,1,0,35,36,35,1,0
Mono,18,2022-04-23,4,4,4,0,88,88,87,1,0
Monterey,18,2022-04-23,253,256,252,4,7378,7497,7365,132,4
Napa,18,2022-04-23,203,207,205,2,3322,3376,3345,31,0
Nevada,18,2022-04-23,47,47,46,1,1345,1366,1349,17,3
Orange,18,2022-04-23,1816,1846,1829,17,83571,84931,84167,764,66
Placer,18,2022-04-23,206,209,206,3,5684,5776,5702,74,25
Plumas,18,2022-04-23,2,2,2,0,233,237,234,3,0
Riverside,18,2022-04-23,1184,1202,1188,14,38930,39562,39101,461,44
Sacramento,18,2022-04-23,929,946,937,9,30647,31145,30859,286,52
San Benito,18,2022-04-23,33,33,33,0,1134,1152,1143,9,0
San Bernardino,18,2022-04-23,1280,1300,1291,9,41840,42520,42229,291,31
San Diego,18,2022-04-23,2719,2761,2753,8,72275,73451,73240,211,97
San Francisco,18,2022-04-23,1818,1847,1822,25,31008,31512,31079,433,32
San Joaquin,18,2022-04-23,352,359,355,4,15212,15458,15300,158,13
San Luis Obispo,18,2022-04-23,190,192,190,2,4985,5066,5026,40,5
San Mateo,18,2022-04-23,1385,1408,1400,8,31627,32140,31946,194,19
Santa Barbara,18,2022-04-23,350,356,353,3,14658,14896,14758,138,7
Santa Clara,18,2022-04-23,2809,2856,2848,8,68851,69971,69765,206,83
Santa Cruz,18,2022-04-23,456,464,461,3,19435,19750,19609,141,2
Shasta,18,2022-04-23,50,50,49,1,3053,3103,3066,37,0
Siskiyou,18,2022-04-23,8,8,8,0,325,330,327,3,0
Solano,18,2022-04-23,403,409,405,4,10090,10255,10163,92,11
Sonoma,18,2022-04-23,623,634,628,6,11567,11756,11649,107,18
Stanislaus,18,2022-04-23,203,205,202,3,7440,7560,7451,109,21
Sutter,18,2022-04-23,33,33,33,0,1307,1327,1313,14,0
Tehama,18,2022-04-23,15,15,15,0,658,669,658,11,1
Trinity,18,2022-04-23,2,2,2,0,77,77,76,1,0
Tulare,18,2022-04-23,82,82,81,1,6943,7055,6949,106,12
Tuolumne,18,2022-04-23,34,34,34,0,1105,1123,1110,13,1
Ventura,18,2022-04-23,554,561,558,3,18602,18904,18794,110,16
Yolo,18,2022-04-23,184,187,186,1,18476,18777,18640,137,0
Yuba,18,2022-04-23,34,34,34,0,1084,1102,1092,10,1
Alameda,19,2022-04-30,3066,3126,3110,16,69132,70462,70110,352,43
Amador,19,2022-04-30,32,32,32,0,1344,1369,1357,12,0
Butte,19,2022-04-30,88,88,88,0,2283,2328,2318,10,4
Calaveras,19,2022-04-30,32,32,32,0,736,750,744,6,0
Colusa,19,2022-04-30,4,4,4,0,219,223,221,2,0
Contra Costa,19,2022-04-30,1684,1717,1703,14,28700,29253,29021,232,42
Del Norte,19,2022-04-30,37,37,37,0,1205,1228,1220,8,0
El Dorado,19,2022-04-30,115,115,114,1,2747,2800,2778,22,3
Fresno,19,2022-04-30,456,465,461,4,16943,17270,17122,148,39
Glenn,19,2022-04-30,4,4,4,0,244,247,245,2,0
Humboldt,19,2022-04-30,203,208,207,1,2908,2964,2943,21,7
Imperial,19,2022-04-30,111,111,110,1,3681,3751,3722,29,2
Inyo,19,2022-04-30,5,5,5,0,207,211,210,1,0
Kern,19,2022-04-30,278,284,282,2,17905,18248,18120,128,15
Kings,19,2022-04-30,45,45,45,0,4736,4828,4787,41,3
Lake,19,2022-04-30,28,28,28,0,1022,1042,1032,10,1
Lassen,19,2022-04-30,9,9,9,0,1606,1636,1626,10,0
Los Angeles,19,2022-04-30,13632,13896,13870,26,918717,936394,934640,1754,226
Madera,19,2022-04-30,67,67,66,1,3225,3288,3260,28,3
Marin,19,2022-04-30,380,387,384,3,6388,6511,6462,49,9
Mariposa,19,2022-04-30,7,7,7,0,239,245,243,2,0
Mendocino,19,2022-04-30,48,48,47,1,1257,1281,1266,15,0
Merced,19,2022-04-30,116,116,115,1,3248,3310,3286,24,6
Modoc,19,2022-04-30,0,0,0,0,44,45,44,1,0
Mono,19,2022-04-30,4,4,4,0,81,81,80,1,0
Monterey,19,2022-04-30,326,333,329,4,8330,8490,8377,113,8
Napa,19,2022-04-30,215,221,219,2,3492,3559,3535,24,5
Nevada,19,2022-04-30,69,69,68,1,1505,1533,1519,14,2
Orange,19,2022-04-30,2449,2497,2480,17,87564,89251,88650,601,83
Placer,19,2022-04-30,262,269,266,3,6278,6398,6337,61,27
Plumas,19,2022-04-30,7,7,7,0,253,258,255,3,0
Riverside,19,2022-04-30,1751,1785,1770,15,41904,42710,42337,373,41
Sacramento,19,2022-04-30,1231,1255,1246,9,32549,33176,32948,228,51
San Benito,19,2022-04-30,44,44,44,0,1203,1227,1220,7,0
San Bernardino,19,2022-04-30,1330,1355,1348,7,42594,43414,43192,222,37
San Diego,19,2022-04-30,3711,3783,3775,8,71321,72694,72538,156,97
San Francisco,19,2022-04-30,2279,2324,2300,24,35023,35699,35332,367,44
San Joaquin,19,2022-04-30,474,483,479,4,15171,15462,15344,118,17
San Luis Obispo,19,2022-04-30,254,259,257,2,5147,5247,5216,31,9
San Mateo,19,2022-04-30,1679,1712,1704,8,36018,36712,36546,166,20
Santa Barbara,19,2022-04-30,387,394,391,3,15587,15887,15777,110,9
Santa Clara,19,2022-04-30,3870,3944,3935,9,95254,97088,96874,214,86
Santa Cruz,19,2022-04-30,633,646,643,3,22263,22692,22571,121,3
Shasta,19,2022-04-30,60,60,59,1,3421,3486,3455,31,7
Siskiyou,19,2022-04-30,11,11,11,0,321,326,324,2,0
Solano,19,2022-04-30,572,583,579,4,11360,11579,11501,78,14
Sonoma,19,2022-04-30,761,774,769,5,12391,12630,12544,86,19
Stanislaus,19,2022-04-30,275,281,278,3,8274,8432,8341,91,20
Sutter,19,2022-04-30,49,49,49,0,1277,1302,1292,10,0
Tehama,19,2022-04-30,17,17,17,0,676,689,681,8,0
Trinity,19,2022-04-30,1,1,1,0,84,84,83,1,0
Tulare,19,2022-04-30,142,143,141,2,7123,7260,7179,81,10
Tuolumne,19,2022-04-30,81,81,80,1,1236,1260,1249,11,5
Ventura,19,2022-04-30,656,669,666,3,19452,19825,19739,86,16
Yolo,19,2022-04-30,239,245,244,1,19185,19555,19448,107,2
Yuba,19,2022-04-30,36,36,36,0,1041,1060,1053,7,2
Alameda,20,2022-05-07,3933,4029,4014,15,70050,71756,71490,266,68
Amador,20,2022-05-07,12,12,12,0,1400,1433,1424,9,0
Butte,20,2022-05-07,116,118,118,0,2380,2437,2429,8,4
Calaveras,20,2022-05-07,27,27,27,0,692,710,706,4,1
Colusa,20,2022-05-07,3,3,3,0,216,221,220,1,0
Contra Costa,20,2022-05-07,2335,2391,2377,14,30552,31295,31111,184,50
Del Norte,20,2022-05-07,42,42,42,0,1226,1257,1251,6,0
El Dorado,20,2022-05-07,167,173,172,1,2814,2883,2866,17,4
Fresno,20,2022-05-07,656,672,668,4,17846,18280,18164,116,32
Glenn,20,2022-05-07,6,6,6,0,229,235,234,1,0
Humboldt,20,2022-05-07,297,304,302,2,3268,3347,3330,17,4
Imperial,20,2022-05-07,108,111,110,1,3745,3835,3813,22,1
Inyo,20,2022-05-07,18,18,18,0,200,205,204,1,0
Kern,20,2022-05-07,422,432,430,2,18499,18948,18849,99,23
Kings,20,2022-05-07,88,88,87,1,4934,5053,5021,32,2
Lake,20,2022-05-07,30,30,30,0,1008,1033,1026,7,1
Lassen,20,2022-05-07,2,2,2,0,1681,1723,1715,8,0
Los Angeles,20,2022-05-07,17250,17671,17646,25,907709,929750,928456,1294,248
Madera,20,2022-05-07,131,133,132,1,3754,3846,3822,24,3
Marin,20,2022-05-07,635,651,647,4,7592,7777,7733,44,12
Mariposa,20,2022-05-07,25,25,25,0,271,278,276,2,0
Mendocino,20,2022-05-07,87,87,86,1,1236,1266,1255,11,1
Merced,20,2022-05-07,176,182,181,1,3419,3503,3484,19,5
Modoc,20,2022-05-07,2,2,2,0,38,39,38,1,0
Mono,20,2022-05-07,10,10,10,0,126,128,127,1,0
Monterey,20,2022-05-07,433,443,439,4,9204,9426,9333,93,8
Napa,20,2022-05-07,226,232,231,1,3250,3328,3311,17,2
Nevada,20,2022-05-07,99,99,98,1,1636,1674,1663,11,3
Orange,20,2022-05-07,3333,3415,3398,17,90716,92923,92457,466,108
Placer,20,2022-05-07,458,470,467,3,6697,6860,6811,49,27
Plumas,20,2022-05-07,13,13,13,0,275,281,279,2,0
Riverside,20,2022-05-07,2349,2405,2389,16,44911,46002,45703,299,43
Sacramento,20,2022-05-07,1963,2012,2002,10,36276,37158,36968,190,70
San Benito,20,2022-05-07,62,62,62,0,1433,1468,1462,6,0
San Bernardino,20,2022-05-07,1751,1794,1787,7,45204,46301,46125,176,38
San Diego,20,2022-05-07,4895,5015,5007,8,85705,87786,87646,140,94
San Francisco,20,2022-05-07,2819,2888,2866,22,37413,38324,38030,294,52
San Joaquin,20,2022-05-07,672,688,684,4,15782,16164,16072,92,14
San Luis Obispo,20,2022-05-07,286,293,292,1,5193,5318,5294,24,2
San Mateo,20,2022-05-07,2134,2185,2178,7,36733,37625,37499,126,27
Santa Barbara,20,2022-05-07,579,592,589,3,15275,15645,15565,80,14
Santa Clara,20,2022-05-07,5402,5534,5525,9,102383,104868,104696,172,110
Santa Cruz,20,2022-05-07,692,709,706,3,23025,23585,23491,94,5
Shasta,20,2022-05-07,93,93,92,1,3455,3539,3515,24,7
Siskiyou,20,2022-05-07,13,13,13,0,292,298,297,1,0
Solano,20,2022-05-07,805,824,820,4,12175,12472,12410,62,19
Sonoma,20,2022-05-07,1142,1169,1163,6,13907,14245,14173,72,23
Stanislaus,20,2022-05-07,385,396,393,3,8631,8840,8769,71,27
Sutter,20,2022-05-07,45,45,45,0,1523,1560,1551,9,0
Tehama,20,2022-05-07,26,26,26,0,692,710,704,6,1
Trinity,20,2022-05-07,2,2,2,0,68,68,67,1,0
Tulare,20,2022-05-07,172,176,175,1,7583,7767,7702,65,12
Tuolumne,20,2022-05-07,80,80,79,1,1329,1361,1352,9,1
Ventura,20,2022-05-07,1046,1072,1069,3,20884,21391,21322,69,16
Yolo,20,2022-05-07,324,332,331,1,19400,19874,19793,81,1
Yuba,20,2022-05-07,63,63,63,0,1210,1239,1233,6,2
Alameda,21,2022-05-14,4607,4760,4747,13,73937,76400,76189,211,69
Amador,21,2022-05-14,44,44,44,0,1679,1735,1727,8,1
Butte,21,2022-05-14,157,163,163,0,2561,2646,2640,6,6
Calaveras,21,2022-05-14,35,35,35,0,745,770,767,3,2
Colusa,21,2022-05-14,5,5,5,0,202,209,208,1,0
Contra Costa,21,2022-05-14,2985,3085,3072,13,32129,33198,33052,146,55
Del Norte,21,2022-05-14,107,110,110,0,1745,1804,1797,7,0
El Dorado,21,2022-05-14,226,232,231,1,3012,3112,3098,14,6
Fresno,21,2022-05-14,931,963,958,5,18501,19118,19027,91,44
Glenn,21,2022-05-14,12,12,12,0,244,252,251,1,0
Humboldt,21,2022-05-14,277,287,286,1,3198,3303,3290,13,10
Imperial,21,2022-05-14,197,204,203,1,4175,4313,4294,19,4
Inyo,21,2022-05-14,20,20,20,0,226,233,232,1,1
Kern,21,2022-05-14,561,579,577,2,19448,20094,20016,78,20
Kings,21,2022-05-14,164,170,169,1,5246,5421,5396,25,0
Lake,21,2022-05-14,56,57,57,0,1121,1157,1151,6,0
Lassen,21,2022-05-14,14,14,14,0,1683,1737,1731,6,0
Los Angeles,21,2022-05-14,19296,19940,19919,21,922611,953204,952216,988,318
Madera,21,2022-05-14,165,171,170,1,3587,3707,3690,17,3
Marin,21,2022-05-14,718,743,740,3,8052,8321,8286,35,11
Mariposa,21,2022-05-14,27,27,27,0,349,361,359,2,0
Mendocino,21,2022-05-14,95,99,98,1,1322,1366,1357,9,2
Merced,21,2022-05-14,259,267,266,1,3806,3933,3917,16,8
Modoc,21,2022-05-14,1,1,1,0,39,40,39,1,0
Mono,21,2022-05-14,9,9,9,0,116,119,118,1,0
Monterey,21,2022-05-14,482,498,494,4,9398,9708,9636,72,10
Napa,21,2022-05-14,289,299,298,1,3495,3611,3597,14,3
Nevada,21,2022-05-14,129,133,132,1,1836,1897,1887,10,3
Orange,21,2022-05-14,4083,4219,4203,16,93009,96108,95749,359,88
Placer,21,2022-05-14,612,633,630,3,7348,7592,7552,40,37
Plumas,21,2022-05-14,41,41,41,0,256,264,263,1,1
Riverside,21,2022-05-14,2887,2985,2971,14,46159,47693,47462,231,59
Sacramento,21,2022-05-14,2768,2860,2849,11,38350,39629,39478,151,71
San Benito,21,2022-05-14,99,103,103,0,1522,1571,1566,5,3
San Bernardino,21,2022-05-14,2210,2283,2277,6,47283,48856,48718,138,47
San Diego,21,2022-05-14,5993,6195,6188,7,91459,94501,94389,112,111
San Francisco,21,2022-05-14,3280,3389,3370,19,38685,39970,39741,229,63
San Joaquin,21,2022-05-14,1096,1134,1129,5,17895,18489,18411,78,12
San Luis Obispo,21,2022-05-14,350,361,360,1,5768,5960,5940,20,2
San Mateo,21,2022-05-14,2626,2713,2706,7,39377,40686,40584,102,37
Santa Barbara,21,2022-05-14,774,800,797,3,16382,16926,16861,65,10
Santa Clara,21,2022-05-14,6568,6787,6779,8,109504,113137,112999,138,124
Santa Cruz,21,2022-05-14,885,913,910,3,24844,25672,25596,76,4
Shasta,21,2022-05-14,115,118,117,1,3724,3846,3827,19,6
Siskiyou,21,2022-05-14,18,18,18,0,383,396,395,1,1
Solano,21,2022-05-14,1086,1124,1120,4,13281,13726,13675,51,24
Sonoma,21,2022-05-14,1426,1475,1469,6,15191,15697,15638,59,23
Stanislaus,21,2022-05-14,631,652,648,4,9647,9965,9905,60,35
Sutter,21,2022-05-14,102,105,105,0,1753,1811,1803,8,0
Tehama,21,2022-05-14,22,22,22,0,799,826,821,5,2
Trinity,21,2022-05-14,4,4,4,0,68,70,69,1,0
Tulare,21,2022-05-14,294,305,303,2,7834,8093,8043,50,11
Tuolumne,21,2022-05-14,94,97,97,0,1439,1485,1478,7,2
Ventura,21,2022-05-14,1352,1398,1395,3,22827,23586,23529,57,25
Yolo,21,2022-05-14,458,473,472,1,21369,22087,22020,67,2
Yuba,21,2022-05-14,105,110,110,0,1250,1291,1286,5,2
Alameda,22,2022-05-21,5189,5492,5481,11,75538,79899,79734,165,92
Amador,22,2022-05-21,60,63,63,0,1573,1663,1657,6,0
Butte,22,2022-05-21,259,275,275,0,2718,2871,2866,5,7
Calaveras,22,2022-05-21,44,45,45,0,763,806,803,3,0
Colusa,22,2022-05-21,4,4,4,0,223,236,235,1,0
Contra Costa,22,2022-05-21,3504,3703,3691,12,34467,36457,36338,119,76
Del Norte,22,2022-05-21,123,129,129,0,1564,1652,1647,5,0
El Dorado,22,2022-05-21,295,313,312,1,3289,3479,3468,11,4
Fresno,22,2022-05-21,1379,1458,1453,5,20513,21703,21626,77,66
Glenn,22,2022-05-21,18,18,18,0,274,290,289,1,0
Humboldt,22,2022-05-21,220,231,230,1,2862,3027,3018,9,13
Imperial,22,2022-05-21,278,294,293,1,4602,4866,4850,16,4
Inyo,22,2022-05-21,24,24,24,0,236,250,249,1,0
Kern,22,2022-05-21,837,885,882,3,20205,21362,21300,62,39
Kings,22,2022-05-21,243,256,255,1,5585,5904,5883,21,0
Lake,22,2022-05-21,69,73,73,0,1230,1300,1295,5,0
Lassen,22,2022-05-21,34,34,34,0,1700,1795,1790,5,0
Los Angeles,22,2022-05-21,24400,25831,25811,20,908031,959968,959226,742,385
Madera,22,2022-05-21,194,207,206,1,3732,3951,3937,14,2
Marin,22,2022-05-21,759,801,798,3,8708,9213,9184,29,16
Mariposa,22,2022-05-21,30,31,31,0,334,354,353,1,0
Mendocino,22,2022-05-21,121,127,126,1,1616,1711,1703,8,5
Merced,22,2022-05-21,373,393,392,1,4105,4340,4327,13,3
Modoc,22,2022-05-21,2,2,2,0,38,39,38,1,0
Mono,22,2022-05-21,16,16,16,0,148,156,155,1,0
Monterey,22,2022-05-21,561,594,591,3,9564,10103,10047,56,11
Napa,22,2022-05-21,264,278,277,1,3917,4143,4131,12,5
Nevada,22,2022-05-21,131,138,137,1,1810,1917,1910,7,1
Orange,22,2022-05-21,5234,5542,5527,15,94975,100469,100190,279,112
Placer,22,2022-05-21,792,837,834,3,7875,8325,8292,33,39
Plumas,22,2022-05-21,28,28,28,0,256,270,269,1,0
Riverside,22,2022-05-21,3832,4053,4038,15,49985,52869,52678,191,79
Sacramento,22,2022-05-21,3583,3791,3780,11,40454,42781,42659,122,116
San Benito,22,2022-05-21,157,165,165,0,1560,1650,1646,4,0
San Bernardino,22,2022-05-21,2753,2911,2905,6,48200,50979,50872,107,51
San Diego,22,2022-05-21,8337,8822,8814,8,101050,106867,106773,94,142
San Francisco,22,2022-05-21,3459,3654,3638,16,41321,43717,43531,186,94
San Joaquin,22,2022-05-21,1360,1439,1434,5,20251,21406,21339,67,26
San Luis Obispo,22,2022-05-21,581,615,614,1,6872,7270,7252,18,11
San Mateo,22,2022-05-21,2857,3021,3015,6,40247,42557,42478,79,47
Santa Barbara,22,2022-05-21,1019,1077,1074,3,17909,18938,18884,54,20
Santa Clara,22,2022-05-21,7264,7679,7672,7,111034,117393,117286,107,129
Santa Cruz,22,2022-05-21,473,501,500,1,7966,8419,8400,19,13
Shasta,22,2022-05-21,168,177,176,1,3534,3732,3718,14,7
Siskiyou,22,2022-05-21,18,18,18,0,334,353,352,1,1
Solano,22,2022-05-21,1402,1483,1479,4,14111,14922,14881,41,27
Sonoma,22,2022-05-21,1436,1517,1513,4,16126,17058,17010,48,36
Stanislaus,22,2022-05-21,792,838,834,4,10272,10851,10802,49,42
Sutter,22,2022-05-21,133,141,141,0,1781,1883,1877,6,0
Tehama,22,2022-05-21,60,63,63,0,745,788,784,4,1
Trinity,22,2022-05-21,4,4,4,0,83,90,89,1,0
Tulare,22,2022-05-21,461,489,487,2,8972,9480,9436,44,22
Tuolumne,22,2022-05-21,144,151,150,1,1581,1671,1665,6,1
Ventura,22,2022-05-21,1741,1842,1839,3,23674,25038,24993,45,36
Yolo,22,2022-05-21,526,556,555,1,22197,23489,23436,53,2
Yuba,22,2022-05-21,147,154,154,0,1423,1504,1500,4,6
Alameda,23,2022-05-25,2038,2307,2303,4,28383,32208,32155,53,88
Amador,23,2022-05-25,28,32,32,0,406,461,460,1,1
Butte,23,2022-05-25,99,113,113,0,1144,1300,1298,2,8
Calaveras,23,2022-05-25,16,18,18,0,306,352,351,1,0
Colusa,23,2022-05-25,4,4,4,0,82,94,93,1,0
Contra Costa,23,2022-05-25,1304,1478,1474,4,13012,14750,14711,39,76
Del Norte,23,2022-05-25,23,26,26,0,453,512,511,1,2
El Dorado,23,2022-05-25,148,169,169,0,1211,1375,1371,4,6
Fresno,23,2022-05-25,616,699,697,2,7874,8943,8918,25,66
Glenn,23,2022-05-25,15,16,16,0,158,180,179,1,0
Humboldt,23,2022-05-25,94,105,105,0,1075,1221,1218,3,12
Imperial,23,2022-05-25,97,112,112,0,2110,2407,2401,6,6
Inyo,23,2022-05-25,10,10,10,0,102,118,117,1,0
Kern,23,2022-05-25,284,321,320,1,6897,7787,7769,18,27
Kings,23,2022-05-25,116,132,132,0,2002,2276,2270,6,1
Lake,23,2022-05-25,34,38,38,0,469,536,534,2,2
Lassen,23,2022-05-25,20,23,23,0,762,858,856,2,1
Los Angeles,23,2022-05-25,8330,9379,9373,6,103385,115756,115684,72,429
Madera,23,2022-05-25,70,80,80,0,1321,1503,1499,4,5
Marin,23,2022-05-25,291,332,331,1,3185,3623,3614,9,9
Mariposa,23,2022-05-25,6,6,6,0,78,90,89,1,0
Mendocino,23,2022-05-25,47,54,54,0,552,631,629,2,2
Merced,23,2022-05-25,121,138,138,0,1457,1652,1648,4,6
Modoc,23,2022-05-25,1,1,1,0,15,17,16,1,0
Mono,23,2022-05-25,2,2,2,0,68,78,77,1,0
Monterey,23,2022-05-25,212,241,240,1,4012,4553,4533,20,11
Napa,23,2022-05-25,103,118,118,0,1224,1389,1386,3,6
Nevada,23,2022-05-25,45,50,50,0,561,634,632,2,1
Orange,23,2022-05-25,2123,2406,2401,5,35571,40565,40475,90,126
Placer,23,2022-05-25,321,364,363,1,3211,3640,3629,11,56
Plumas,23,2022-05-25,21,24,24,0,152,176,175,1,1
Riverside,23,2022-05-25,1469,1663,1658,5,19271,21823,21760,63,90
Sacramento,23,2022-05-25,1318,1490,1487,3,14812,16776,16738,38,134
San Benito,23,2022-05-25,56,64,64,0,752,858,856,2,0
San Bernardino,23,2022-05-25,1199,1360,1358,2,17660,19982,19948,34,58
San Diego,23,2022-05-25,3097,3511,3509,2,38991,44268,44237,31,169
San Francisco,23,2022-05-25,1157,1317,1313,4,15711,17834,17773,61,92
San Joaquin,23,2022-05-25,523,596,595,1,7494,8482,8461,21,26
San Luis Obispo,23,2022-05-25,278,315,314,1,2749,3104,3098,6,11
San Mateo,23,2022-05-25,1018,1152,1150,2,15475,17553,17527,26,36
Santa Barbara,23,2022-05-25,458,523,522,1,7389,8411,8392,19,21
Santa Clara,23,2022-05-25,2781,3152,3150,2,38533,43655,43623,32,159
Santa Cruz,23,2022-05-25,126,142,142,0,2957,3351,3345,6,11
Shasta,23,2022-05-25,63,71,71,0,1222,1380,1376,4,9
Siskiyou,23,2022-05-25,17,19,19,0,151,174,173,1,3
Solano,23,2022-05-25,464,526,525,1,4825,5466,5454,12,39
Sonoma,23,2022-05-25,428,483,482,1,5440,6176,6162,14,44
Stanislaus,23,2022-05-25,283,321,320,1,3909,4441,4425,16,42
Sutter,23,2022-05-25,70,81,81,0,1035,1181,1178,3,0
Tehama,23,2022-05-25,8,9,9,0,265,298,297,1,2
Trinity,23,2022-05-25,1,1,1,0,36,42,41,1,0
Tulare,23,2022-05-25,204,231,230,1,3144,3557,3544,13,25
Tuolumne,23,2022-05-25,41,47,47,0,654,745,743,2,0
Ventura,23,2022-05-25,601,681,680,1,8783,9993,9979,14,36
Yolo,23,2022-05-25,143,162,162,0,6823,7724,7710,14,3
Yuba,23,2022-05-25,52,60,60,0,607,691,689,2,9
