county,time,date,cases,est_cases,est_omicron_cases,est_other_cases,tests,est_tests,est_omicron_tests,est_other_tests,hospitalizations
Alameda,1,2021-12-19,2339,2346,1021,1325,89358,89562,38244,51318,68
Amador,1,2021-12-19,45,45,14,31,1654,1659,497,1162,4
Butte,1,2021-12-19,159,159,75,84,4228,4238,1977,2261,25
Calaveras,1,2021-12-19,54,54,18,36,1683,1686,560,1126,1
Colusa,1,2021-12-19,14,14,5,9,461,461,160,301,0
Contra Costa,1,2021-12-19,1381,1383,452,931,43043,43141,13785,29356,33
Del Norte,1,2021-12-19,18,18,7,11,1388,1390,509,881,0
El Dorado,1,2021-12-19,217,217,72,145,4419,4431,1438,2993,9
Fresno,1,2021-12-19,980,980,300,680,25860,25919,7837,18082,173
Glenn,1,2021-12-19,20,20,7,13,421,421,148,273,0
Humboldt,1,2021-12-19,145,145,51,94,3640,3648,1270,2378,12
Imperial,1,2021-12-19,590,590,193,397,5827,5840,1884,3956,64
Inyo,1,2021-12-19,26,26,11,15,357,357,144,213,1
Kern,1,2021-12-19,895,895,313,582,28616,28680,9901,18779,120
Kings,1,2021-12-19,235,235,72,163,7308,7324,2230,5094,19
Lake,1,2021-12-19,36,36,10,26,1434,1438,415,1023,0
Lassen,1,2021-12-19,8,8,3,5,2481,2487,984,1503,0
Los Angeles,1,2021-12-19,25605,25664,17284,8380,1036976,1039336,690840,348496,741
Madera,1,2021-12-19,161,161,49,112,6024,6039,1832,4207,14
Marin,1,2021-12-19,443,443,151,292,11477,11503,3836,7667,4
Mariposa,1,2021-12-19,16,16,5,11,450,450,138,312,0
Mendocino,1,2021-12-19,87,87,21,66,2628,2633,625,2008,5
Merced,1,2021-12-19,261,261,90,171,5603,5616,1887,3729,22
Modoc,1,2021-12-19,4,4,2,2,50,50,18,32,2
Mono,1,2021-12-19,30,30,8,22,294,294,78,216,1
Monterey,1,2021-12-19,431,431,96,335,13056,13085,2874,10211,29
Napa,1,2021-12-19,199,199,72,127,5668,5681,2003,3678,3
Nevada,1,2021-12-19,152,152,45,107,2660,2665,773,1892,6
Orange,1,2021-12-19,3945,3953,1435,2518,96173,96392,34402,61990,195
Placer,1,2021-12-19,490,490,141,349,11076,11102,3118,7984,79
Plumas,1,2021-12-19,17,17,5,12,508,508,151,357,0
Riverside,1,2021-12-19,4825,4838,1473,3365,78630,78811,23564,55247,317
Sacramento,1,2021-12-19,1923,1930,687,1243,53404,53524,18776,34748,137
San Benito,1,2021-12-19,87,87,35,52,1955,1959,781,1178,5
San Bernardino,1,2021-12-19,4210,4218,1805,2413,78308,78486,33080,45406,403
San Diego,1,2021-12-19,7119,7136,4582,2554,146794,147129,93726,53403,351
San Francisco,1,2021-12-19,2349,2356,644,1712,53079,53201,14244,38957,35
San Joaquin,1,2021-12-19,841,841,279,562,25797,25857,8430,17427,78
San Luis Obispo,1,2021-12-19,352,352,138,214,9695,9718,3737,5981,16
San Mateo,1,2021-12-19,1210,1211,561,650,49870,49984,22670,27314,13
Santa Barbara,1,2021-12-19,640,640,229,411,15627,15662,5494,10168,31
Santa Clara,1,2021-12-19,2332,2339,1491,848,121508,121785,76560,45225,125
Santa Cruz,1,2021-12-19,354,354,147,207,21094,21141,8633,12508,16
Shasta,1,2021-12-19,155,155,47,108,6012,6024,1766,4258,35
Siskiyou,1,2021-12-19,17,17,7,10,476,476,191,285,4
Solano,1,2021-12-19,440,440,159,281,14665,14699,5221,9478,25
Sonoma,1,2021-12-19,659,659,238,421,21228,21275,7516,13759,30
Stanislaus,1,2021-12-19,623,623,162,461,13642,13673,3502,10171,113
Sutter,1,2021-12-19,94,94,32,62,2201,2206,729,1477,0
Tehama,1,2021-12-19,55,55,13,42,1300,1304,309,995,8
Trinity,1,2021-12-19,3,3,1,2,106,106,29,77,0
Tulare,1,2021-12-19,387,387,97,290,12494,12522,3090,9432,51
Tuolumne,1,2021-12-19,95,95,29,66,1961,1966,597,1369,7
Ventura,1,2021-12-19,1662,1667,784,883,38668,38756,17892,20864,80
Yolo,1,2021-12-19,284,284,116,168,25329,25388,10300,15088,5
Yuba,1,2021-12-19,98,98,35,63,1882,1887,667,1220,8
Alameda,2,2021-12-26,6059,6073,3071,3002,84843,85046,42331,42715,90
Amador,2,2021-12-26,88,88,33,55,1505,1509,546,963,4
Butte,2,2021-12-26,427,427,235,192,3959,3969,2141,1828,38
Calaveras,2,2021-12-26,94,94,39,55,999,1001,400,601,2
Colusa,2,2021-12-26,17,17,7,10,232,232,96,136,2
Contra Costa,2,2021-12-26,3866,3876,1526,2350,44458,44564,17175,27389,52
Del Norte,2,2021-12-26,24,24,11,13,1245,1248,541,707,0
El Dorado,2,2021-12-26,411,411,163,248,4196,4206,1633,2573,10
Fresno,2,2021-12-26,1733,1739,651,1088,23050,23106,8478,14628,161
Glenn,2,2021-12-26,44,44,19,25,424,424,177,247,0
Humboldt,2,2021-12-26,396,396,169,227,3247,3255,1348,1907,9
Imperial,2,2021-12-26,706,706,280,426,5505,5519,2149,3370,55
Inyo,2,2021-12-26,95,95,46,49,410,410,193,217,0
Kern,2,2021-12-26,1462,1465,623,842,20572,20622,8578,12044,104
Kings,2,2021-12-26,410,410,157,253,5349,5361,1978,3383,19
Lake,2,2021-12-26,54,54,20,34,1153,1157,407,750,0
Lassen,2,2021-12-26,19,19,9,10,2325,2332,1087,1245,0
Los Angeles,2,2021-12-26,75130,75310,55128,20182,684297,685939,498366,187573,966
Madera,2,2021-12-26,242,242,92,150,4227,4237,1557,2680,11
Marin,2,2021-12-26,1400,1403,572,831,15718,15756,6326,9430,4
Mariposa,2,2021-12-26,36,36,13,23,505,505,185,320,0
Mendocino,2,2021-12-26,118,118,36,82,2485,2490,723,1767,6
Merced,2,2021-12-26,494,494,204,290,4935,4946,1994,2952,2
Modoc,2,2021-12-26,3,3,1,2,58,58,25,33,3
Mono,2,2021-12-26,108,108,35,73,366,366,115,251,1
Monterey,2,2021-12-26,832,832,234,598,12610,12641,3447,9194,36
Napa,2,2021-12-26,648,648,280,368,5738,5751,2437,3314,6
Nevada,2,2021-12-26,211,211,76,135,2535,2540,887,1653,6
Orange,2,2021-12-26,13012,13044,5661,7383,114151,114426,48816,65610,282
Placer,2,2021-12-26,991,991,348,643,10359,10384,3548,6836,85
Plumas,2,2021-12-26,13,13,5,8,398,398,142,256,0
Riverside,2,2021-12-26,10905,10930,4051,6879,80317,80509,29241,51268,371
Sacramento,2,2021-12-26,3959,3969,1698,2271,48907,49025,20527,28498,165
San Benito,2,2021-12-26,254,254,122,132,2207,2212,1046,1166,4
San Bernardino,2,2021-12-26,10396,10421,5236,5185,82269,82466,40582,41884,438
San Diego,2,2021-12-26,20571,20621,14546,6075,164489,164885,115450,49435,384
San Francisco,2,2021-12-26,6127,6142,2031,4111,64252,64406,20980,43426,41
San Joaquin,2,2021-12-26,1804,1810,730,1080,21530,21581,8501,13080,78
San Luis Obispo,2,2021-12-26,830,830,385,445,10433,10458,4747,5711,22
San Mateo,2,2021-12-26,4336,4346,2330,2016,53188,53315,28080,25235,21
Santa Barbara,2,2021-12-26,1684,1689,724,965,14417,14452,6051,8401,39
Santa Clara,2,2021-12-26,7193,7210,5058,2152,100090,100331,69590,30741,118
Santa Cruz,2,2021-12-26,761,761,375,386,11965,11993,5739,6254,14
Shasta,2,2021-12-26,207,207,76,131,4649,4659,1656,3003,40
Siskiyou,2,2021-12-26,16,16,8,8,356,356,170,186,0
Solano,2,2021-12-26,915,916,395,521,15676,15713,6680,9033,29
Sonoma,2,2021-12-26,1600,1603,696,907,20132,20181,8551,11630,20
Stanislaus,2,2021-12-26,1011,1012,329,683,10796,10822,3437,7385,104
Sutter,2,2021-12-26,200,200,81,119,2058,2063,819,1244,0
Tehama,2,2021-12-26,78,78,24,54,1067,1070,313,757,11
Trinity,2,2021-12-26,4,4,1,3,96,96,32,64,0
Tulare,2,2021-12-26,659,659,207,452,10621,10646,3238,7408,46
Tuolumne,2,2021-12-26,150,150,57,93,1773,1777,654,1123,6
Ventura,2,2021-12-26,4464,4473,2440,2033,36828,36917,19774,17143,78
Yolo,2,2021-12-26,616,616,298,318,18969,19015,8956,10059,7
Yuba,2,2021-12-26,129,129,56,73,1521,1525,641,884,11
Alameda,3,2022-01-02,14606,14643,8421,6222,105284,105550,60417,45133,173
Amador,3,2022-01-02,164,164,73,91,1892,1896,825,1071,6
Butte,3,2022-01-02,1001,1002,621,381,5953,5967,3656,2311,33
Calaveras,3,2022-01-02,177,177,86,91,1143,1146,542,604,2
Colusa,3,2022-01-02,52,52,25,27,314,314,152,162,5
Contra Costa,3,2022-01-02,11656,11685,5381,6304,60899,61052,27956,33096,91
Del Norte,3,2022-01-02,60,60,31,29,2007,2012,1015,997,0
El Dorado,3,2022-01-02,1096,1098,513,585,5472,5485,2539,2946,17
Fresno,3,2022-01-02,5382,5396,2384,3012,35871,35962,15781,20181,193
Glenn,3,2022-01-02,65,65,32,33,523,523,257,266,0
Humboldt,3,2022-01-02,780,780,386,394,4860,4872,2384,2488,11
Imperial,3,2022-01-02,1525,1529,710,819,8324,8345,3851,4494,58
Inyo,3,2022-01-02,216,216,119,97,612,612,333,279,2
Kern,3,2022-01-02,4618,4630,2292,2338,30744,30822,15071,15751,124
Kings,3,2022-01-02,922,922,414,508,7677,7697,3402,4295,14
Lake,3,2022-01-02,171,171,74,97,1494,1498,634,864,2
Lassen,3,2022-01-02,49,49,27,22,2661,2667,1437,1230,2
Los Angeles,3,2022-01-02,182508,182972,143258,39714,948633,951036,744056,206980,1994
Madera,3,2022-01-02,696,696,309,387,5831,5845,2569,3276,18
Marin,3,2022-01-02,2185,2190,1036,1154,17075,17118,8041,9077,19
Mariposa,3,2022-01-02,78,78,35,43,537,537,236,301,0
Mendocino,3,2022-01-02,379,379,138,241,3178,3185,1141,2044,10
Merced,3,2022-01-02,1256,1260,605,655,7488,7508,3581,3927,26
Modoc,3,2022-01-02,14,14,7,7,52,52,26,26,0
Mono,3,2022-01-02,177,177,68,109,396,396,151,245,1
Monterey,3,2022-01-02,2114,2120,721,1399,18466,18511,6245,12266,36
Napa,3,2022-01-02,1554,1558,777,781,10207,10232,5063,5169,11
Nevada,3,2022-01-02,516,516,223,293,2243,2250,963,1287,8
Orange,3,2022-01-02,40791,40895,20453,20442,202152,202663,101012,101651,545
Placer,3,2022-01-02,2499,2506,1045,1461,14245,14281,5876,8405,129
Plumas,3,2022-01-02,46,46,20,26,359,359,154,205,1
Riverside,3,2022-01-02,27873,27942,12206,15736,128319,128644,55816,72828,595
Sacramento,3,2022-01-02,11764,11793,5852,5941,72897,73081,36001,37080,267
San Benito,3,2022-01-02,642,642,352,290,3142,3150,1722,1428,6
San Bernardino,3,2022-01-02,29005,29078,16548,12530,125444,125761,71223,54538,655
San Diego,3,2022-01-02,55103,55242,41948,13294,235515,236111,179122,56989,664
San Francisco,3,2022-01-02,10031,10056,3997,6059,76786,76981,30367,46614,96
San Joaquin,3,2022-01-02,5878,5894,2788,3106,33047,33132,15498,17634,92
San Luis Obispo,3,2022-01-02,2164,2169,1149,1020,15036,15075,7957,7118,22
San Mateo,3,2022-01-02,9430,9454,5701,3753,71254,71435,42900,28535,36
Santa Barbara,3,2022-01-02,4556,4568,2274,2294,24549,24612,12202,12410,57
Santa Clara,3,2022-01-02,19192,19241,14568,4673,140545,140901,106229,34672,225
Santa Cruz,3,2022-01-02,2018,2025,1139,886,16679,16721,9309,7412,22
Shasta,3,2022-01-02,490,490,215,275,5590,5605,2400,3205,43
Siskiyou,3,2022-01-02,57,57,31,26,460,460,252,208,0
Solano,3,2022-01-02,3630,3639,1817,1822,24260,24322,12097,12225,66
Sonoma,3,2022-01-02,3706,3715,1857,1858,28209,28280,14038,14242,29
Stanislaus,3,2022-01-02,2828,2835,1106,1729,16389,16431,6331,10100,130
Sutter,3,2022-01-02,437,437,209,228,2720,2726,1284,1442,0
Tehama,3,2022-01-02,181,181,67,114,1184,1187,424,763,3
Trinity,3,2022-01-02,11,11,5,6,100,100,40,60,0
Tulare,3,2022-01-02,1712,1718,652,1066,14915,14953,5551,9402,59
Tuolumne,3,2022-01-02,312,312,140,172,1967,1973,871,1102,6
Ventura,3,2022-01-02,11591,11621,7086,4535,55407,55547,33700,21847,153
Yolo,3,2022-01-02,1934,1940,1081,859,30073,30149,16570,13579,8
Yuba,3,2022-01-02,397,397,200,197,2109,2115,1048,1067,24
Alameda,4,2022-01-09,31137,31221,20130,11091,191789,192307,123850,68457,322
Amador,4,2022-01-09,372,372,190,182,2753,2761,1396,1365,8
Butte,4,2022-01-09,1910,1917,1308,609,10000,10026,6817,3209,48
Calaveras,4,2022-01-09,464,464,257,207,2462,2468,1351,1117,2
Colusa,4,2022-01-09,80,80,45,35,658,658,367,291,5
Contra Costa,4,2022-01-09,19070,19121,10202,8919,102480,102756,54721,48035,167
Del Norte,4,2022-01-09,172,172,100,72,3830,3840,2241,1599,1
El Dorado,4,2022-01-09,2150,2156,1162,994,9000,9025,4848,4177,18
Fresno,4,2022-01-09,12241,12274,6332,5942,58221,58379,30012,28367,305
Glenn,4,2022-01-09,182,182,104,78,860,861,487,374,2
Humboldt,4,2022-01-09,1396,1401,792,609,8305,8328,4701,3627,16
Imperial,4,2022-01-09,3449,3460,1855,1605,13724,13762,7365,6397,73
Inyo,4,2022-01-09,377,377,232,145,1237,1240,764,476,3
Kern,4,2022-01-09,11406,11437,6465,4972,55733,55884,31420,24464,199
Kings,4,2022-01-09,2051,2057,1073,984,12141,12174,6301,5873,29
Lake,4,2022-01-09,458,458,229,229,2700,2707,1341,1366,2
Lassen,4,2022-01-09,139,139,85,54,3519,3528,2140,1388,2
Los Angeles,4,2022-01-09,331844,332742,275827,56915,1898359,1903490,1577550,325940,3472
Madera,4,2022-01-09,1785,1791,929,862,10201,10230,5260,4970,28
Marin,4,2022-01-09,3047,3055,1669,1386,21431,21489,11719,9770,23
Mariposa,4,2022-01-09,180,180,92,88,1101,1104,566,538,0
Mendocino,4,2022-01-09,789,789,340,449,5299,5313,2272,3041,7
Merced,4,2022-01-09,3202,3211,1777,1434,13477,13514,7458,6056,45
Modoc,4,2022-01-09,13,13,7,6,98,98,56,42,0
Mono,4,2022-01-09,248,248,113,135,825,826,376,450,1
Monterey,4,2022-01-09,4544,4556,1854,2702,31873,31960,12947,19013,52
Napa,4,2022-01-09,2695,2701,1539,1162,14968,15008,8523,6485,17
Nevada,4,2022-01-09,1111,1113,559,554,4917,4930,2452,2478,13
Orange,4,2022-01-09,61044,61209,35015,26194,311002,311842,178321,133521,964
Placer,4,2022-01-09,4962,4974,2433,2541,21502,21561,10489,11072,189
Plumas,4,2022-01-09,118,118,60,58,779,779,389,390,4
Riverside,4,2022-01-09,47620,47749,24279,23470,184626,185124,94024,91100,886
Sacramento,4,2022-01-09,26773,26845,15247,11598,119744,120067,68027,52040,426
San Benito,4,2022-01-09,1037,1039,645,394,4480,4492,2783,1709,6
San Bernardino,4,2022-01-09,47610,47737,30531,17206,189172,189683,121167,68516,937
San Diego,4,2022-01-09,84899,85129,68815,16314,337705,338618,273759,64859,988
San Francisco,4,2022-01-09,16084,16127,7530,8597,120651,120978,56474,64504,178
San Joaquin,4,2022-01-09,13195,13232,7206,6026,61342,61507,33396,28111,156
San Luis Obispo,4,2022-01-09,4269,4281,2583,1698,21652,21710,13073,8637,37
San Mateo,4,2022-01-09,15022,15063,10076,4987,113110,113418,75722,37696,110
Santa Barbara,4,2022-01-09,8289,8312,4718,3594,45240,45362,25750,19612,87
Santa Clara,4,2022-01-09,34983,35078,28236,6842,262971,263682,212042,51640,405
Santa Cruz,4,2022-01-09,4462,4474,2820,1654,41628,41741,26188,15553,22
Shasta,4,2022-01-09,999,999,507,492,8269,8291,4166,4125,46
Siskiyou,4,2022-01-09,115,115,71,44,886,887,546,341,6
Solano,4,2022-01-09,6687,6705,3852,2853,36476,36575,20971,15604,92
Sonoma,4,2022-01-09,8503,8526,4871,3655,46460,46584,26532,20052,76
Stanislaus,4,2022-01-09,6203,6220,2866,3354,27450,27524,12606,14918,178
Sutter,4,2022-01-09,1130,1131,620,511,4701,4714,2566,2148,0
Tehama,4,2022-01-09,459,459,199,260,2395,2400,1028,1372,12
Trinity,4,2022-01-09,35,35,17,18,266,266,127,139,0
Tulare,4,2022-01-09,4464,4476,2009,2467,22629,22690,10091,12599,66
Tuolumne,4,2022-01-09,750,750,388,362,4116,4128,2117,2011,15
Ventura,4,2022-01-09,17409,17455,11802,5653,86493,86726,58552,28174,248
Yolo,4,2022-01-09,3842,3854,2402,1452,49058,49191,30630,18561,8
Yuba,4,2022-01-09,947,947,542,405,3875,3887,2215,1672,46
Alameda,5,2022-01-16,26463,26541,18791,7750,183965,184500,130570,53930,415
Amador,5,2022-01-16,490,490,285,205,3802,3813,2201,1612,12
Butte,5,2022-01-16,2086,2092,1550,542,9412,9440,6975,2465,60
Calaveras,5,2022-01-16,598,598,370,228,2704,2711,1675,1036,6
Colusa,5,2022-01-16,170,170,107,63,802,804,503,301,3
Contra Costa,5,2022-01-16,16268,16316,9881,6435,95047,95324,57601,37723,242
Del Norte,5,2022-01-16,198,198,129,69,3949,3961,2548,1413,3
El Dorado,5,2022-01-16,2096,2102,1276,826,8804,8829,5356,3473,14
Fresno,5,2022-01-16,16798,16847,9889,6958,68167,68365,40060,28305,422
Glenn,5,2022-01-16,306,306,195,111,1062,1066,677,389,1
Humboldt,5,2022-01-16,1242,1246,790,456,8848,8873,5622,3251,15
Imperial,5,2022-01-16,3684,3695,2239,1456,14149,14190,8600,5590,92
Inyo,5,2022-01-16,393,393,267,126,1233,1237,839,398,2
Kern,5,2022-01-16,12888,12926,8186,4740,58689,58860,37154,21706,279
Kings,5,2022-01-16,3502,3513,2074,1439,16614,16664,9823,6841,43
Lake,5,2022-01-16,588,588,336,252,3177,3186,1816,1370,3
Lassen,5,2022-01-16,294,294,199,95,3788,3799,2559,1240,1
Los Angeles,5,2022-01-16,243040,243748,211058,32690,1775006,1780178,1541325,238853,4564
Madera,5,2022-01-16,2408,2414,1423,991,11033,11064,6493,4571,36
Marin,5,2022-01-16,2577,2584,1595,989,18935,18991,11701,7290,42
Mariposa,5,2022-01-16,186,186,108,78,1216,1221,712,509,0
Mendocino,5,2022-01-16,982,983,493,490,5559,5576,2783,2793,21
Merced,5,2022-01-16,4150,4161,2590,1571,14902,14945,9294,5651,50
Modoc,5,2022-01-16,12,12,8,4,110,110,71,39,0
Mono,5,2022-01-16,229,229,121,108,880,881,466,415,1
Monterey,5,2022-01-16,6193,6212,2978,3234,30230,30318,14462,15856,71
Napa,5,2022-01-16,2160,2166,1384,782,13264,13302,8479,4823,23
Nevada,5,2022-01-16,1293,1298,742,556,5660,5677,3228,2449,22
Orange,5,2022-01-16,45926,46059,29519,16540,278187,278996,178641,100355,1200
Placer,5,2022-01-16,4589,4602,2572,2030,20996,21057,11736,9321,215
Plumas,5,2022-01-16,197,197,113,84,808,810,460,350,4
Riverside,5,2022-01-16,44665,44795,25981,18814,180568,181094,105032,76062,1023
Sacramento,5,2022-01-16,23305,23373,14878,8495,110828,111151,70666,40485,547
San Benito,5,2022-01-16,880,881,604,277,4230,4243,2902,1341,8
San Bernardino,5,2022-01-16,41240,41360,29057,12303,179947,180473,126827,53646,1126
San Diego,5,2022-01-16,66371,66563,56553,10010,284464,285294,242456,42838,1256
San Francisco,5,2022-01-16,11610,11643,6311,5332,99441,99732,53895,45837,249
San Joaquin,5,2022-01-16,13885,13927,8527,5400,63460,63644,38949,24695,249
San Luis Obispo,5,2022-01-16,4089,4100,2747,1353,22502,22567,15106,7461,46
San Mateo,5,2022-01-16,13455,13495,9839,3656,105629,105936,77118,28818,117
Santa Barbara,5,2022-01-16,7506,7529,4791,2738,44207,44335,28184,16151,128
Santa Clara,5,2022-01-16,30741,30832,26092,4740,250131,250860,212165,38695,515
Santa Cruz,5,2022-01-16,4300,4311,2998,1313,46033,46166,32029,14137,31
Shasta,5,2022-01-16,1316,1321,766,555,9662,9690,5575,4115,76
Siskiyou,5,2022-01-16,160,160,109,51,1026,1029,698,331,5
Solano,5,2022-01-16,6890,6910,4453,2457,37887,37998,24457,13541,124
Sonoma,5,2022-01-16,8214,8238,5275,2963,47041,47178,30148,17030,88
Stanislaus,5,2022-01-16,7597,7620,4048,3572,30686,30776,16290,14486,231
Sutter,5,2022-01-16,1341,1346,828,518,5092,5106,3130,1976,0
Tehama,5,2022-01-16,652,652,329,323,2619,2626,1313,1313,17
Trinity,5,2022-01-16,40,40,22,18,268,268,147,121,0
Tulare,5,2022-01-16,7628,7650,3970,3680,28090,28171,14559,13612,103
Tuolumne,5,2022-01-16,933,933,550,383,4354,4367,2553,1814,10
Ventura,5,2022-01-16,13469,13507,9927,3580,74948,75167,55188,19979,337
Yolo,5,2022-01-16,3024,3034,2085,949,42822,42946,29547,13399,17
Yuba,5,2022-01-16,1080,1083,691,392,3970,3981,2535,1446,44
Alameda,6,2022-01-23,20242,20306,15533,4773,160864,161369,123528,37841,442
Amador,6,2022-01-23,561,561,365,196,4356,4370,2843,1527,12
Butte,6,2022-01-23,1916,1921,1522,399,8702,8731,6915,1816,91
Calaveras,6,2022-01-23,592,592,406,186,2429,2435,1668,767,7
Colusa,6,2022-01-23,164,164,114,50,810,811,562,249,5
Contra Costa,6,2022-01-23,12926,12966,8731,4235,81005,81261,54719,26542,292
Del Norte,6,2022-01-23,320,320,228,92,3881,3893,2756,1137,5
El Dorado,6,2022-01-23,1517,1522,1027,495,7152,7175,4844,2331,19
Fresno,6,2022-01-23,17485,17539,11479,6060,67435,67647,44300,23347,568
Glenn,6,2022-01-23,252,252,177,75,921,923,645,278,0
Humboldt,6,2022-01-23,945,948,663,285,7220,7242,5064,2178,27
Imperial,6,2022-01-23,3586,3598,2432,1166,12966,13007,8786,4221,92
Inyo,6,2022-01-23,152,152,113,39,615,615,455,160,1
Kern,6,2022-01-23,10485,10518,7358,3160,50386,50544,35321,15223,309
Kings,6,2022-01-23,4039,4052,2670,1382,16899,16953,11177,5776,43
Lake,6,2022-01-23,679,679,435,244,3151,3160,2009,1151,8
Lassen,6,2022-01-23,423,423,311,112,3659,3670,2699,971,1
Los Angeles,6,2022-01-23,167743,168268,150893,17375,1520248,1525014,1367952,157062,4573
Madera,6,2022-01-23,2729,2737,1799,938,11567,11605,7612,3993,57
Marin,6,2022-01-23,1897,1903,1301,602,16861,16913,11559,5354,53
Mariposa,6,2022-01-23,146,146,95,51,935,937,612,325,0
Mendocino,6,2022-01-23,940,943,541,402,4765,4780,2741,2039,23
Merced,6,2022-01-23,3162,3172,2186,986,12368,12407,8555,3852,63
Modoc,6,2022-01-23,15,15,11,4,104,104,73,31,2
Mono,6,2022-01-23,93,93,56,37,441,441,265,176,1
Monterey,6,2022-01-23,5018,5033,2771,2262,30660,30758,16937,13821,91
Napa,6,2022-01-23,1678,1683,1186,497,11833,11872,8362,3510,22
Nevada,6,2022-01-23,1055,1058,679,379,4761,4776,3052,1724,30
Orange,6,2022-01-23,28985,29076,20524,8552,223982,224685,158740,65945,1162
Placer,6,2022-01-23,3800,3812,2404,1408,18230,18286,11512,6774,253
Plumas,6,2022-01-23,214,214,137,77,878,880,559,321,6
Riverside,6,2022-01-23,32983,33087,21511,11576,155217,155703,101287,54416,1065
Sacramento,6,2022-01-23,17833,17889,12565,5324,94621,94917,66659,28258,623
San Benito,6,2022-01-23,813,814,606,208,3913,3925,2922,1003,8
San Bernardino,6,2022-01-23,27721,27809,21168,6641,145994,146453,111512,34941,1182
San Diego,6,2022-01-23,52582,52748,46615,6133,243885,244651,216321,28330,1297
San Francisco,6,2022-01-23,8549,8576,5249,3327,85863,86134,52744,33390,278
San Joaquin,6,2022-01-23,11128,11162,7589,3573,55739,55913,38004,17909,297
San Luis Obispo,6,2022-01-23,3524,3535,2584,951,20626,20690,15134,5556,52
San Mateo,6,2022-01-23,8919,8947,7005,1942,89940,90224,70680,19544,153
Santa Barbara,6,2022-01-23,6391,6411,4502,1909,41075,41205,28926,12279,139
Santa Clara,6,2022-01-23,22820,22892,20175,2717,218269,218955,192940,26015,552
Santa Cruz,6,2022-01-23,5140,5156,3896,1260,46335,46482,35156,11326,39
Shasta,6,2022-01-23,1456,1461,946,515,9455,9484,6122,3362,75
Siskiyou,6,2022-01-23,162,162,120,42,832,834,616,218,6
Solano,6,2022-01-23,4983,4999,3542,1457,30790,30888,21879,9009,166
Sonoma,6,2022-01-23,7059,7080,4998,2082,40956,41084,28977,12107,106
Stanislaus,6,2022-01-23,6559,6579,3968,2611,27608,27695,16683,11012,309
Sutter,6,2022-01-23,1087,1092,745,347,4970,4986,3396,1590,0
Tehama,6,2022-01-23,564,564,325,239,2421,2427,1394,1033,19
Trinity,6,2022-01-23,65,65,40,25,316,316,196,120,0
Tulare,6,2022-01-23,7777,7801,4607,3194,28260,28348,16719,11629,133
Tuolumne,6,2022-01-23,858,859,565,294,3501,3513,2301,1212,19
Ventura,6,2022-01-23,9810,9841,7772,2069,64811,65014,51339,13675,344
Yolo,6,2022-01-23,2314,2322,1736,586,38576,38697,28976,9721,21
Yuba,6,2022-01-23,967,971,683,288,3745,3758,2641,1117,63
Alameda,7,2022-01-30,12118,12160,9884,2276,141028,141515,114997,26518,416
Amador,7,2022-01-30,354,354,253,101,3284,3296,2352,944,16
Butte,7,2022-01-30,1244,1249,1044,205,7757,7783,6499,1284,94
Calaveras,7,2022-01-30,271,271,202,69,1921,1926,1432,494,3
Colusa,7,2022-01-30,107,107,80,27,678,680,510,170,8
Contra Costa,7,2022-01-30,7829,7856,5752,2104,71018,71263,52213,19050,274
Del Norte,7,2022-01-30,339,339,259,80,4185,4199,3209,990,8
El Dorado,7,2022-01-30,813,815,599,216,6139,6159,4528,1631,16
Fresno,7,2022-01-30,11727,11768,8433,3335,57713,57912,41498,16414,587
Glenn,7,2022-01-30,209,209,158,51,771,772,584,188,2
Humboldt,7,2022-01-30,594,594,450,144,6104,6126,4626,1500,25
Imperial,7,2022-01-30,2466,2474,1816,658,12113,12155,8932,3223,102
Inyo,7,2022-01-30,64,64,51,13,503,504,398,106,4
Kern,7,2022-01-30,6139,6158,4654,1504,43360,43511,32863,10648,307
Kings,7,2022-01-30,2684,2692,1936,756,14803,14854,10679,4175,53
Lake,7,2022-01-30,559,560,392,168,3380,3391,2375,1016,8
Lassen,7,2022-01-30,332,332,262,70,3550,3562,2804,758,6
Los Angeles,7,2022-01-30,84839,85132,78354,6778,1326572,1331143,1225163,105980,3720
Madera,7,2022-01-30,1809,1814,1303,511,9667,9701,6957,2744,55
Marin,7,2022-01-30,1163,1168,866,302,14183,14232,10561,3671,39
Mariposa,7,2022-01-30,104,104,75,29,876,879,630,249,0
Mendocino,7,2022-01-30,515,515,330,185,3549,3561,2285,1276,16
Merced,7,2022-01-30,2249,2256,1685,571,10855,10891,8140,2751,54
Modoc,7,2022-01-30,11,11,8,3,99,99,75,24,2
Mono,7,2022-01-30,43,43,29,14,340,340,227,113,0
Monterey,7,2022-01-30,3810,3824,2368,1456,26630,26721,16565,10156,95
Napa,7,2022-01-30,1088,1093,832,261,9675,9709,7379,2330,22
Nevada,7,2022-01-30,643,644,453,191,4117,4132,2901,1231,33
Orange,7,2022-01-30,13449,13496,10290,3206,182538,183166,139595,43571,934
Placer,7,2022-01-30,2504,2513,1747,766,15900,15954,11079,4875,203
Plumas,7,2022-01-30,147,147,103,44,748,749,524,225,2
Riverside,7,2022-01-30,18313,18376,13080,5296,125585,126018,89840,36178,911
Sacramento,7,2022-01-30,11357,11397,8646,2751,80713,80991,61447,19544,595
San Benito,7,2022-01-30,526,526,419,107,3329,3340,2657,683,7
San Bernardino,7,2022-01-30,14810,14862,12025,2837,120843,121261,98184,23077,953
San Diego,7,2022-01-30,28090,28187,25648,2539,189485,190139,173081,17058,1180
San Francisco,7,2022-01-30,4564,4580,3099,1481,73549,73804,50018,23786,258
San Joaquin,7,2022-01-30,6298,6319,4668,1651,44997,45151,33342,11809,290
San Luis Obispo,7,2022-01-30,2276,2283,1788,495,17276,17334,13586,3748,53
San Mateo,7,2022-01-30,4854,4870,4032,838,78202,78472,64958,13514,151
Santa Barbara,7,2022-01-30,4086,4101,3104,997,35726,35850,27164,8686,108
Santa Clara,7,2022-01-30,15071,15122,13733,1389,207209,207925,188836,19089,523
Santa Cruz,7,2022-01-30,3511,3523,2829,694,46776,46937,37745,9192,43
Shasta,7,2022-01-30,1045,1049,743,306,8724,8754,6199,2555,72
Siskiyou,7,2022-01-30,117,117,93,24,674,676,535,141,13
Solano,7,2022-01-30,4074,4088,3129,959,29815,29919,22876,7043,157
Sonoma,7,2022-01-30,4008,4022,3059,963,33104,33218,25266,7952,94
Stanislaus,7,2022-01-30,3890,3904,2613,1291,22530,22608,15129,7479,317
Sutter,7,2022-01-30,683,684,507,177,3880,3894,2881,1013,0
Tehama,7,2022-01-30,405,405,261,144,2147,2153,1382,771,22
Trinity,7,2022-01-30,40,40,27,13,216,216,147,69,0
Tulare,7,2022-01-30,5232,5250,3454,1796,24379,24464,16077,8387,158
Tuolumne,7,2022-01-30,785,788,563,225,3400,3412,2441,971,18
Ventura,7,2022-01-30,5209,5227,4357,870,54435,54622,45502,9120,307
Yolo,7,2022-01-30,1512,1517,1210,307,37788,37919,30319,7600,22
Yuba,7,2022-01-30,562,562,427,135,3012,3023,2295,728,79
Alameda,8,2022-02-06,6565,6591,5625,966,119961,120433,102767,17666,340
Amador,8,2022-02-06,226,226,173,53,2990,3001,2304,697,16
Butte,8,2022-02-06,834,837,730,107,6461,6487,5653,834,83
Calaveras,8,2022-02-06,209,209,166,43,1555,1561,1240,321,3
Colusa,8,2022-02-06,90,90,72,18,560,562,449,113,3
Contra Costa,8,2022-02-06,4258,4274,3361,913,56345,56568,44461,12107,220
Del Norte,8,2022-02-06,262,262,214,48,4041,4058,3303,755,6
El Dorado,8,2022-02-06,489,489,386,103,5128,5148,4056,1092,29
Fresno,8,2022-02-06,6987,7015,5417,1598,45501,45681,35285,10396,524
Glenn,8,2022-02-06,133,133,107,26,632,633,510,123,2
Humboldt,8,2022-02-06,492,492,397,95,5008,5028,4050,978,15
Imperial,8,2022-02-06,1228,1233,971,262,8804,8839,6966,1873,79
Inyo,8,2022-02-06,53,53,44,9,452,452,377,75,6
Kern,8,2022-02-06,3783,3798,3061,737,35781,35921,28924,6997,231
Kings,8,2022-02-06,1475,1480,1146,334,10642,10684,8273,2411,53
Lake,8,2022-02-06,371,371,282,89,2741,2753,2088,665,12
Lassen,8,2022-02-06,149,149,124,25,2963,2975,2471,504,5
Los Angeles,8,2022-02-06,42038,42203,39650,2553,1174722,1179332,1107907,71425,2773
Madera,8,2022-02-06,1178,1183,915,268,8434,8467,6547,1920,48
Marin,8,2022-02-06,700,701,557,144,11795,11841,9399,2442,34
Mariposa,8,2022-02-06,55,55,42,13,621,623,480,143,0
Mendocino,8,2022-02-06,357,357,253,104,2933,2943,2077,866,15
Merced,8,2022-02-06,1324,1329,1062,267,8372,8404,6713,1691,64
Modoc,8,2022-02-06,23,23,19,4,160,160,130,30,3
Mono,8,2022-02-06,45,45,33,12,268,268,195,73,0
Monterey,8,2022-02-06,2444,2454,1684,770,22866,22957,15741,7216,87
Napa,8,2022-02-06,789,792,642,150,8011,8042,6508,1534,13
Nevada,8,2022-02-06,383,383,292,91,3261,3274,2489,785,25
Orange,8,2022-02-06,7082,7110,5773,1337,154891,155499,126162,29337,620
Placer,8,2022-02-06,1438,1444,1089,355,12533,12582,9472,3110,183
Plumas,8,2022-02-06,90,90,68,22,577,578,436,142,1
Riverside,8,2022-02-06,9055,9090,6993,2097,97888,98273,75569,22704,686
Sacramento,8,2022-02-06,6676,6703,5425,1278,65568,65825,53224,12601,495
San Benito,8,2022-02-06,320,320,269,51,2759,2770,2323,447,8
San Bernardino,8,2022-02-06,7713,7743,6589,1154,93383,93750,79768,13982,697
San Diego,8,2022-02-06,15289,15350,14300,1050,156651,157268,146535,10733,959
San Francisco,8,2022-02-06,2581,2591,1916,675,56668,56892,42042,14850,214
San Joaquin,8,2022-02-06,3752,3767,2983,784,38045,38195,30242,7953,252
San Luis Obispo,8,2022-02-06,1378,1384,1148,236,13324,13376,11102,2274,36
San Mateo,8,2022-02-06,2692,2702,2341,361,63511,63761,55205,8556,117
Santa Barbara,8,2022-02-06,2642,2653,2143,510,33150,33279,26873,6406,98
Santa Clara,8,2022-02-06,8790,8825,8208,617,176890,177586,165111,12475,445
Santa Cruz,8,2022-02-06,2046,2053,1735,318,39161,39314,33183,6131,32
Shasta,8,2022-02-06,716,718,551,167,7095,7121,5446,1675,75
Siskiyou,8,2022-02-06,100,100,84,16,708,711,593,118,8
Solano,8,2022-02-06,2453,2462,1998,464,24369,24465,19877,4588,124
Sonoma,8,2022-02-06,2260,2269,1841,428,27705,27815,22533,5282,70
Stanislaus,8,2022-02-06,2752,2763,2020,743,19539,19616,14327,5289,272
Sutter,8,2022-02-06,409,409,324,85,3460,3474,2752,722,0
Tehama,8,2022-02-06,313,313,221,92,1709,1716,1210,506,23
Trinity,8,2022-02-06,23,23,17,6,149,149,110,39,0
Tulare,8,2022-02-06,3040,3053,2201,852,18523,18596,13393,5203,153
Tuolumne,8,2022-02-06,406,406,313,93,2671,2682,2069,613,12
Ventura,8,2022-02-06,2899,2911,2536,375,42890,43059,37463,5596,248
Yolo,8,2022-02-06,896,899,757,142,31957,32083,27017,5066,15
Yuba,8,2022-02-06,377,377,305,72,2477,2488,2012,476,63
Alameda,9,2022-02-13,3811,3827,3394,433,102226,102667,91011,11656,244
Amador,9,2022-02-13,109,109,89,20,2443,2453,2003,450,11
Butte,9,2022-02-13,515,516,465,51,5517,5540,4991,549,74
Calaveras,9,2022-02-13,101,101,85,16,1301,1306,1095,211,6
Colusa,9,2022-02-13,43,43,36,7,515,517,435,82,4
Contra Costa,9,2022-02-13,2621,2634,2191,443,46098,46296,38494,7802,166
Del Norte,9,2022-02-13,233,233,199,34,3523,3539,3020,519,9
El Dorado,9,2022-02-13,289,289,241,48,4634,4654,3876,778,25
Fresno,9,2022-02-13,4143,4162,3415,747,36649,36807,30186,6621,446
Glenn,9,2022-02-13,59,59,50,9,470,471,399,72,4
Humboldt,9,2022-02-13,372,372,316,56,4447,4465,3784,681,19
Imperial,9,2022-02-13,681,683,569,114,6586,6614,5511,1103,66
Inyo,9,2022-02-13,27,27,24,3,406,407,354,53,3
Kern,9,2022-02-13,2316,2326,1972,354,29976,30106,25508,4598,198
Kings,9,2022-02-13,871,874,718,156,8401,8437,6930,1507,49
Lake,9,2022-02-13,262,262,212,50,2406,2417,1952,465,11
Lassen,9,2022-02-13,152,152,133,19,3127,3139,2724,415,3
Los Angeles,9,2022-02-13,23897,24000,22905,1095,1076971,1081590,1031999,49591,2054
Madera,9,2022-02-13,688,690,566,124,6941,6971,5720,1251,44
Marin,9,2022-02-13,413,413,346,67,10310,10355,8679,1676,30
Mariposa,9,2022-02-13,27,27,22,5,435,435,356,79,0
Mendocino,9,2022-02-13,222,222,170,52,2485,2496,1904,592,18
Merced,9,2022-02-13,813,817,689,128,7243,7273,6124,1149,47
Modoc,9,2022-02-13,20,20,17,3,184,184,156,28,0
Mono,9,2022-02-13,13,13,10,3,183,183,143,40,0
Monterey,9,2022-02-13,1385,1392,1038,354,18541,18619,13862,4757,82
Napa,9,2022-02-13,447,447,380,67,6780,6809,5790,1019,17
Nevada,9,2022-02-13,197,197,160,37,2705,2718,2199,519,20
Orange,9,2022-02-13,4323,4342,3706,636,135694,136276,116076,20200,453
Placer,9,2022-02-13,694,696,560,136,10379,10423,8373,2050,134
Plumas,9,2022-02-13,49,49,39,10,443,444,357,87,3
Riverside,9,2022-02-13,5164,5187,4243,944,78585,78925,64492,14433,490
Sacramento,9,2022-02-13,3784,3800,3232,568,55508,55747,47390,8357,412
San Benito,9,2022-02-13,179,179,156,23,2266,2276,1991,285,6
San Bernardino,9,2022-02-13,4157,4174,3692,482,76455,76783,67914,8869,499
San Diego,9,2022-02-13,9195,9234,8756,478,130859,131424,124623,6801,728
San Francisco,9,2022-02-13,1736,1744,1380,364,48765,48974,38761,10213,167
San Joaquin,9,2022-02-13,2237,2247,1881,366,32164,32302,27006,5296,184
San Luis Obispo,9,2022-02-13,877,881,764,117,10596,10642,9235,1407,29
San Mateo,9,2022-02-13,1467,1473,1321,152,56324,56566,50711,5855,77
Santa Barbara,9,2022-02-13,1208,1213,1031,182,23301,23401,19891,3510,77
Santa Clara,9,2022-02-13,5090,5113,4842,271,157740,158419,149969,8450,362
Santa Cruz,9,2022-02-13,1137,1142,1004,138,34425,34573,30383,4190,26
Shasta,9,2022-02-13,495,496,404,92,6145,6171,5019,1152,73
Siskiyou,9,2022-02-13,79,79,69,10,581,582,506,76,5
Solano,9,2022-02-13,1335,1341,1144,197,20174,20260,17283,2977,94
Sonoma,9,2022-02-13,1311,1316,1121,195,23110,23209,19748,3461,65
Stanislaus,9,2022-02-13,1565,1572,1234,338,16030,16100,12625,3475,257
Sutter,9,2022-02-13,234,234,196,38,2958,2972,2487,485,0
Tehama,9,2022-02-13,192,192,147,45,1445,1451,1108,343,19
Trinity,9,2022-02-13,20,20,16,4,172,172,137,35,0
Tulare,9,2022-02-13,1716,1724,1338,386,16173,16243,12608,3635,142
Tuolumne,9,2022-02-13,213,213,175,38,2318,2327,1907,420,12
Ventura,9,2022-02-13,1693,1701,1532,169,37937,38100,34279,3821,173
Yolo,9,2022-02-13,556,557,488,69,28585,28709,25196,3513,16
Yuba,9,2022-02-13,232,232,197,35,2191,2201,1871,330,36
Alameda,10,2022-02-20,2204,2215,2023,192,89574,90008,82158,7850,181
Amador,10,2022-02-20,89,89,76,13,2141,2150,1842,308,9
Butte,10,2022-02-20,305,305,282,23,4647,4669,4317,352,69
Calaveras,10,2022-02-20,49,49,43,6,937,942,824,118,5
Colusa,10,2022-02-20,26,26,23,3,376,377,331,46,4
Contra Costa,10,2022-02-20,1546,1553,1349,204,39379,39569,34364,5205,106
Del Norte,10,2022-02-20,144,144,128,16,2959,2973,2634,339,10
El Dorado,10,2022-02-20,169,169,147,22,4015,4035,3512,523,9
Fresno,10,2022-02-20,2368,2380,2046,334,30032,30178,25942,4236,337
Glenn,10,2022-02-20,36,36,32,4,419,420,370,50,2
Humboldt,10,2022-02-20,229,229,202,27,3740,3759,3315,444,19
Imperial,10,2022-02-20,427,427,372,55,5289,5315,4631,684,43
Inyo,10,2022-02-20,12,12,11,1,372,373,336,37,1
Kern,10,2022-02-20,1395,1403,1239,164,25793,25918,22871,3047,120
Kings,10,2022-02-20,554,556,480,76,7338,7373,6356,1017,35
Lake,10,2022-02-20,212,212,180,32,2207,2217,1885,332,8
Lassen,10,2022-02-20,132,132,119,13,2327,2338,2101,237,4
Los Angeles,10,2022-02-20,13751,13817,13343,474,985328,990098,955915,34183,1310
Madera,10,2022-02-20,404,405,348,57,5830,5859,5037,822,36
Marin,10,2022-02-20,252,252,220,32,9917,9965,8712,1253,17
Mariposa,10,2022-02-20,23,23,20,3,403,403,346,57,0
Mendocino,10,2022-02-20,135,135,110,25,2230,2241,1821,420,12
Merced,10,2022-02-20,548,549,482,67,5930,5958,5229,729,39
Modoc,10,2022-02-20,10,10,9,1,73,73,64,9,1
Mono,10,2022-02-20,9,9,7,2,174,174,144,30,0
Monterey,10,2022-02-20,930,935,747,188,15157,15231,12152,3079,60
Napa,10,2022-02-20,285,285,252,33,5765,5793,5124,669,9
Nevada,10,2022-02-20,125,125,106,19,2380,2393,2036,357,20
Orange,10,2022-02-20,2773,2786,2470,316,126337,126949,112390,14559,334
Placer,10,2022-02-20,367,367,311,56,9399,9443,7991,1452,112
Plumas,10,2022-02-20,25,25,21,4,386,387,327,60,1
Riverside,10,2022-02-20,2788,2802,2403,399,66845,67169,57603,9566,321
Sacramento,10,2022-02-20,2289,2300,2034,266,48499,48734,43083,5651,308
San Benito,10,2022-02-20,135,135,122,13,2037,2047,1850,197,1
San Bernardino,10,2022-02-20,2236,2246,2048,198,66057,66376,60519,5857,343
San Diego,10,2022-02-20,5341,5368,5159,209,110450,110985,106647,4338,576
San Francisco,10,2022-02-20,1098,1103,922,181,44503,44720,37377,7343,133
San Joaquin,10,2022-02-20,1242,1247,1089,158,27236,27368,23881,3487,123
San Luis Obispo,10,2022-02-20,561,564,506,58,9106,9151,8219,932,23
San Mateo,10,2022-02-20,843,847,780,67,48877,49115,45215,3900,57
Santa Barbara,10,2022-02-20,735,739,653,86,21494,21597,19079,2518,52
Santa Clara,10,2022-02-20,2854,2868,2753,115,138218,138886,133281,5605,285
Santa Cruz,10,2022-02-20,666,669,607,62,28094,28229,25614,2615,23
Shasta,10,2022-02-20,309,309,264,45,5363,5390,4603,787,67
Siskiyou,10,2022-02-20,48,48,43,5,532,533,480,53,11
Solano,10,2022-02-20,775,779,691,88,16643,16724,14829,1895,67
Sonoma,10,2022-02-20,726,730,646,84,18882,18974,16788,2186,44
Stanislaus,10,2022-02-20,860,865,718,147,13241,13306,11044,2262,187
Sutter,10,2022-02-20,149,149,130,19,2395,2408,2102,306,0
Tehama,10,2022-02-20,112,112,91,21,1254,1259,1023,236,11
Trinity,10,2022-02-20,17,17,14,3,217,217,182,35,0
Tulare,10,2022-02-20,914,919,756,163,12323,12384,10188,2196,102
Tuolumne,10,2022-02-20,113,113,97,16,1937,1945,1670,275,6
Ventura,10,2022-02-20,987,992,917,75,30779,30928,28562,2366,127
Yolo,10,2022-02-20,324,324,294,30,23527,23642,21421,2221,10
Yuba,10,2022-02-20,152,152,134,18,1771,1780,1574,206,31
Alameda,11,2022-02-27,1423,1430,1337,93,69293,69657,65100,4557,139
Amador,11,2022-02-27,63,63,56,7,1970,1980,1764,216,9
Butte,11,2022-02-27,180,180,170,10,3965,3986,3759,227,44
Calaveras,11,2022-02-27,36,36,33,3,1074,1078,976,102,0
Colusa,11,2022-02-27,10,10,9,1,365,366,332,34,4
Contra Costa,11,2022-02-27,936,941,847,94,31706,31871,28683,3188,83
Del Norte,11,2022-02-27,83,83,76,7,2641,2656,2424,232,7
El Dorado,11,2022-02-27,111,111,100,11,3343,3360,3028,332,7
Fresno,11,2022-02-27,1317,1324,1182,142,25076,25208,22494,2714,249
Glenn,11,2022-02-27,19,19,17,2,363,364,331,33,0
Humboldt,11,2022-02-27,147,147,134,13,2765,2780,2530,250,8
Imperial,11,2022-02-27,280,280,252,28,4545,4568,4116,452,23
Inyo,11,2022-02-27,10,10,9,1,329,330,305,25,0
Kern,11,2022-02-27,833,838,763,75,22389,22506,20483,2023,99
Kings,11,2022-02-27,247,247,221,26,5775,5804,5187,617,26
Lake,11,2022-02-27,124,124,110,14,1816,1824,1614,210,4
Lassen,11,2022-02-27,48,48,44,4,1911,1921,1771,150,1
Los Angeles,11,2022-02-27,8288,8331,8118,213,924772,929624,905845,23779,916
Madera,11,2022-02-27,197,197,176,21,4217,4240,3787,453,27
Marin,11,2022-02-27,138,138,125,13,7123,7160,6473,687,12
Mariposa,11,2022-02-27,32,32,29,3,324,324,289,35,0
Mendocino,11,2022-02-27,73,73,62,11,1723,1732,1480,252,16
Merced,11,2022-02-27,257,257,233,24,4678,4701,4262,439,28
Modoc,11,2022-02-27,6,6,5,1,49,49,45,4,1
Mono,11,2022-02-27,4,4,3,1,162,162,140,22,0
Monterey,11,2022-02-27,357,357,301,56,12481,12546,10568,1978,33
Napa,11,2022-02-27,178,178,163,15,5004,5030,4590,440,10
Nevada,11,2022-02-27,74,74,66,8,1954,1965,1741,224,12
Orange,11,2022-02-27,1765,1775,1621,154,114338,114938,104972,9966,230
Placer,11,2022-02-27,243,243,214,29,7803,7843,6912,931,85
Plumas,11,2022-02-27,25,25,22,3,337,337,297,40,0
Riverside,11,2022-02-27,1728,1737,1547,190,59184,59495,52982,6513,243
Sacramento,11,2022-02-27,1158,1165,1063,102,41116,41331,37686,3645,216
San Benito,11,2022-02-27,51,51,47,4,1571,1579,1465,114,1
San Bernardino,11,2022-02-27,1200,1206,1126,80,56088,56383,52619,3764,215
San Diego,11,2022-02-27,3265,3282,3186,96,93672,94162,91419,2743,435
San Francisco,11,2022-02-27,849,854,746,108,36840,37033,32346,4687,96
San Joaquin,11,2022-02-27,692,696,629,67,23573,23695,21390,2305,83
San Luis Obispo,11,2022-02-27,320,320,295,25,7655,7696,7104,592,15
San Mateo,11,2022-02-27,560,561,528,33,35354,35539,33423,2116,46
Santa Barbara,11,2022-02-27,374,374,341,33,19527,19630,17891,1739,42
Santa Clara,11,2022-02-27,1724,1732,1681,51,84581,85026,82492,2534,246
Santa Cruz,11,2022-02-27,464,465,432,33,23794,23918,22248,1670,19
Shasta,11,2022-02-27,167,167,148,19,4632,4657,4134,523,50
Siskiyou,11,2022-02-27,27,27,25,2,403,404,373,31,5
Solano,11,2022-02-27,476,476,435,41,14230,14304,13072,1232,62
Sonoma,11,2022-02-27,449,450,411,39,14995,15073,13755,1318,32
Stanislaus,11,2022-02-27,481,482,419,63,12095,12159,10561,1598,141
Sutter,11,2022-02-27,105,105,95,10,2199,2211,1997,214,0
Tehama,11,2022-02-27,57,57,49,8,1118,1123,959,164,9
Trinity,11,2022-02-27,5,5,4,1,107,107,93,14,0
Tulare,11,2022-02-27,493,495,427,68,11037,11095,9572,1523,77
Tuolumne,11,2022-02-27,76,76,68,8,1429,1434,1279,155,8
Ventura,11,2022-02-27,573,574,541,33,27212,27355,25779,1576,89
Yolo,11,2022-02-27,204,204,189,15,22956,23078,21445,1633,10
Yuba,11,2022-02-27,81,81,74,7,1700,1708,1556,152,20
Alameda,12,2022-03-06,1168,1176,1117,59,73112,73549,69857,3692,102
Amador,12,2022-03-06,75,75,69,6,1433,1442,1320,122,6
Butte,12,2022-03-06,127,127,121,6,3650,3673,3515,158,36
Calaveras,12,2022-03-06,31,31,29,2,1126,1132,1049,83,1
Colusa,12,2022-03-06,10,10,9,1,344,345,320,25,6
Contra Costa,12,2022-03-06,641,645,596,49,31584,31772,29322,2450,61
Del Norte,12,2022-03-06,52,52,49,3,1872,1883,1758,125,5
El Dorado,12,2022-03-06,87,87,80,7,3235,3255,3006,249,8
Fresno,12,2022-03-06,917,922,846,76,22752,22890,20993,1897,168
Glenn,12,2022-03-06,11,11,10,1,366,367,341,26,2
Humboldt,12,2022-03-06,92,92,86,6,3082,3099,2886,213,10
Imperial,12,2022-03-06,155,155,143,12,4538,4565,4219,346,19
Inyo,12,2022-03-06,9,9,8,1,364,366,345,21,0
Kern,12,2022-03-06,498,500,466,34,21393,21520,20033,1487,79
Kings,12,2022-03-06,159,159,146,13,5029,5059,4644,415,15
Lake,12,2022-03-06,71,71,65,6,1791,1802,1641,161,4
Lassen,12,2022-03-06,91,91,86,5,1906,1918,1804,114,0
Los Angeles,12,2022-03-06,5916,5951,5836,115,885022,890287,873001,17286,731
Madera,12,2022-03-06,131,131,120,11,4034,4058,3723,335,13
Marin,12,2022-03-06,166,166,154,12,7592,7638,7073,565,12
Mariposa,12,2022-03-06,13,13,12,1,301,301,276,25,0
Mendocino,12,2022-03-06,72,72,64,8,1745,1757,1558,199,8
Merced,12,2022-03-06,189,189,175,14,4655,4683,4347,336,25
Modoc,12,2022-03-06,1,1,1,0,52,52,48,4,0
Mono,12,2022-03-06,3,3,3,0,135,135,121,14,1
Monterey,12,2022-03-06,256,256,224,32,11384,11451,10033,1418,25
Napa,12,2022-03-06,203,203,190,13,4957,4986,4649,337,6
Nevada,12,2022-03-06,47,47,43,4,1737,1747,1593,154,4
Orange,12,2022-03-06,1351,1358,1269,89,108958,109606,102292,7314,179
Placer,12,2022-03-06,171,171,155,16,7817,7864,7143,721,69
Plumas,12,2022-03-06,5,5,5,0,273,273,248,25,0
Riverside,12,2022-03-06,1067,1074,984,90,54655,54981,50343,4638,172
Sacramento,12,2022-03-06,815,820,765,55,39924,40162,37441,2721,160
San Benito,12,2022-03-06,35,35,33,2,1511,1520,1435,85,1
San Bernardino,12,2022-03-06,871,877,832,45,53599,53918,51170,2748,133
San Diego,12,2022-03-06,2478,2493,2439,54,96344,96920,94788,2132,308
San Francisco,12,2022-03-06,675,679,613,66,38115,38343,34578,3765,67
San Joaquin,12,2022-03-06,464,465,431,34,21568,21696,20076,1620,58
San Luis Obispo,12,2022-03-06,296,297,279,18,7434,7479,7038,441,8
San Mateo,12,2022-03-06,568,571,545,26,41536,41783,39873,1910,36
Santa Barbara,12,2022-03-06,204,204,190,14,18116,18223,16983,1240,27
Santa Clara,12,2022-03-06,1480,1489,1456,33,114967,115650,113017,2633,183
Santa Cruz,12,2022-03-06,341,341,323,18,24962,25112,23763,1349,18
Shasta,12,2022-03-06,149,149,136,13,4957,4986,4556,430,37
Siskiyou,12,2022-03-06,20,20,19,1,413,414,390,24,2
Solano,12,2022-03-06,369,369,345,24,14019,14102,13168,934,55
Sonoma,12,2022-03-06,362,362,338,24,15357,15449,14409,1040,33
Stanislaus,12,2022-03-06,302,302,271,31,11042,11108,9974,1134,112
Sutter,12,2022-03-06,85,85,79,6,1981,1994,1845,149,0
Tehama,12,2022-03-06,46,46,41,5,1185,1191,1056,135,4
Trinity,12,2022-03-06,5,5,5,0,114,114,103,11,0
Tulare,12,2022-03-06,320,320,286,34,10269,10329,9230,1099,44
Tuolumne,12,2022-03-06,56,56,51,5,1262,1268,1162,106,3
Ventura,12,2022-03-06,424,424,406,18,27135,27298,26101,1197,54
Yolo,12,2022-03-06,162,162,153,9,22262,22395,21175,1220,6
Yuba,12,2022-03-06,65,65,61,4,1584,1594,1486,108,23
Alameda,13,2022-03-13,914,919,884,35,68435,68916,66307,2609,77
Amador,13,2022-03-13,33,33,31,2,1434,1446,1353,93,4
Butte,13,2022-03-13,69,69,67,2,3412,3436,3324,112,23
Calaveras,13,2022-03-13,14,14,13,1,1035,1042,984,58,2
Colusa,13,2022-03-13,6,6,6,0,250,250,236,14,2
Contra Costa,13,2022-03-13,570,575,542,33,29025,29230,27521,1709,29
Del Norte,13,2022-03-13,42,42,40,2,1445,1455,1381,74,4
El Dorado,13,2022-03-13,51,51,48,3,3041,3062,2885,177,6
Fresno,13,2022-03-13,584,589,552,37,21723,21877,20500,1377,139
Glenn,13,2022-03-13,16,16,15,1,317,318,301,17,1
Humboldt,13,2022-03-13,60,60,57,3,2744,2764,2620,144,7
Imperial,13,2022-03-13,82,82,77,5,4632,4665,4395,270,13
Inyo,13,2022-03-13,9,9,9,0,170,170,163,7,0
Kern,13,2022-03-13,301,301,285,16,20035,20176,19123,1053,56
Kings,13,2022-03-13,217,217,203,14,4870,4904,4600,304,17
Lake,13,2022-03-13,60,60,56,4,1609,1619,1509,110,0
Lassen,13,2022-03-13,17,17,16,1,1482,1493,1426,67,0
Los Angeles,13,2022-03-13,4294,4324,4262,62,846621,852574,840198,12376,500
Madera,13,2022-03-13,73,73,68,5,3699,3724,3490,234,14
Marin,13,2022-03-13,175,175,165,10,6634,6681,6307,374,6
Mariposa,13,2022-03-13,7,7,7,0,226,226,211,15,0
Mendocino,13,2022-03-13,42,42,38,4,1480,1492,1363,129,5
Merced,13,2022-03-13,139,139,131,8,4207,4237,4007,230,24
Modoc,13,2022-03-13,3,3,3,0,56,56,53,3,1
Mono,13,2022-03-13,2,2,2,0,103,103,95,8,0
Monterey,13,2022-03-13,169,169,153,16,10336,10409,9418,991,17
Napa,13,2022-03-13,140,140,133,7,4260,4287,4067,220,6
Nevada,13,2022-03-13,54,54,50,4,1607,1618,1510,108,3
Orange,13,2022-03-13,877,883,839,44,102767,103491,98272,5219,139
Placer,13,2022-03-13,153,153,142,11,7524,7578,7050,528,62
Plumas,13,2022-03-13,9,9,8,1,307,308,286,22,0
Riverside,13,2022-03-13,753,759,711,48,52852,53227,49828,3399,115
Sacramento,13,2022-03-13,601,607,576,31,37138,37400,35480,1920,134
San Benito,13,2022-03-13,28,28,27,1,1447,1456,1395,61,1
San Bernardino,13,2022-03-13,591,596,573,23,51201,51561,49578,1983,114
San Diego,13,2022-03-13,1936,1950,1918,32,96757,97440,95832,1608,218
San Francisco,13,2022-03-13,585,589,545,44,34801,35046,32422,2624,43
San Joaquin,13,2022-03-13,292,293,276,17,20332,20474,19316,1158,43
San Luis Obispo,13,2022-03-13,164,164,157,7,6976,7024,6710,314,7
San Mateo,13,2022-03-13,448,451,436,15,37303,37565,36276,1289,29
Santa Barbara,13,2022-03-13,197,197,187,10,17371,17494,16593,901,19
Santa Clara,13,2022-03-13,1110,1118,1099,19,100821,101530,99802,1728,130
Santa Cruz,13,2022-03-13,240,240,230,10,22969,23130,22192,938,12
Shasta,13,2022-03-13,105,105,98,7,4989,5025,4695,330,19
Siskiyou,13,2022-03-13,16,16,15,1,408,409,391,18,0
Solano,13,2022-03-13,241,241,229,12,12807,12897,12249,648,45
Sonoma,13,2022-03-13,229,229,218,11,13822,13918,13207,711,15
Stanislaus,13,2022-03-13,236,236,218,18,10163,10233,9435,798,101
Sutter,13,2022-03-13,50,50,47,3,1803,1816,1713,103,0
Tehama,13,2022-03-13,25,25,23,2,996,1002,915,87,1
Trinity,13,2022-03-13,3,3,3,0,97,97,90,7,0
Tulare,13,2022-03-13,205,205,188,17,9765,9834,9031,803,37
Tuolumne,13,2022-03-13,26,26,24,2,1249,1258,1178,80,1
Ventura,13,2022-03-13,335,335,324,11,25072,25248,24413,835,44
Yolo,13,2022-03-13,125,125,120,5,21614,21768,20873,895,2
Yuba,13,2022-03-13,36,36,34,2,1454,1464,1389,75,12
Alameda,14,2022-03-20,710,717,697,20,67329,67880,65947,1933,59
Amador,14,2022-03-20,28,28,27,1,1376,1387,1319,68,2
Butte,14,2022-03-20,89,89,87,2,3014,3039,2965,74,17
Calaveras,14,2022-03-20,14,14,13,1,657,662,634,28,0
Colusa,14,2022-03-20,3,3,3,0,241,242,232,10,1
Contra Costa,14,2022-03-20,457,461,441,20,27739,27966,26728,1238,35
Del Norte,14,2022-03-20,21,21,20,1,1286,1297,1248,49,1
El Dorado,14,2022-03-20,41,41,39,2,2809,2832,2708,124,2
Fresno,14,2022-03-20,351,353,336,17,19941,20105,19147,958,101
Glenn,14,2022-03-20,8,8,8,0,342,343,329,14,1
Humboldt,14,2022-03-20,37,37,36,1,2372,2392,2298,94,8
Imperial,14,2022-03-20,59,59,56,3,4055,4088,3910,178,9
Inyo,14,2022-03-20,1,1,1,0,152,152,147,5,0
Kern,14,2022-03-20,215,215,207,8,19535,19696,18920,776,44
Kings,14,2022-03-20,75,75,72,3,4453,4490,4279,211,6
Lake,14,2022-03-20,17,17,16,1,1440,1452,1377,75,0
Lassen,14,2022-03-20,9,9,9,0,1448,1460,1410,50,0
Los Angeles,14,2022-03-20,4023,4057,4014,43,825580,832334,823302,9032,404
Madera,14,2022-03-20,41,41,39,2,3412,3440,3277,163,11
Marin,14,2022-03-20,142,142,136,6,6295,6346,6077,269,4
Mariposa,14,2022-03-20,9,9,9,0,250,251,239,12,0
Mendocino,14,2022-03-20,28,28,26,2,1490,1504,1406,98,5
Merced,14,2022-03-20,98,98,94,4,3879,3911,3751,160,15
Modoc,14,2022-03-20,2,2,2,0,53,53,51,2,0
Mono,14,2022-03-20,2,2,2,0,132,132,124,8,1
Monterey,14,2022-03-20,155,155,144,11,10206,10290,9544,746,20
Napa,14,2022-03-20,58,58,56,2,3472,3500,3364,136,6
Nevada,14,2022-03-20,21,21,20,1,1517,1530,1452,78,2
Orange,14,2022-03-20,758,765,736,29,97659,98459,94714,3745,126
Placer,14,2022-03-20,116,116,110,6,6591,6645,6294,351,41
Plumas,14,2022-03-20,2,2,2,0,229,230,217,13,0
Riverside,14,2022-03-20,660,665,633,32,53275,53714,51111,2603,92
Sacramento,14,2022-03-20,471,476,458,18,32540,32806,31541,1265,105
San Benito,14,2022-03-20,24,24,23,1,1389,1401,1357,44,2
San Bernardino,14,2022-03-20,489,494,480,14,51055,51474,49986,1488,81
San Diego,14,2022-03-20,1510,1523,1504,19,87864,88584,87492,1092,192
San Francisco,14,2022-03-20,657,664,627,37,33526,33802,31883,1919,35
San Joaquin,14,2022-03-20,240,240,230,10,15420,15547,14886,661,30
San Luis Obispo,14,2022-03-20,111,111,107,4,6645,6699,6474,225,3
San Mateo,14,2022-03-20,382,385,375,10,34110,34390,33506,884,28
Santa Barbara,14,2022-03-20,176,176,169,7,15778,15907,15287,620,16
Santa Clara,14,2022-03-20,1042,1050,1037,13,94558,95332,94122,1210,126
Santa Cruz,14,2022-03-20,207,207,201,6,20497,20664,20032,632,10
Shasta,14,2022-03-20,48,48,46,2,4215,4250,4038,212,10
Siskiyou,14,2022-03-20,10,10,10,0,353,356,344,12,1
Solano,14,2022-03-20,190,190,183,7,11665,11761,11317,444,24
Sonoma,14,2022-03-20,226,226,218,8,13338,13446,12930,516,16
Stanislaus,14,2022-03-20,151,151,142,9,8459,8529,8026,503,66
Sutter,14,2022-03-20,32,32,31,1,1509,1522,1457,65,0
Tehama,14,2022-03-20,9,9,8,1,930,936,874,62,1
Trinity,14,2022-03-20,0,0,0,0,99,99,93,6,0
Tulare,14,2022-03-20,132,132,124,8,8487,8556,8027,529,28
Tuolumne,14,2022-03-20,17,17,16,1,1166,1175,1118,57,2
Ventura,14,2022-03-20,294,294,287,7,23827,24021,23425,596,31
Yolo,14,2022-03-20,99,99,96,3,22257,22441,21747,694,5
Yuba,14,2022-03-20,38,38,37,1,1309,1321,1270,51,8
Alameda,15,2022-03-27,869,877,859,18,59335,59905,58628,1277,43
Amador,15,2022-03-27,8,8,8,0,1364,1378,1327,51,3
Butte,15,2022-03-27,65,65,64,1,2685,2711,2661,50,16
Calaveras,15,2022-03-27,15,15,15,0,594,599,580,19,0
Colusa,15,2022-03-27,4,4,4,0,206,206,200,6,0
Contra Costa,15,2022-03-27,528,534,517,17,24978,25218,24381,837,36
Del Norte,15,2022-03-27,16,16,16,0,1036,1047,1017,30,0
El Dorado,15,2022-03-27,55,55,53,2,2834,2863,2769,94,1
Fresno,15,2022-03-27,304,305,294,11,18628,18808,18134,674,91
Glenn,15,2022-03-27,7,7,7,0,304,305,296,9,0
Humboldt,15,2022-03-27,25,25,24,1,2605,2630,2552,78,7
Imperial,15,2022-03-27,59,59,57,2,3708,3743,3620,123,8
Inyo,15,2022-03-27,3,3,3,0,179,179,175,4,0
Kern,15,2022-03-27,155,155,150,5,18357,18533,17984,549,25
Kings,15,2022-03-27,61,61,59,2,4325,4367,4213,154,6
Lake,15,2022-03-27,13,13,12,1,1157,1169,1124,45,0
Lassen,15,2022-03-27,6,6,6,0,1348,1361,1326,35,0
Los Angeles,15,2022-03-27,4425,4468,4433,35,784985,792516,786101,6415,329
Madera,15,2022-03-27,27,27,26,1,3392,3424,3302,122,5
Marin,15,2022-03-27,158,158,153,5,6007,6064,5871,193,3
Mariposa,15,2022-03-27,5,5,5,0,169,169,163,6,0
Mendocino,15,2022-03-27,32,32,30,2,1311,1324,1258,66,0
Merced,15,2022-03-27,64,64,62,2,3346,3379,3275,104,9
Modoc,15,2022-03-27,2,2,2,0,50,50,49,1,0
Mono,15,2022-03-27,3,3,3,0,135,135,129,6,0
Monterey,15,2022-03-27,158,158,149,9,9413,9503,8981,522,17
Napa,15,2022-03-27,62,62,60,2,3360,3391,3292,99,1
Nevada,15,2022-03-27,27,27,26,1,1488,1503,1445,58,1
Orange,15,2022-03-27,804,811,788,23,90417,91287,88681,2606,95
Placer,15,2022-03-27,110,110,106,4,6157,6216,5969,247,33
Plumas,15,2022-03-27,2,2,2,0,271,273,262,11,0
Riverside,15,2022-03-27,536,543,524,19,44490,44919,43284,1635,64
Sacramento,15,2022-03-27,455,460,447,13,31841,32147,31214,933,92
San Benito,15,2022-03-27,9,9,9,0,1311,1324,1293,31,0
San Bernardino,15,2022-03-27,499,505,494,11,41310,41708,40807,901,70
San Diego,15,2022-03-27,1352,1364,1352,12,74508,75228,74538,690,150
San Francisco,15,2022-03-27,808,816,781,35,32972,33291,31866,1425,27
San Joaquin,15,2022-03-27,186,186,180,6,16613,16772,16236,536,31
San Luis Obispo,15,2022-03-27,98,98,96,2,5894,5950,5801,149,4
San Mateo,15,2022-03-27,532,538,528,10,34577,34909,34236,673,31
Santa Barbara,15,2022-03-27,125,125,121,4,9235,9323,9054,269,21
Santa Clara,15,2022-03-27,1262,1275,1263,12,91754,92638,91763,875,102
Santa Cruz,15,2022-03-27,139,139,136,3,18840,19020,18585,435,5
Shasta,15,2022-03-27,39,39,38,1,3862,3899,3753,146,10
Siskiyou,15,2022-03-27,8,8,8,0,310,311,303,8,0
Solano,15,2022-03-27,158,158,154,4,10906,11010,10697,313,23
Sonoma,15,2022-03-27,243,243,236,7,8243,8322,8084,238,21
Stanislaus,15,2022-03-27,123,123,118,5,8032,8110,7748,362,35
Sutter,15,2022-03-27,27,27,26,1,1505,1519,1470,49,0
Tehama,15,2022-03-27,14,14,13,1,791,798,758,40,3
Trinity,15,2022-03-27,0,0,0,0,95,95,91,4,0
Tulare,15,2022-03-27,93,93,89,4,7856,7932,7562,370,19
Tuolumne,15,2022-03-27,11,11,11,0,1129,1140,1099,41,3
Ventura,15,2022-03-27,341,342,336,6,21795,22005,21598,407,24
Yolo,15,2022-03-27,93,93,91,2,18796,18979,18547,432,3
Yuba,15,2022-03-27,31,31,30,1,1260,1272,1235,37,3
Alameda,16,2022-04-03,981,991,976,15,58006,58647,57712,935,38
Amador,16,2022-04-03,4,4,4,0,1148,1162,1130,32,1
Butte,16,2022-04-03,50,50,49,1,2493,2522,2488,34,8
Calaveras,16,2022-04-03,10,10,10,0,585,591,577,14,0
Colusa,16,2022-04-03,2,2,2,0,190,192,187,5,0
Contra Costa,16,2022-04-03,544,551,537,14,24319,24588,23975,613,17
Del Norte,16,2022-04-03,10,10,10,0,1106,1118,1094,24,1
El Dorado,16,2022-04-03,47,47,46,1,2716,2748,2680,68,3
Fresno,16,2022-04-03,203,204,199,5,16946,17133,16672,461,77
Glenn,16,2022-04-03,5,5,5,0,259,260,254,6,0
Humboldt,16,2022-04-03,21,21,21,0,2478,2506,2450,56,5
Imperial,16,2022-04-03,53,53,52,1,3475,3513,3426,87,6
Inyo,16,2022-04-03,8,8,8,0,170,170,167,3,0
Kern,16,2022-04-03,163,163,159,4,17097,17285,16901,384,23
Kings,16,2022-04-03,51,51,50,1,4184,4231,4119,112,3
Lake,16,2022-04-03,13,13,13,0,989,1001,972,29,0
Lassen,16,2022-04-03,4,4,4,0,1224,1237,1213,24,0
Los Angeles,16,2022-04-03,5085,5143,5113,30,731598,739708,735280,4428,287
Madera,16,2022-04-03,28,28,27,1,3307,3344,3255,89,4
Marin,16,2022-04-03,169,169,165,4,6461,6533,6377,156,2
Mariposa,16,2022-04-03,6,6,6,0,222,223,217,6,0
Mendocino,16,2022-04-03,25,25,24,1,1233,1247,1200,47,2
Merced,16,2022-04-03,55,55,54,1,3298,3333,3256,77,4
Modoc,16,2022-04-03,4,4,4,0,47,47,46,1,0
Mono,16,2022-04-03,1,1,1,0,151,151,146,5,0
Monterey,16,2022-04-03,133,133,128,5,7492,7575,7263,312,8
Napa,16,2022-04-03,70,70,69,1,3226,3260,3189,71,3
Nevada,16,2022-04-03,27,27,26,1,1404,1420,1379,41,0
Orange,16,2022-04-03,926,936,917,19,88210,89186,87275,1911,66
Placer,16,2022-04-03,122,122,118,4,6657,6731,6530,201,21
Plumas,16,2022-04-03,4,4,4,0,231,232,225,7,0
Riverside,16,2022-04-03,611,618,601,17,38596,39023,37953,1070,47
Sacramento,16,2022-04-03,432,437,428,9,32561,32921,32204,717,60
San Benito,16,2022-04-03,14,14,14,0,1233,1247,1225,22,0
San Bernardino,16,2022-04-03,584,591,582,9,41263,41721,41045,676,43
San Diego,16,2022-04-03,1502,1520,1510,10,64991,65712,65263,449,119
San Francisco,16,2022-04-03,956,967,936,31,28460,28775,27846,929,25
San Joaquin,16,2022-04-03,207,207,202,5,15953,16130,15740,390,14
San Luis Obispo,16,2022-04-03,100,100,98,2,5599,5660,5553,107,3
San Mateo,16,2022-04-03,684,691,681,10,29497,29824,29395,429,14
Santa Barbara,16,2022-04-03,176,176,172,4,14993,15160,14829,331,8
Santa Clara,16,2022-04-03,1409,1426,1416,10,90542,91543,90895,648,102
Santa Cruz,16,2022-04-03,190,191,188,3,20128,20350,20000,350,6
Shasta,16,2022-04-03,24,24,23,1,3544,3582,3481,101,4
Siskiyou,16,2022-04-03,4,4,4,0,301,304,298,6,0
Solano,16,2022-04-03,153,153,150,3,10116,10227,10008,219,24
Sonoma,16,2022-04-03,306,309,303,6,10632,10749,10518,231,10
Stanislaus,16,2022-04-03,104,104,101,3,7784,7871,7605,266,27
Sutter,16,2022-04-03,26,26,25,1,1280,1294,1263,31,0
Tehama,16,2022-04-03,4,4,4,0,757,764,735,29,0
Trinity,16,2022-04-03,1,1,1,0,78,78,75,3,0
Tulare,16,2022-04-03,50,50,48,2,7604,7686,7415,271,16
Tuolumne,16,2022-04-03,11,11,11,0,962,973,947,26,1
Ventura,16,2022-04-03,295,297,293,4,20817,21047,20756,291,22
Yolo,16,2022-04-03,68,68,67,1,26773,27071,26600,471,2
Yuba,16,2022-04-03,12,12,12,0,1024,1036,1013,23,4
Alameda,17,2022-04-10,1423,1440,1423,17,48929,49539,48951,588,52
Amador,17,2022-04-10,7,7,7,0,1062,1076,1054,22,1
Butte,17,2022-04-10,35,35,35,0,2084,2110,2089,21,4
Calaveras,17,2022-04-10,11,11,11,0,653,662,650,12,0
Colusa,17,2022-04-10,5,5,5,0,199,201,197,4,0
Contra Costa,17,2022-04-10,664,672,660,12,19709,19956,19586,370,21
Del Norte,17,2022-04-10,7,7,7,0,1017,1030,1014,16,0
El Dorado,17,2022-04-10,55,55,54,1,2592,2624,2576,48,1
Fresno,17,2022-04-10,188,188,184,4,16708,16916,16575,341,58
Glenn,17,2022-04-10,3,3,3,0,228,229,225,4,0
Humboldt,17,2022-04-10,41,41,40,1,2341,2369,2330,39,6
Imperial,17,2022-04-10,25,25,25,0,3439,3481,3417,64,3
Inyo,17,2022-04-10,5,5,5,0,198,199,196,3,1
Kern,17,2022-04-10,145,145,143,2,17155,17368,17080,288,24
Kings,17,2022-04-10,36,36,35,1,4220,4272,4187,85,3
Lake,17,2022-04-10,20,20,20,0,850,862,843,19,0
Lassen,17,2022-04-10,1,1,1,0,1294,1311,1292,19,1
Los Angeles,17,2022-04-10,6590,6672,6643,29,750648,759991,756577,3414,265
Madera,17,2022-04-10,28,28,27,1,3108,3148,3085,63,4
Marin,17,2022-04-10,197,198,195,3,5480,5547,5448,99,6
Mariposa,17,2022-04-10,6,6,6,0,242,246,241,5,0
Mendocino,17,2022-04-10,29,29,28,1,1135,1150,1117,33,0
Merced,17,2022-04-10,78,78,77,1,3290,3329,3272,57,0
Modoc,17,2022-04-10,1,1,1,0,46,46,45,1,0
Mono,17,2022-04-10,4,4,4,0,136,136,133,3,0
Monterey,17,2022-04-10,111,111,108,3,7162,7252,7027,225,11
Napa,17,2022-04-10,118,118,116,2,3106,3145,3094,51,1
Nevada,17,2022-04-10,34,34,33,1,1495,1515,1482,33,3
Orange,17,2022-04-10,1120,1134,1116,18,54419,55100,54222,878,77
Placer,17,2022-04-10,120,120,117,3,6039,6115,5978,137,23
Plumas,17,2022-04-10,5,5,5,0,260,263,257,6,0
Riverside,17,2022-04-10,740,748,733,15,37599,38068,37284,784,41
Sacramento,17,2022-04-10,491,498,490,8,31209,31598,31082,516,45
San Benito,17,2022-04-10,18,18,18,0,1170,1186,1170,16,0
San Bernardino,17,2022-04-10,826,838,828,10,41703,42223,41712,511,34
San Diego,17,2022-04-10,1842,1865,1856,9,74182,75109,74727,382,108
San Francisco,17,2022-04-10,1166,1181,1153,28,29976,30350,29615,735,24
San Joaquin,17,2022-04-10,225,227,223,4,15402,15593,15311,282,16
San Luis Obispo,17,2022-04-10,104,104,103,1,4934,4995,4924,71,2
San Mateo,17,2022-04-10,829,839,830,9,30576,30956,30623,333,5
Santa Barbara,17,2022-04-10,260,263,259,4,15182,15372,15120,252,8
Santa Clara,17,2022-04-10,1637,1657,1648,9,79464,80455,80032,423,81
Santa Cruz,17,2022-04-10,295,299,295,4,8383,8487,8380,107,6
Shasta,17,2022-04-10,20,20,20,0,3230,3270,3201,69,3
Siskiyou,17,2022-04-10,1,1,1,0,327,331,326,5,0
Solano,17,2022-04-10,221,222,218,4,9579,9699,9545,154,17
Sonoma,17,2022-04-10,387,394,388,6,10632,10765,10592,173,9
Stanislaus,17,2022-04-10,128,128,125,3,7883,7982,7780,202,20
Sutter,17,2022-04-10,19,19,19,0,1302,1318,1294,24,0
Tehama,17,2022-04-10,10,10,10,0,742,751,730,21,1
Trinity,17,2022-04-10,0,0,0,0,88,88,86,2,0
Tulare,17,2022-04-10,46,46,45,1,7837,7934,7724,210,8
Tuolumne,17,2022-04-10,17,17,17,0,1053,1066,1044,22,1
Ventura,17,2022-04-10,296,300,297,3,18006,18229,18041,188,17
Yolo,17,2022-04-10,102,102,101,1,18526,18759,18516,243,1
Yuba,17,2022-04-10,15,15,15,0,1077,1090,1072,18,1
Alameda,18,2022-04-17,1722,1747,1732,15,53926,54690,54204,486,46
Amador,18,2022-04-17,8,8,8,0,1158,1174,1156,18,2
Butte,18,2022-04-17,47,47,47,0,1999,2026,2011,15,6
Calaveras,18,2022-04-17,15,15,15,0,598,606,598,8,0
Colusa,18,2022-04-17,3,3,3,0,164,165,163,2,0
Contra Costa,18,2022-04-17,980,993,979,14,24489,24837,24490,347,30
Del Norte,18,2022-04-17,10,10,10,0,996,1010,998,12,0
El Dorado,18,2022-04-17,63,63,62,1,2320,2354,2321,33,0
Fresno,18,2022-04-17,203,204,201,3,13764,13961,13752,209,46
Glenn,18,2022-04-17,3,3,3,0,235,237,234,3,0
Humboldt,18,2022-04-17,77,77,76,1,1941,1968,1943,25,6
Imperial,18,2022-04-17,43,43,42,1,3317,3364,3317,47,3
Inyo,18,2022-04-17,0,0,0,0,165,166,164,2,0
Kern,18,2022-04-17,129,129,127,2,13334,13523,13356,167,14
Kings,18,2022-04-17,35,35,34,1,3550,3600,3547,53,2
Lake,18,2022-04-17,19,19,19,0,797,810,797,13,3
Lassen,18,2022-04-17,2,2,2,0,1335,1352,1337,15,0
Los Angeles,18,2022-04-17,7585,7694,7669,25,366146,371329,370086,1243,221
Madera,18,2022-04-17,21,21,21,0,2602,2638,2599,39,4
Marin,18,2022-04-17,288,295,291,4,5973,6057,5976,81,5
Mariposa,18,2022-04-17,12,12,12,0,257,262,258,4,0
Mendocino,18,2022-04-17,47,47,46,1,1293,1312,1284,28,3
Merced,18,2022-04-17,58,58,57,1,3124,3168,3127,41,5
Modoc,18,2022-04-17,1,1,1,0,33,34,33,1,0
Mono,18,2022-04-17,12,12,12,0,163,165,162,3,0
Monterey,18,2022-04-17,137,137,134,3,6209,6299,6152,147,5
Napa,18,2022-04-17,140,140,138,2,2644,2681,2649,32,1
Nevada,18,2022-04-17,42,42,41,1,1224,1242,1222,20,1
Orange,18,2022-04-17,1335,1355,1339,16,81154,82301,81311,990,60
Placer,18,2022-04-17,153,153,150,3,4661,4728,4649,79,28
Plumas,18,2022-04-17,9,9,9,0,205,208,204,4,0
Riverside,18,2022-04-17,836,848,835,13,36434,36950,36379,571,45
Sacramento,18,2022-04-17,656,665,657,8,27453,27843,27504,339,56
San Benito,18,2022-04-17,24,24,24,0,1173,1191,1179,12,0
San Bernardino,18,2022-04-17,1055,1069,1059,10,38853,39403,39045,358,43
San Diego,18,2022-04-17,1875,1901,1894,7,66784,67730,67471,259,107
San Francisco,18,2022-04-17,1358,1376,1351,25,30341,30772,30214,558,28
San Joaquin,18,2022-04-17,243,246,243,3,14703,14911,14709,202,12
San Luis Obispo,18,2022-04-17,144,144,142,2,4846,4914,4862,52,3
San Mateo,18,2022-04-17,1060,1074,1066,8,29424,29841,29602,239,15
Santa Barbara,18,2022-04-17,326,332,328,4,14728,14936,14753,183,8
Santa Clara,18,2022-04-17,2100,2130,2122,8,73509,74548,74254,294,74
Santa Cruz,18,2022-04-17,403,407,403,4,12221,12391,12269,122,4
Shasta,18,2022-04-17,29,29,29,0,2818,2860,2815,45,3
Siskiyou,18,2022-04-17,3,3,3,0,320,323,320,3,2
Solano,18,2022-04-17,223,227,224,3,8953,9080,8972,108,11
Sonoma,18,2022-04-17,491,498,492,6,11141,11298,11162,136,18
Stanislaus,18,2022-04-17,153,153,150,3,7664,7772,7624,148,19
Sutter,18,2022-04-17,22,22,22,0,1165,1181,1165,16,0
Tehama,18,2022-04-17,8,8,8,0,649,657,643,14,1
Trinity,18,2022-04-17,0,0,0,0,68,68,67,1,0
Tulare,18,2022-04-17,80,80,78,2,6731,6827,6691,136,12
Tuolumne,18,2022-04-17,25,25,25,0,1070,1086,1069,17,0
Ventura,18,2022-04-17,347,352,349,3,15576,15797,15675,122,8
Yolo,18,2022-04-17,103,103,102,1,17552,17801,17627,174,2
Yuba,18,2022-04-17,21,21,21,0,973,987,975,12,1
Alameda,19,2022-04-24,2327,2365,2350,15,56675,57604,57224,380,42
Amador,19,2022-04-24,23,23,23,0,1311,1332,1316,16,0
Butte,19,2022-04-24,44,44,44,0,2256,2294,2281,13,8
Calaveras,19,2022-04-24,29,29,29,0,636,646,640,6,0
Colusa,19,2022-04-24,3,3,3,0,183,185,183,2,0
Contra Costa,19,2022-04-24,1411,1435,1420,15,26128,26558,26282,276,33
Del Norte,19,2022-04-24,19,19,19,0,1089,1107,1097,10,0
El Dorado,19,2022-04-24,98,98,97,1,2708,2752,2724,28,0
Fresno,19,2022-04-24,333,340,336,4,15987,16249,16067,182,37
Glenn,19,2022-04-24,4,4,4,0,258,262,260,2,0
Humboldt,19,2022-04-24,178,180,178,2,2769,2815,2789,26,4
Imperial,19,2022-04-24,56,56,55,1,3386,3442,3407,35,4
Inyo,19,2022-04-24,6,6,6,0,176,179,178,1,0
Kern,19,2022-04-24,232,237,235,2,17206,17487,17326,161,20
Kings,19,2022-04-24,56,56,55,1,4478,4552,4502,50,2
Lake,19,2022-04-24,14,14,14,0,819,833,823,10,1
Lassen,19,2022-04-24,0,0,0,0,1503,1526,1514,12,0
Los Angeles,19,2022-04-24,10938,11120,11093,27,859721,873732,871552,2180,231
Madera,19,2022-04-24,36,36,36,0,2830,2877,2845,32,2
Marin,19,2022-04-24,344,351,348,3,6218,6320,6257,63,9
Mariposa,19,2022-04-24,14,14,14,0,214,218,215,3,0
Mendocino,19,2022-04-24,65,65,64,1,1221,1240,1220,20,1
Merced,19,2022-04-24,95,95,94,1,2955,3003,2974,29,6
Modoc,19,2022-04-24,1,1,1,0,38,39,38,1,0
Mono,19,2022-04-24,4,4,4,0,93,93,92,1,0
Monterey,19,2022-04-24,303,307,302,5,7580,7703,7569,134,4
Napa,19,2022-04-24,201,205,203,2,3352,3407,3376,31,1
Nevada,19,2022-04-24,50,50,49,1,1354,1375,1358,17,1
Orange,19,2022-04-24,1913,1945,1928,17,84703,86088,85320,768,69
Placer,19,2022-04-24,219,223,220,3,5833,5928,5854,74,25
Plumas,19,2022-04-24,0,0,0,0,238,242,239,3,0
Riverside,19,2022-04-24,1240,1259,1245,14,39642,40290,39826,464,42
Sacramento,19,2022-04-24,966,983,974,9,31115,31624,31337,287,47
San Benito,19,2022-04-24,33,33,33,0,1142,1160,1151,9,0
San Bernardino,19,2022-04-24,1291,1311,1302,9,42436,43130,42839,291,28
San Diego,19,2022-04-24,2831,2876,2868,8,73716,74924,74712,212,98
San Francisco,19,2022-04-24,1867,1898,1873,25,31488,32004,31571,433,31
San Joaquin,19,2022-04-24,355,362,358,4,15343,15593,15435,158,13
San Luis Obispo,19,2022-04-24,199,201,199,2,5058,5141,5101,40,4
San Mateo,19,2022-04-24,1447,1472,1463,9,32124,32648,32453,195,19
Santa Barbara,19,2022-04-24,358,365,362,3,14779,15021,14884,137,8
Santa Clara,19,2022-04-24,2943,2993,2984,9,69926,71072,70865,207,89
Santa Cruz,19,2022-04-24,478,487,484,3,19680,20000,19858,142,2
Shasta,19,2022-04-24,49,49,48,1,3099,3150,3113,37,0
Siskiyou,19,2022-04-24,10,10,10,0,323,328,325,3,0
Solano,19,2022-04-24,413,419,415,4,10226,10394,10302,92,11
Sonoma,19,2022-04-24,641,652,646,6,11855,12050,11942,108,20
Stanislaus,19,2022-04-24,217,220,217,3,7712,7838,7727,111,23
Sutter,19,2022-04-24,36,36,36,0,1349,1370,1356,14,0
Tehama,19,2022-04-24,15,15,15,0,670,682,671,11,1
Trinity,19,2022-04-24,2,2,2,0,72,72,71,1,0
Tulare,19,2022-04-24,79,79,78,1,7021,7135,7029,106,12
Tuolumne,19,2022-04-24,37,37,37,0,1124,1142,1129,13,1
Ventura,19,2022-04-24,587,595,592,3,18875,19184,19074,110,17
Yolo,19,2022-04-24,199,202,201,1,19461,19780,19637,143,1
Yuba,19,2022-04-24,34,34,34,0,1114,1132,1122,10,0
Alameda,20,2022-05-01,3211,3275,3259,16,69092,70433,70085,348,49
Amador,20,2022-05-01,27,27,27,0,1335,1360,1348,12,0
Butte,20,2022-05-01,85,85,85,0,2287,2332,2322,10,4
Calaveras,20,2022-05-01,28,28,28,0,728,742,737,5,0
Colusa,20,2022-05-01,5,5,5,0,209,213,211,2,0
Contra Costa,20,2022-05-01,1772,1807,1793,14,28805,29367,29139,228,44
Del Norte,20,2022-05-01,40,40,40,0,1199,1223,1215,8,0
El Dorado,20,2022-05-01,122,122,121,1,2722,2775,2754,21,1
Fresno,20,2022-05-01,467,475,471,4,16813,17142,16998,144,39
Glenn,20,2022-05-01,5,5,5,0,243,246,244,2,0
Humboldt,20,2022-05-01,229,235,233,2,2940,2997,2976,21,8
Imperial,20,2022-05-01,114,114,113,1,3652,3722,3693,29,2
Inyo,20,2022-05-01,5,5,5,0,207,211,210,1,0
Kern,20,2022-05-01,287,294,292,2,17880,18226,18100,126,17
Kings,20,2022-05-01,45,45,45,0,4712,4804,4764,40,5
Lake,20,2022-05-01,30,30,30,0,1014,1034,1025,9,1
Lassen,20,2022-05-01,9,9,9,0,1614,1645,1635,10,0
Los Angeles,20,2022-05-01,14063,14341,14315,26,920442,938224,936477,1747,225
Madera,20,2022-05-01,71,71,70,1,3283,3349,3321,28,5
Marin,20,2022-05-01,389,396,393,3,6439,6565,6516,49,10
Mariposa,20,2022-05-01,9,9,9,0,240,246,244,2,0
Mendocino,20,2022-05-01,46,46,45,1,1266,1291,1276,15,0
Merced,20,2022-05-01,118,118,117,1,3244,3307,3283,24,7
Modoc,20,2022-05-01,0,0,0,0,41,42,41,1,0
Mono,20,2022-05-01,4,4,4,0,85,85,84,1,0
Monterey,20,2022-05-01,323,330,326,4,8307,8468,8357,111,8
Napa,20,2022-05-01,217,224,223,1,3516,3584,3560,24,5
Nevada,20,2022-05-01,76,76,75,1,1505,1533,1519,14,2
Orange,20,2022-05-01,2496,2546,2529,17,87852,89556,88959,597,81
Placer,20,2022-05-01,279,286,283,3,6221,6342,6283,59,29
Plumas,20,2022-05-01,10,10,10,0,250,255,253,2,0
Riverside,20,2022-05-01,1853,1890,1874,16,42220,43042,42672,370,37
Sacramento,20,2022-05-01,1257,1282,1273,9,32571,33205,32980,225,53
San Benito,20,2022-05-01,46,46,46,0,1228,1253,1246,7,0
San Bernardino,20,2022-05-01,1383,1410,1403,7,42772,43604,43385,219,36
San Diego,20,2022-05-01,3825,3900,3892,8,71275,72665,72512,153,84
San Francisco,20,2022-05-01,2351,2398,2374,24,35256,35946,35583,363,44
San Joaquin,20,2022-05-01,489,498,494,4,15274,15570,15453,117,15
San Luis Obispo,20,2022-05-01,250,255,253,2,5142,5243,5212,31,8
San Mateo,20,2022-05-01,1723,1757,1749,8,36102,36804,36640,164,24
Santa Barbara,20,2022-05-01,404,411,408,3,15549,15851,15743,108,10
Santa Clara,20,2022-05-01,4063,4143,4134,9,95593,97451,97239,212,103
Santa Cruz,20,2022-05-01,629,642,639,3,22109,22537,22417,120,2
Shasta,20,2022-05-01,62,62,61,1,3392,3457,3426,31,9
Siskiyou,20,2022-05-01,11,11,11,0,324,329,327,2,0
Solano,20,2022-05-01,561,572,568,4,11311,11531,11455,76,11
Sonoma,20,2022-05-01,808,822,817,5,12437,12679,12594,85,17
Stanislaus,20,2022-05-01,268,274,271,3,8208,8367,8278,89,21
Sutter,20,2022-05-01,47,47,47,0,1257,1282,1272,10,0
Tehama,20,2022-05-01,20,20,20,0,685,698,690,8,0
Trinity,20,2022-05-01,1,1,1,0,88,88,87,1,0
Tulare,20,2022-05-01,152,153,151,2,7163,7302,7221,81,11
Tuolumne,20,2022-05-01,85,85,84,1,1226,1250,1239,11,5
Ventura,20,2022-05-01,681,695,692,3,19400,19776,19691,85,17
Yolo,20,2022-05-01,256,263,262,1,18891,19259,19155,104,1
Yuba,20,2022-05-01,41,41,41,0,1060,1080,1073,7,2
Alameda,21,2022-05-08,3916,4014,3999,15,70218,71948,71684,264,67
Amador,21,2022-05-08,13,13,13,0,1428,1463,1454,9,0
Butte,21,2022-05-08,117,119,119,0,2382,2441,2433,8,4
Calaveras,21,2022-05-08,30,30,30,0,688,706,702,4,1
Colusa,21,2022-05-08,2,2,2,0,216,221,220,1,0
Contra Costa,21,2022-05-08,2339,2397,2383,14,30396,31148,30968,180,46
Del Norte,21,2022-05-08,39,39,39,0,1227,1258,1252,6,0
El Dorado,21,2022-05-08,167,173,172,1,2814,2884,2867,17,4
Fresno,21,2022-05-08,665,682,678,4,17848,18289,18175,114,35
Glenn,21,2022-05-08,6,6,6,0,230,236,235,1,0
Humboldt,21,2022-05-08,284,291,290,1,3257,3336,3319,17,4
Imperial,21,2022-05-08,119,123,122,1,3735,3826,3804,22,1
Inyo,21,2022-05-08,21,21,21,0,200,205,204,1,1
Kern,21,2022-05-08,422,432,430,2,18328,18778,18681,97,21
Kings,21,2022-05-08,94,94,93,1,4919,5039,5008,31,2
Lake,21,2022-05-08,31,31,31,0,1010,1035,1028,7,1
Lassen,21,2022-05-08,2,2,2,0,1697,1740,1732,8,0
Los Angeles,21,2022-05-08,17529,17967,17943,24,909235,931432,930142,1290,242
Madera,21,2022-05-08,128,130,129,1,3688,3779,3756,23,3
Marin,21,2022-05-08,663,680,676,4,7616,7805,7762,43,11
Mariposa,21,2022-05-08,26,26,26,0,268,275,273,2,0
Mendocino,21,2022-05-08,91,91,90,1,1219,1249,1238,11,0
Merced,21,2022-05-08,175,181,180,1,3415,3500,3481,19,5
Modoc,21,2022-05-08,2,2,2,0,41,42,41,1,0
Mono,21,2022-05-08,11,11,11,0,127,129,128,1,0
Monterey,21,2022-05-08,424,435,431,4,9149,9373,9281,92,9
Napa,21,2022-05-08,234,240,239,1,3230,3308,3291,17,3
Nevada,21,2022-05-08,97,97,96,1,1624,1662,1651,11,4
Orange,21,2022-05-08,3387,3472,3455,17,90903,93137,92675,462,117
Placer,21,2022-05-08,479,492,489,3,6695,6861,6813,48,30
Plumas,21,2022-05-08,10,10,10,0,274,280,278,2,0
Riverside,21,2022-05-08,2367,2425,2410,15,44846,45951,45657,294,43
Sacramento,21,2022-05-08,2032,2082,2072,10,36267,37160,36972,188,73
San Benito,21,2022-05-08,68,68,68,0,1436,1472,1466,6,0
San Bernardino,21,2022-05-08,1791,1836,1829,7,45140,46251,46078,173,39
San Diego,21,2022-05-08,5012,5138,5130,8,86491,88625,88486,139,97
San Francisco,21,2022-05-08,2878,2951,2929,22,37548,38477,38187,290,58
San Joaquin,21,2022-05-08,725,743,739,4,15788,16177,16087,90,15
San Luis Obispo,21,2022-05-08,287,294,293,1,5216,5343,5320,23,0
San Mateo,21,2022-05-08,2219,2274,2267,7,36872,37778,37653,125,26
Santa Barbara,21,2022-05-08,605,619,616,3,15333,15709,15629,80,11
Santa Clara,21,2022-05-08,5455,5593,5584,9,102711,105235,105065,170,107
Santa Cruz,21,2022-05-08,700,717,714,3,22953,23513,23420,93,4
Shasta,21,2022-05-08,96,96,95,1,3448,3532,3509,23,5
Siskiyou,21,2022-05-08,13,13,13,0,285,291,290,1,0
Solano,21,2022-05-08,843,864,860,4,12214,12515,12453,62,18
Sonoma,21,2022-05-08,1152,1181,1175,6,13963,14307,14236,71,23
Stanislaus,21,2022-05-08,407,418,415,3,8748,8964,8894,70,26
Sutter,21,2022-05-08,48,48,48,0,1542,1580,1571,9,0
Tehama,21,2022-05-08,23,23,23,0,684,702,696,6,1
Trinity,21,2022-05-08,2,2,2,0,67,68,67,1,0
Tulare,21,2022-05-08,178,183,182,1,7569,7755,7691,64,13
Tuolumne,21,2022-05-08,79,79,79,0,1317,1349,1340,9,2
Ventura,21,2022-05-08,1074,1101,1098,3,21051,21568,21499,69,14
Yolo,21,2022-05-08,320,328,327,1,19489,19972,19892,80,2
Yuba,21,2022-05-08,65,65,65,0,1195,1224,1218,6,2
Alameda,22,2022-05-15,4718,4882,4869,13,74217,76733,76523,210,69
Amador,22,2022-05-15,49,49,49,0,1683,1740,1732,8,1
Butte,22,2022-05-15,167,174,174,0,2605,2694,2688,6,6
Calaveras,22,2022-05-15,31,31,31,0,763,789,786,3,2
Colusa,22,2022-05-15,5,5,5,0,212,220,219,1,0
Contra Costa,22,2022-05-15,3133,3242,3228,14,32350,33453,33309,144,56
Del Norte,22,2022-05-15,113,116,116,0,1741,1801,1794,7,0
El Dorado,22,2022-05-15,242,250,249,1,3054,3157,3143,14,7
Fresno,22,2022-05-15,1002,1038,1033,5,18947,19595,19504,91,49
Glenn,22,2022-05-15,12,12,12,0,256,265,264,1,0
Humboldt,22,2022-05-15,277,287,286,1,3231,3339,3326,13,11
Imperial,22,2022-05-15,202,209,208,1,4193,4335,4317,18,4
Inyo,22,2022-05-15,22,22,22,0,225,233,232,1,1
Kern,22,2022-05-15,600,620,618,2,19680,20346,20268,78,21
Kings,22,2022-05-15,178,185,184,1,5328,5510,5485,25,0
Lake,22,2022-05-15,61,62,62,0,1126,1163,1157,6,0
Lassen,22,2022-05-15,16,16,16,0,1682,1737,1731,6,0
Los Angeles,22,2022-05-15,19928,20620,20599,21,924601,955526,954541,985,312
Madera,22,2022-05-15,173,180,179,1,3627,3752,3735,17,2
Marin,22,2022-05-15,753,780,777,3,8130,8409,8374,35,12
Mariposa,22,2022-05-15,25,25,25,0,351,363,361,2,0
Mendocino,22,2022-05-15,98,102,101,1,1347,1393,1384,9,3
Merced,22,2022-05-15,277,286,285,1,3865,3997,3981,16,10
Modoc,22,2022-05-15,3,3,3,0,43,44,43,1,0
Mono,22,2022-05-15,8,8,8,0,109,112,111,1,0
Monterey,22,2022-05-15,492,509,505,4,9564,9887,9815,72,7
Napa,22,2022-05-15,282,292,291,1,3501,3619,3606,13,2
Nevada,22,2022-05-15,137,144,143,1,1850,1913,1903,10,1
Orange,22,2022-05-15,4213,4360,4344,16,93532,96700,96343,357,87
Placer,22,2022-05-15,649,672,669,3,7446,7701,7661,40,43
Plumas,22,2022-05-15,45,45,45,0,257,265,264,1,1
Riverside,22,2022-05-15,3072,3181,3166,15,46687,48277,48047,230,57
Sacramento,22,2022-05-15,2872,2972,2961,11,38721,40040,39890,150,101
San Benito,22,2022-05-15,101,105,105,0,1542,1593,1588,5,1
San Bernardino,22,2022-05-15,2290,2369,2363,6,47729,49352,49214,138,44
San Diego,22,2022-05-15,6094,6307,6300,7,92673,95836,95724,112,110
San Francisco,22,2022-05-15,3313,3428,3409,19,38696,40014,39788,226,57
San Joaquin,22,2022-05-15,1133,1174,1169,5,18126,18742,18664,78,13
San Luis Obispo,22,2022-05-15,366,378,377,1,5783,5980,5961,19,4
San Mateo,22,2022-05-15,2665,2758,2751,7,39686,41033,40932,101,38
Santa Barbara,22,2022-05-15,808,837,834,3,16553,17114,17049,65,12
Santa Clara,22,2022-05-15,6822,7061,7053,8,110242,113974,113837,137,115
Santa Cruz,22,2022-05-15,882,911,908,3,24914,25749,25673,76,5
Shasta,22,2022-05-15,111,114,113,1,3762,3887,3868,19,6
Siskiyou,22,2022-05-15,19,19,19,0,392,406,405,1,0
Solano,22,2022-05-15,1089,1128,1124,4,13458,13917,13866,51,26
Sonoma,22,2022-05-15,1452,1503,1498,5,15186,15702,15644,58,29
Stanislaus,22,2022-05-15,672,696,692,4,9808,10143,10084,59,37
Sutter,22,2022-05-15,101,104,104,0,1752,1812,1804,8,0
Tehama,22,2022-05-15,25,25,25,0,808,836,831,5,3
Trinity,22,2022-05-15,5,5,5,0,66,68,67,1,0
Tulare,22,2022-05-15,319,331,329,2,7835,8098,8048,50,12
Tuolumne,22,2022-05-15,98,101,101,0,1460,1508,1501,7,2
Ventura,22,2022-05-15,1410,1460,1457,3,23061,23846,23790,56,25
Yolo,22,2022-05-15,477,493,492,1,21352,22082,22016,66,1
Yuba,22,2022-05-15,104,109,109,0,1264,1307,1302,5,4
Alameda,23,2022-05-22,5431,5771,5759,12,76133,80722,80558,164,83
Amador,23,2022-05-22,67,71,71,0,1555,1649,1643,6,0
Butte,23,2022-05-22,262,279,279,0,2694,2856,2851,5,8
Calaveras,23,2022-05-22,53,55,55,0,750,795,793,2,0
Colusa,23,2022-05-22,6,6,6,0,221,234,233,1,0
Contra Costa,23,2022-05-22,3669,3899,3887,12,34575,36681,36563,118,72
Del Norte,23,2022-05-22,123,129,129,0,1567,1659,1654,5,1
El Dorado,23,2022-05-22,328,349,348,1,3345,3549,3538,11,6
Fresno,23,2022-05-22,1482,1575,1570,5,20785,22061,21984,77,60
Glenn,23,2022-05-22,19,19,19,0,263,279,278,1,0
Humboldt,23,2022-05-22,236,250,249,1,2869,3043,3034,9,15
Imperial,23,2022-05-22,277,294,293,1,4657,4940,4924,16,4
Inyo,23,2022-05-22,21,21,21,0,239,254,253,1,0
Kern,23,2022-05-22,891,947,944,3,20437,21668,21606,62,38
Kings,23,2022-05-22,241,255,254,1,5591,5926,5906,20,0
Lake,23,2022-05-22,76,82,82,0,1247,1321,1316,5,2
Lassen,23,2022-05-22,34,34,34,0,1727,1830,1825,5,0
Los Angeles,23,2022-05-22,24914,26468,26448,20,926867,981106,980354,752,391
Madera,23,2022-05-22,208,223,222,1,3713,3942,3928,14,1
Marin,23,2022-05-22,795,845,842,3,8798,9339,9310,29,14
Mariposa,23,2022-05-22,32,33,33,0,337,358,357,1,0
Mendocino,23,2022-05-22,133,141,140,1,1614,1713,1705,8,4
Merced,23,2022-05-22,408,435,434,1,4116,4365,4352,13,4
Modoc,23,2022-05-22,2,2,2,0,35,36,35,1,0
Mono,23,2022-05-22,17,17,17,0,163,173,172,1,0
Monterey,23,2022-05-22,601,637,634,3,9551,10121,10066,55,15
Napa,23,2022-05-22,304,324,323,1,4010,4252,4240,12,5
Nevada,23,2022-05-22,138,146,145,1,1823,1933,1926,7,1
Orange,23,2022-05-22,5351,5692,5677,15,95200,100916,100639,277,126
Placer,23,2022-05-22,854,909,906,3,7907,8388,8355,33,41
Plumas,23,2022-05-22,42,44,44,0,257,272,271,1,0
Riverside,23,2022-05-22,4133,4396,4381,15,50268,53333,53144,189,80
Sacramento,23,2022-05-22,3735,3970,3959,11,40588,43037,42917,120,116
San Benito,23,2022-05-22,157,166,166,0,1554,1649,1645,4,0
San Bernardino,23,2022-05-22,3007,3197,3190,7,48329,51258,51152,106,56
San Diego,23,2022-05-22,8490,9020,9012,8,101840,108033,107939,94,142
San Francisco,23,2022-05-22,3532,3749,3733,16,41485,44023,43838,185,92
San Joaquin,23,2022-05-22,1425,1513,1508,5,20457,21692,21625,67,28
San Luis Obispo,23,2022-05-22,632,673,671,2,7055,7487,7469,18,11
San Mateo,23,2022-05-22,3006,3196,3190,6,40417,42847,42768,79,37
Santa Barbara,23,2022-05-22,1044,1109,1106,3,17915,18991,18938,53,20
Santa Clara,23,2022-05-22,7612,8096,8089,7,111324,118003,117897,106,131
Santa Cruz,23,2022-05-22,493,524,523,1,7945,8415,8397,18,15
Shasta,23,2022-05-22,182,193,192,1,3535,3742,3728,14,7
Siskiyou,23,2022-05-22,20,20,20,0,343,364,363,1,1
Solano,23,2022-05-22,1422,1508,1504,4,14065,14905,14864,41,27
Sonoma,23,2022-05-22,1485,1574,1570,4,16343,17330,17282,48,37
Stanislaus,23,2022-05-22,837,889,885,4,10163,10778,10731,47,41
Sutter,23,2022-05-22,137,146,146,0,1799,1909,1903,6,0
Tehama,23,2022-05-22,64,67,67,0,749,795,791,4,1
Trinity,23,2022-05-22,4,4,4,0,84,91,90,1,0
Tulare,23,2022-05-22,538,573,570,3,9041,9571,9527,44,24
Tuolumne,23,2022-05-22,167,177,176,1,1597,1693,1687,6,0
Ventura,23,2022-05-22,1848,1964,1961,3,23977,25426,25381,45,38
Yolo,23,2022-05-22,557,592,591,1,22277,23629,23576,53,0
Yuba,23,2022-05-22,154,163,163,0,1438,1526,1522,4,6
Alameda,24,2022-05-29,4668,7645,7634,11,65902,98650,98502,148,102
Amador,24,2022-05-29,61,119,119,0,1159,1893,1888,5,0
Butte,24,2022-05-29,257,413,412,1,2714,4638,4632,6,14
Calaveras,24,2022-05-29,37,99,99,0,664,1212,1209,3,0
Colusa,24,2022-05-29,4,7,7,0,189,307,306,1,0
Contra Costa,24,2022-05-29,2974,4721,4710,11,30329,48840,48725,115,78
Del Norte,24,2022-05-29,38,80,80,0,992,1541,1538,3,2
El Dorado,24,2022-05-29,317,532,531,1,3025,5111,5099,12,5
Fresno,24,2022-05-29,1514,2739,2732,7,19168,34392,34306,86,66
Glenn,24,2022-05-29,23,46,46,0,287,471,470,1,2
Humboldt,24,2022-05-29,164,279,278,1,2459,3845,3837,8,15
Imperial,24,2022-05-29,199,364,363,1,4284,7348,7331,17,4
Inyo,24,2022-05-29,18,25,25,0,158,277,276,1,0
Kern,24,2022-05-29,904,1435,1432,3,18417,26626,26570,56,36
Kings,24,2022-05-29,293,602,601,1,4904,7686,7667,19,3
Lake,24,2022-05-29,84,176,176,0,1081,2081,2075,6,1
Lassen,24,2022-05-29,52,87,87,0,1603,2208,2204,4,1
Los Angeles,24,2022-05-29,23037,33550,33531,19,443190,523170,522857,313,486
Madera,24,2022-05-29,204,323,322,1,3342,5765,5751,14,6
Marin,24,2022-05-29,587,1296,1293,3,7424,13923,13892,31,18
Mariposa,24,2022-05-29,26,53,53,0,323,557,556,1,0
Mendocino,24,2022-05-29,104,176,175,1,1317,2300,2292,8,5
Merced,24,2022-05-29,300,497,496,1,3566,5848,5835,13,9
Modoc,24,2022-05-29,3,3,3,0,39,67,66,1,0
Mono,24,2022-05-29,6,8,8,0,104,165,164,1,0
Monterey,24,2022-05-29,449,830,827,3,7837,13545,13492,53,15
Napa,24,2022-05-29,245,551,550,1,3426,5682,5671,11,4
Nevada,24,2022-05-29,146,210,209,1,1705,2464,2457,7,2
Orange,24,2022-05-29,5203,8989,8971,18,85705,129233,128972,261,137
Placer,24,2022-05-29,695,1317,1313,4,6533,11220,11188,32,58
Plumas,24,2022-05-29,24,36,36,0,250,398,397,1,1
Riverside,24,2022-05-29,3236,5107,5094,13,44543,66482,66307,175,96
Sacramento,24,2022-05-29,3404,5687,5675,12,34207,53222,53113,109,139
San Benito,24,2022-05-29,155,222,222,0,1437,2487,2483,4,0
San Bernardino,24,2022-05-29,2745,4259,4253,6,41973,62173,62078,95,60
San Diego,24,2022-05-29,7692,12878,12870,8,86054,131597,131513,84,174
San Francisco,24,2022-05-29,2700,4961,4946,15,34660,56833,56659,174,94
San Joaquin,24,2022-05-29,1205,2263,2258,5,17560,28804,28739,65,33
San Luis Obispo,24,2022-05-29,599,930,928,2,5888,8768,8752,16,13
San Mateo,24,2022-05-29,2381,3742,3737,5,33518,51114,51045,69,40
Santa Barbara,24,2022-05-29,911,1664,1661,3,16267,26484,26430,54,34
Santa Clara,24,2022-05-29,6069,10274,10267,7,91351,138075,137984,91,170
Santa Cruz,24,2022-05-29,385,610,609,1,6691,9928,9912,16,8
Shasta,24,2022-05-29,130,185,185,0,3108,4085,4074,11,9
Siskiyou,24,2022-05-29,49,146,146,0,344,732,731,1,3
Solano,24,2022-05-29,1065,1744,1741,3,11550,17985,17949,36,38
Sonoma,24,2022-05-29,1060,1803,1799,4,14060,22078,22033,45,42
Stanislaus,24,2022-05-29,683,1358,1354,4,9061,16433,16381,52,63
Sutter,24,2022-05-29,150,410,409,1,1782,3564,3556,8,0
Tehama,24,2022-05-29,34,47,47,0,669,943,940,3,2
Trinity,24,2022-05-29,4,5,5,0,85,113,112,1,0
Tulare,24,2022-05-29,472,873,870,3,8057,11735,11695,40,22
Tuolumne,24,2022-05-29,90,183,183,0,1434,2552,2546,6,3
Ventura,24,2022-05-29,1533,2671,2668,3,20530,33065,33022,43,36
Yolo,24,2022-05-29,397,723,722,1,19256,31179,31128,51,4
Yuba,24,2022-05-29,129,316,315,1,1237,2732,2727,5,11
