county,time,date,cases,est_cases,est_omicron_cases,est_other_cases,tests,est_tests,est_omicron_tests,est_other_tests,hospitalizations
Alameda,1,2021-12-25,5404,5416,2688,2728,83120,83300,40971,42329,86
Amador,1,2021-12-25,75,75,27,48,1474,1477,527,950,4
Butte,1,2021-12-25,349,349,188,161,3809,3819,2032,1787,31
Calaveras,1,2021-12-25,72,72,29,43,965,966,380,586,2
Colusa,1,2021-12-25,15,15,6,9,239,239,97,142,2
Contra Costa,1,2021-12-25,3256,3262,1252,2010,43044,43137,16360,26777,49
Del Norte,1,2021-12-25,20,20,9,11,1225,1226,524,702,0
El Dorado,1,2021-12-25,385,385,150,235,4121,4131,1583,2548,11
Fresno,1,2021-12-25,1524,1528,559,969,22559,22608,8168,14440,152
Glenn,1,2021-12-25,37,37,15,22,412,412,170,242,0
Humboldt,1,2021-12-25,334,334,140,194,3141,3148,1279,1869,10
Imperial,1,2021-12-25,659,659,254,405,5414,5427,2086,3341,51
Inyo,1,2021-12-25,81,81,39,42,419,419,196,223,0
Kern,1,2021-12-25,1205,1206,498,708,19629,19672,8042,11630,98
Kings,1,2021-12-25,352,352,131,221,5355,5367,1958,3409,20
Lake,1,2021-12-25,43,43,15,28,1144,1147,399,748,0
Lassen,1,2021-12-25,19,19,9,10,2322,2328,1067,1261,0
Los Angeles,1,2021-12-25,66459,66604,48297,18307,660097,661535,477538,183997,904
Madera,1,2021-12-25,209,209,78,131,4152,4162,1508,2654,12
Marin,1,2021-12-25,1161,1161,459,702,14382,14413,5674,8739,4
Mariposa,1,2021-12-25,31,31,11,20,504,504,183,321,0
Mendocino,1,2021-12-25,86,86,25,61,2497,2501,714,1787,6
Merced,1,2021-12-25,428,428,172,256,4860,4871,1939,2932,2
Modoc,1,2021-12-25,5,5,2,3,57,57,24,33,2
Mono,1,2021-12-25,93,93,30,63,356,356,111,245,1
Monterey,1,2021-12-25,723,723,197,526,12220,12247,3273,8974,35
Napa,1,2021-12-25,559,559,237,322,5566,5578,2341,3237,5
Nevada,1,2021-12-25,205,205,72,133,2513,2518,871,1647,6
Orange,1,2021-12-25,10836,10859,4601,6258,106596,106829,44772,62057,256
Placer,1,2021-12-25,912,912,312,600,10314,10336,3470,6866,82
Plumas,1,2021-12-25,11,11,4,7,395,395,140,255,0
Riverside,1,2021-12-25,9349,9369,3379,5990,76506,76672,27281,49391,357
Sacramento,1,2021-12-25,3384,3391,1416,1975,47935,48039,19828,28211,158
San Benito,1,2021-12-25,204,204,96,108,2097,2101,978,1123,5
San Bernardino,1,2021-12-25,8928,8948,4403,4545,79723,79896,38884,41012,421
San Diego,1,2021-12-25,17481,17518,12216,5302,156996,157339,109213,48126,355
San Francisco,1,2021-12-25,5598,5610,1807,3803,62129,62263,19930,42333,34
San Joaquin,1,2021-12-25,1555,1559,615,944,20822,20865,8111,12754,74
San Luis Obispo,1,2021-12-25,718,718,326,392,10144,10167,4570,5597,22
San Mateo,1,2021-12-25,3546,3554,1865,1689,50461,50570,26281,24289,18
Santa Barbara,1,2021-12-25,1417,1418,593,825,13837,13867,5710,8157,37
Santa Clara,1,2021-12-25,6163,6176,4279,1897,97868,98081,67437,30644,114
Santa Cruz,1,2021-12-25,654,654,315,339,11583,11608,5507,6101,14
Shasta,1,2021-12-25,198,198,71,127,4589,4597,1617,2980,37
Siskiyou,1,2021-12-25,15,15,7,8,344,344,161,183,0
Solano,1,2021-12-25,837,838,355,483,15109,15141,6367,8774,29
Sonoma,1,2021-12-25,1328,1329,561,768,18926,18968,7899,11069,16
Stanislaus,1,2021-12-25,881,881,278,603,10381,10403,3226,7177,104
Sutter,1,2021-12-25,177,177,70,107,2013,2017,787,1230,0
Tehama,1,2021-12-25,64,64,19,45,1046,1048,302,746,11
Trinity,1,2021-12-25,3,3,1,2,96,96,32,64,0
Tulare,1,2021-12-25,561,561,172,389,10434,10457,3135,7322,47
Tuolumne,1,2021-12-25,133,133,49,84,1743,1747,631,1116,5
Ventura,1,2021-12-25,3580,3587,1911,1676,34021,34094,17968,16126,74
Yolo,1,2021-12-25,544,544,258,286,20050,20093,9398,10695,7
Yuba,1,2021-12-25,116,116,49,67,1501,1505,623,882,11
Alameda,2,2022-01-01,13875,13907,7896,6011,102082,102315,57909,44406,150
Amador,2,2022-01-01,148,148,64,84,1850,1854,797,1057,7
Butte,2,2022-01-01,902,902,549,353,5681,5693,3447,2246,30
Calaveras,2,2022-01-01,170,170,80,90,1148,1150,538,612,3
Colusa,2,2022-01-01,53,53,26,27,299,299,144,155,4
Contra Costa,2,2022-01-01,11114,11140,5050,6090,59683,59820,27018,32802,85
Del Norte,2,2022-01-01,61,61,31,30,1963,1968,982,986,0
El Dorado,2,2022-01-01,1002,1004,462,542,5333,5346,2445,2901,17
Fresno,2,2022-01-01,5027,5039,2191,2848,34827,34906,15127,19779,188
Glenn,2,2022-01-01,68,68,33,35,517,517,251,266,0
Humboldt,2,2022-01-01,721,721,349,372,4664,4674,2251,2423,10
Imperial,2,2022-01-01,1497,1501,687,814,8184,8203,3748,4455,57
Inyo,2,2022-01-01,207,207,113,94,598,598,324,274,3
Kern,2,2022-01-01,4272,4282,2083,2199,30062,30131,14529,15602,121
Kings,2,2022-01-01,872,872,383,489,7435,7453,3261,4192,17
Lake,2,2022-01-01,144,144,61,83,1470,1474,618,856,1
Lassen,2,2022-01-01,45,45,24,21,2511,2517,1332,1185,2
Los Angeles,2,2022-01-01,175254,175654,136706,38948,912093,914174,711061,203113,1792
Madera,2,2022-01-01,660,660,289,371,5686,5699,2474,3225,13
Marin,2,2022-01-01,2211,2216,1024,1192,17588,17628,8133,9495,19
Mariposa,2,2022-01-01,73,73,32,41,533,533,232,301,0
Mendocino,2,2022-01-01,325,325,114,211,2901,2907,1018,1889,6
Merced,2,2022-01-01,1222,1225,579,646,7403,7421,3508,3913,22
Modoc,2,2022-01-01,11,11,6,5,52,52,26,26,0
Mono,2,2022-01-01,170,170,64,106,386,386,146,240,2
Monterey,2,2022-01-01,1976,1981,658,1323,17496,17537,5798,11739,29
Napa,2,2022-01-01,1518,1522,750,772,10129,10151,4991,5160,10
Nevada,2,2022-01-01,471,471,200,271,2183,2188,924,1264,6
Orange,2,2022-01-01,39452,39542,19515,20027,199487,199942,98456,101486,522
Placer,2,2022-01-01,2381,2387,978,1409,14038,14069,5713,8356,124
Plumas,2,2022-01-01,36,36,16,20,353,353,151,202,2
Riverside,2,2022-01-01,26675,26735,11471,15264,125616,125904,53793,72111,545
Sacramento,2,2022-01-01,11306,11332,5546,5786,71511,71674,34928,36746,243
San Benito,2,2022-01-01,617,617,333,284,3032,3039,1639,1400,5
San Bernardino,2,2022-01-01,28119,28183,15847,12336,122890,123170,69149,54021,624
San Diego,2,2022-01-01,53220,53341,40236,13105,229969,230495,173682,56813,628
San Francisco,2,2022-01-01,9660,9683,3764,5919,74984,75155,29128,46027,84
San Joaquin,2,2022-01-01,5515,5527,2577,2950,32323,32396,14991,17405,94
San Luis Obispo,2,2022-01-01,2118,2122,1111,1011,14801,14835,7766,7069,19
San Mateo,2,2022-01-01,8994,9013,5349,3664,67506,67659,40068,27591,34
Santa Barbara,2,2022-01-01,4183,4193,2048,2145,22303,22356,10886,11470,57
Santa Clara,2,2022-01-01,17644,17684,13272,4412,134007,134313,100510,33803,198
Santa Cruz,2,2022-01-01,1857,1863,1031,832,15282,15317,8416,6901,21
Shasta,2,2022-01-01,439,439,189,250,5442,5454,2310,3144,13
Siskiyou,2,2022-01-01,57,57,31,26,456,456,247,209,0
Solano,2,2022-01-01,3488,3496,1731,1765,24087,24143,11912,12231,62
Sonoma,2,2022-01-01,3704,3713,1828,1885,27938,28003,13706,14297,29
Stanislaus,2,2022-01-01,2636,2642,1010,1632,15969,16005,6053,9952,120
Sutter,2,2022-01-01,402,402,188,214,2617,2622,1215,1407,0
Tehama,2,2022-01-01,169,169,61,108,1173,1176,414,762,4
Trinity,2,2022-01-01,9,9,4,5,101,101,40,61,0
Tulare,2,2022-01-01,1604,1608,597,1011,14669,14702,5392,9310,53
Tuolumne,2,2022-01-01,284,284,124,160,1902,1907,827,1080,6
Ventura,2,2022-01-01,11376,11402,6863,4539,55658,55784,33475,22309,124
Yolo,2,2022-01-01,1628,1633,893,740,25313,25372,13727,11645,10
Yuba,2,2022-01-01,358,358,177,181,2056,2061,1009,1052,22
Alameda,3,2022-01-08,30998,31072,19910,11162,191098,191560,122626,68934,307
Amador,3,2022-01-08,374,374,189,185,2778,2784,1396,1388,6
Butte,3,2022-01-08,1926,1932,1306,626,9996,10020,6767,3253,47
Calaveras,3,2022-01-08,454,454,249,205,2435,2440,1329,1111,2
Colusa,3,2022-01-08,77,77,43,34,659,659,365,294,5
Contra Costa,3,2022-01-08,18922,18967,10015,8952,102122,102368,54085,48283,172
Del Norte,3,2022-01-08,161,161,93,68,3855,3864,2244,1620,2
El Dorado,3,2022-01-08,2115,2120,1130,990,8873,8893,4738,4155,18
Fresno,3,2022-01-08,12027,12056,6163,5893,57977,58117,29638,28479,284
Glenn,3,2022-01-08,181,181,103,78,872,873,491,382,2
Humboldt,3,2022-01-08,1413,1417,792,625,8252,8272,4625,3647,16
Imperial,3,2022-01-08,3413,3421,1821,1600,13709,13741,7312,6429,74
Inyo,3,2022-01-08,392,392,240,152,1243,1246,766,480,4
Kern,3,2022-01-08,10963,10990,6147,4843,55468,55602,31028,24574,191
Kings,3,2022-01-08,1951,1956,1006,950,11902,11931,6124,5807,22
Lake,3,2022-01-08,456,456,225,231,2672,2677,1317,1360,2
Lassen,3,2022-01-08,118,118,72,46,3627,3636,2182,1454,2
Los Angeles,3,2022-01-08,333571,334377,276373,58004,1909126,1913738,1582021,331717,3364
Madera,3,2022-01-08,1701,1706,876,830,10067,10092,5149,4943,26
Marin,3,2022-01-08,3075,3082,1661,1421,21676,21728,11728,10000,23
Mariposa,3,2022-01-08,181,181,92,89,1104,1107,566,541,0
Mendocino,3,2022-01-08,808,808,342,466,5478,5491,2321,3170,7
Merced,3,2022-01-08,3165,3170,1743,1427,13342,13373,7341,6032,39
Modoc,3,2022-01-08,16,16,9,7,95,95,54,41,0
Mono,3,2022-01-08,261,261,118,143,841,842,382,460,1
Monterey,3,2022-01-08,4463,4474,1796,2678,32077,32153,12870,19283,56
Napa,3,2022-01-08,2692,2698,1526,1172,14849,14885,8414,6471,15
Nevada,3,2022-01-08,1104,1104,548,556,4899,4910,2427,2483,15
Orange,3,2022-01-08,61461,61609,34955,26654,313004,313759,178223,135536,907
Placer,3,2022-01-08,4817,4829,2335,2494,21304,21357,10297,11060,165
Plumas,3,2022-01-08,120,120,60,60,784,784,390,394,4
Riverside,3,2022-01-08,47603,47717,24004,23713,185263,185710,93402,92308,851
Sacramento,3,2022-01-08,26615,26680,15055,11625,119987,120278,67736,52542,399
San Benito,3,2022-01-08,963,963,589,374,4320,4330,2651,1679,6
San Bernardino,3,2022-01-08,47533,47647,30255,17392,188528,188984,120044,68940,923
San Diego,3,2022-01-08,85914,86123,69371,16752,343346,344175,277256,66919,943
San Francisco,3,2022-01-08,16289,16329,7530,8799,121373,121666,56218,65448,156
San Joaquin,3,2022-01-08,12927,12958,6996,5962,59827,59971,32318,27653,150
San Luis Obispo,3,2022-01-08,4269,4280,2568,1712,21780,21832,13083,8749,40
San Mateo,3,2022-01-08,15103,15139,10034,5105,114147,114421,75777,38644,97
Santa Barbara,3,2022-01-08,8331,8352,4689,3663,45770,45880,25784,20096,77
Santa Clara,3,2022-01-08,34980,35064,28084,6980,262211,262845,210557,52288,391
Santa Cruz,3,2022-01-08,4357,4368,2728,1640,41804,41904,26144,15760,18
Shasta,3,2022-01-08,991,991,496,495,8244,8264,4121,4143,54
Siskiyou,3,2022-01-08,106,106,65,41,874,875,535,340,5
Solano,3,2022-01-08,6548,6564,3747,2817,35749,35835,20420,15415,88
Sonoma,3,2022-01-08,8379,8398,4765,3633,46913,47027,26602,20425,71
Stanislaus,3,2022-01-08,5967,5981,2718,3263,27067,27132,12279,14853,168
Sutter,3,2022-01-08,1088,1088,590,498,4671,4683,2524,2159,0
Tehama,3,2022-01-08,460,460,197,263,2393,2398,1020,1378,12
Trinity,3,2022-01-08,33,33,16,17,263,263,125,138,0
Tulare,3,2022-01-08,4316,4328,1920,2408,22497,22551,9947,12604,62
Tuolumne,3,2022-01-08,702,702,358,344,4033,4044,2053,1991,14
Ventura,3,2022-01-08,17627,17670,11865,5805,87056,87266,58604,28662,228
Yolo,3,2022-01-08,3969,3979,2455,1524,50702,50823,31341,19482,8
Yuba,3,2022-01-08,925,925,524,401,3807,3816,2158,1658,35
Alameda,4,2022-01-15,26971,27040,19045,7995,185877,186350,131248,55102,402
Amador,4,2022-01-15,491,491,283,208,3823,3832,2203,1629,9
Butte,4,2022-01-15,2113,2118,1560,558,9634,9658,7101,2557,55
Calaveras,4,2022-01-15,612,612,376,236,2724,2730,1679,1051,5
Colusa,4,2022-01-15,165,165,103,62,799,801,499,302,2
Contra Costa,4,2022-01-15,16569,16613,9965,6648,95666,95910,57553,38357,238
Del Norte,4,2022-01-15,201,201,129,72,3970,3979,2551,1428,3
El Dorado,4,2022-01-15,2179,2184,1316,868,9015,9039,5449,3590,16
Fresno,4,2022-01-15,16745,16787,9789,6998,68078,68252,39750,28502,430
Glenn,4,2022-01-15,306,306,194,112,1061,1062,672,390,2
Humboldt,4,2022-01-15,1259,1262,792,470,8891,8914,5606,3308,24
Imperial,4,2022-01-15,3728,3737,2253,1484,14277,14312,8640,5672,94
Inyo,4,2022-01-15,397,397,269,128,1238,1241,841,400,3
Kern,4,2022-01-15,13182,13216,8302,4914,59456,59606,37424,22182,256
Kings,4,2022-01-15,3495,3505,2052,1453,16569,16612,9733,6879,46
Lake,4,2022-01-15,594,594,337,257,3195,3203,1817,1386,4
Lassen,4,2022-01-15,279,279,186,93,3783,3793,2536,1257,1
Los Angeles,4,2022-01-15,249864,250500,216394,34106,1800743,1805330,1560466,244864,4507
Madera,4,2022-01-15,2428,2434,1424,1010,11172,11201,6535,4666,32
Marin,4,2022-01-15,2674,2681,1638,1043,19358,19408,11866,7542,34
Mariposa,4,2022-01-15,189,189,109,80,1227,1232,717,515,0
Mendocino,4,2022-01-15,984,985,489,496,5575,5588,2769,2819,22
Merced,4,2022-01-15,4159,4169,2584,1585,14974,15011,9296,5715,53
Modoc,4,2022-01-15,10,10,6,4,110,110,70,40,0
Mono,4,2022-01-15,235,235,123,112,856,857,452,405,1
Monterey,4,2022-01-15,6067,6083,2883,3200,30168,30244,14270,15974,74
Napa,4,2022-01-15,2193,2198,1395,803,13379,13413,8513,4900,24
Nevada,4,2022-01-15,1315,1319,749,570,5720,5734,3248,2486,23
Orange,4,2022-01-15,47124,47245,30064,17181,282165,282883,180219,102664,1200
Placer,4,2022-01-15,4750,4762,2635,2127,21335,21389,11836,9553,207
Plumas,4,2022-01-15,186,186,105,81,806,807,457,350,4
Riverside,4,2022-01-15,45513,45629,26242,19387,182828,183294,105513,77781,1006
Sacramento,4,2022-01-15,23568,23628,14953,8675,111605,111889,70786,41103,533
San Benito,4,2022-01-15,945,945,639,306,4434,4445,3014,1431,8
San Bernardino,4,2022-01-15,42403,42511,29693,12818,181923,182387,127587,54800,1100
San Diego,4,2022-01-15,67473,67645,57309,10336,286890,287620,243765,43855,1206
San Francisco,4,2022-01-15,11816,11848,6341,5507,100552,100809,53968,46841,230
San Joaquin,4,2022-01-15,14287,14323,8717,5606,65111,65276,39725,25551,239
San Luis Obispo,4,2022-01-15,4101,4111,2742,1369,22532,22589,15067,7522,42
San Mateo,4,2022-01-15,13879,13914,10076,3838,109050,109327,79173,30154,111
Santa Barbara,4,2022-01-15,7602,7621,4805,2816,44892,45006,28408,16598,122
Santa Clara,4,2022-01-15,31570,31651,26685,4966,252856,253499,213766,39733,494
Santa Cruz,4,2022-01-15,4371,4382,3023,1359,45085,45199,31200,13999,34
Shasta,4,2022-01-15,1315,1320,759,561,9714,9739,5573,4166,74
Siskiyou,4,2022-01-15,160,160,109,51,1051,1054,712,342,5
Solano,4,2022-01-15,7018,7037,4512,2525,38497,38596,24719,13877,129
Sonoma,4,2022-01-15,8155,8175,5197,2978,46854,46974,29854,17120,91
Stanislaus,4,2022-01-15,7651,7670,4029,3641,30904,30981,16245,14736,219
Sutter,4,2022-01-15,1369,1374,838,536,5157,5171,3148,2023,0
Tehama,4,2022-01-15,634,634,317,317,2607,2612,1299,1313,15
Trinity,4,2022-01-15,43,43,23,20,272,272,148,124,0
Tulare,4,2022-01-15,7574,7593,3909,3684,28160,28231,14504,13727,96
Tuolumne,4,2022-01-15,941,941,547,394,4437,4449,2580,1869,9
Ventura,4,2022-01-15,13864,13901,10162,3739,76337,76532,55971,20561,338
Yolo,4,2022-01-15,3141,3150,2150,1000,43894,44007,30085,13922,18
Yuba,4,2022-01-15,1105,1106,700,406,4012,4023,2546,1477,37
Alameda,5,2022-01-22,20509,20565,15666,4899,161681,162121,123626,38495,446
Amador,5,2022-01-22,561,561,363,198,4340,4352,2822,1530,11
Butte,5,2022-01-22,1952,1957,1544,413,8698,8720,6882,1838,88
Calaveras,5,2022-01-22,594,594,406,188,2441,2447,1671,776,7
Colusa,5,2022-01-22,160,160,110,50,810,811,560,251,5
Contra Costa,5,2022-01-22,13207,13241,8847,4394,81277,81498,54537,26961,302
Del Norte,5,2022-01-22,298,298,211,87,3830,3840,2710,1130,2
El Dorado,5,2022-01-22,1546,1551,1042,509,7237,7256,4877,2379,28
Fresno,5,2022-01-22,17599,17645,11490,6155,67808,67992,44308,23684,554
Glenn,5,2022-01-22,252,252,176,76,927,929,648,281,0
Humboldt,5,2022-01-22,981,982,682,300,7465,7487,5206,2281,22
Imperial,5,2022-01-22,3538,3548,2387,1161,12770,12805,8616,4189,85
Inyo,5,2022-01-22,158,158,117,41,609,609,449,160,1
Kern,5,2022-01-22,10695,10723,7456,3267,50519,50657,35244,15413,319
Kings,5,2022-01-22,4081,4093,2682,1411,16944,16991,11147,5844,43
Lake,5,2022-01-22,684,684,435,249,3180,3187,2020,1167,9
Lassen,5,2022-01-22,431,431,315,116,3492,3502,2554,948,1
Los Angeles,5,2022-01-22,171848,172315,154264,18051,1532664,1536834,1376964,159870,4569
Madera,5,2022-01-22,2758,2765,1808,957,11431,11462,7482,3980,54
Marin,5,2022-01-22,1958,1963,1332,631,17037,17084,11610,5474,51
Mariposa,5,2022-01-22,149,149,97,52,940,942,614,328,0
Mendocino,5,2022-01-22,962,963,548,415,4825,4839,2757,2082,22
Merced,5,2022-01-22,3186,3194,2192,1002,12392,12426,8535,3891,61
Modoc,5,2022-01-22,16,16,11,5,104,104,73,31,0
Mono,5,2022-01-22,97,97,58,39,462,462,276,186,1
Monterey,5,2022-01-22,5324,5337,2912,2425,31409,31495,17214,14281,102
Napa,5,2022-01-22,1704,1709,1198,511,11814,11846,8314,3532,24
Nevada,5,2022-01-22,1045,1047,667,380,4756,4769,3036,1733,26
Orange,5,2022-01-22,29969,30049,21084,8965,225866,226481,159360,67121,1162
Placer,5,2022-01-22,3829,3840,2402,1438,18215,18265,11428,6837,257
Plumas,5,2022-01-22,218,218,138,80,883,884,561,323,6
Riverside,5,2022-01-22,33747,33838,21846,11992,156240,156666,101278,55388,1048
Sacramento,5,2022-01-22,17926,17974,12557,5417,94891,95150,66538,28612,614
San Benito,5,2022-01-22,852,852,630,222,3958,3970,2939,1031,8
San Bernardino,5,2022-01-22,28573,28651,21707,6944,147877,148279,112493,35786,1207
San Diego,5,2022-01-22,53887,54034,47656,6378,247072,247744,218600,29144,1309
San Francisco,5,2022-01-22,8888,8912,5397,3515,86773,87009,52863,34146,278
San Joaquin,5,2022-01-22,11251,11282,7639,3643,56101,56253,38090,18163,296
San Luis Obispo,5,2022-01-22,3595,3604,2626,978,20759,20815,15183,5632,51
San Mateo,5,2022-01-22,9290,9315,7255,2060,90615,90861,70923,19938,154
Santa Barbara,5,2022-01-22,6569,6587,4594,1993,41115,41227,28780,12447,141
Santa Clara,5,2022-01-22,23348,23411,20572,2839,220213,220811,194137,26674,515
Santa Cruz,5,2022-01-22,5315,5330,4012,1318,48508,48640,36676,11964,43
Shasta,5,2022-01-22,1453,1458,938,520,9453,9478,6092,3386,81
Siskiyou,5,2022-01-22,156,156,115,41,821,823,606,217,6
Solano,5,2022-01-22,5039,5053,3565,1488,30893,30977,21853,9124,155
Sonoma,5,2022-01-22,7220,7240,5080,2160,41261,41374,29038,12336,106
Stanislaus,5,2022-01-22,6683,6702,4005,2697,27827,27902,16675,11227,303
Sutter,5,2022-01-22,1109,1112,753,359,4983,4996,3385,1611,0
Tehama,5,2022-01-22,577,577,329,248,2446,2452,1402,1050,20
Trinity,5,2022-01-22,66,66,41,25,311,311,192,119,0
Tulare,5,2022-01-22,7841,7863,4614,3249,28381,28458,16707,11751,130
Tuolumne,5,2022-01-22,888,888,578,310,3586,3597,2342,1255,17
Ventura,5,2022-01-22,9890,9917,7796,2121,64467,64642,50881,13761,355
Yolo,5,2022-01-22,2317,2322,1726,596,38323,38428,28627,9801,24
Yuba,5,2022-01-22,938,939,656,283,3727,3738,2613,1125,65
Alameda,6,2022-01-29,12528,12566,10175,2391,143347,143767,116497,27270,417
Amador,6,2022-01-29,364,364,258,106,3262,3272,2326,946,18
Butte,6,2022-01-29,1279,1283,1069,214,7910,7933,6608,1325,101
Calaveras,6,2022-01-29,282,282,208,74,1919,1924,1426,498,4
Colusa,6,2022-01-29,118,118,88,30,685,685,513,172,2
Contra Costa,6,2022-01-29,8239,8263,6009,2254,72227,72438,52816,19622,285
Del Norte,6,2022-01-29,357,357,272,85,4128,4140,3154,986,9
El Dorado,6,2022-01-29,840,841,615,226,6180,6200,4542,1658,20
Fresno,6,2022-01-29,12083,12119,8647,3472,58421,58592,41824,16768,586
Glenn,6,2022-01-29,208,208,157,51,762,763,576,187,4
Humboldt,6,2022-01-29,614,614,462,152,6164,6182,4651,1531,26
Imperial,6,2022-01-29,2542,2550,1863,687,12246,12281,8995,3286,103
Inyo,6,2022-01-29,66,66,52,14,507,507,400,107,4
Kern,6,2022-01-29,6423,6442,4843,1599,43961,44090,33185,10905,304
Kings,6,2022-01-29,2773,2781,1991,790,15067,15110,10824,4286,52
Lake,6,2022-01-29,561,561,391,170,3393,3404,2379,1025,10
Lassen,6,2022-01-29,347,347,272,75,3643,3654,2856,798,5
Los Angeles,6,2022-01-29,88316,88573,81403,7170,1339032,1342960,1235068,107892,3852
Madera,6,2022-01-29,1818,1823,1303,520,9844,9873,7050,2823,52
Marin,6,2022-01-29,1223,1227,905,322,14265,14307,10565,3742,48
Mariposa,6,2022-01-29,106,106,76,30,867,869,622,247,0
Mendocino,6,2022-01-29,542,542,345,197,3602,3613,2306,1307,14
Merced,6,2022-01-29,2298,2304,1714,590,10959,10990,8189,2801,64
Modoc,6,2022-01-29,12,12,9,3,98,98,74,24,2
Mono,6,2022-01-29,42,42,28,14,344,344,230,114,0
Monterey,6,2022-01-29,3862,3875,2387,1488,26896,26975,16636,10339,113
Napa,6,2022-01-29,1126,1129,855,274,9854,9882,7489,2393,22
Nevada,6,2022-01-29,676,676,472,204,4139,4150,2905,1245,30
Orange,6,2022-01-29,14345,14387,10909,3478,185332,185875,141223,44652,967
Placer,6,2022-01-29,2578,2586,1783,803,15848,15895,10972,4923,215
Plumas,6,2022-01-29,154,154,107,47,750,751,524,227,2
Riverside,6,2022-01-29,19206,19263,13625,5638,127214,127587,90470,37117,952
Sacramento,6,2022-01-29,11758,11793,8902,2891,81559,81798,61842,19956,588
San Benito,6,2022-01-29,526,526,416,110,3369,3379,2676,703,7
San Bernardino,6,2022-01-29,15546,15593,12567,3026,122436,122795,99161,23634,1004
San Diego,6,2022-01-29,29237,29323,26637,2686,193236,193801,176141,17660,1210
San Francisco,6,2022-01-29,4945,4960,3327,1633,75168,75389,50794,24595,259
San Joaquin,6,2022-01-29,6491,6511,4791,1720,45318,45451,33456,11995,306
San Luis Obispo,6,2022-01-29,2305,2311,1805,506,17373,17424,13626,3798,67
San Mateo,6,2022-01-29,5101,5116,4217,899,79527,79760,65853,13907,155
Santa Barbara,6,2022-01-29,4284,4296,3235,1061,36540,36647,27652,8995,112
Santa Clara,6,2022-01-29,15812,15858,14370,1488,209915,210529,190913,19616,518
Santa Cruz,6,2022-01-29,3559,3571,2860,711,46905,47043,37795,9248,45
Shasta,6,2022-01-29,1081,1083,763,320,8675,8701,6136,2565,82
Siskiyou,6,2022-01-29,125,125,99,26,699,700,552,148,13
Solano,6,2022-01-29,4155,4168,3180,988,29983,30072,22923,7149,165
Sonoma,6,2022-01-29,4224,4237,3206,1031,33736,33835,25637,8198,101
Stanislaus,6,2022-01-29,4097,4109,2728,1381,22822,22888,15211,7677,321
Sutter,6,2022-01-29,702,702,517,185,3940,3953,2911,1042,0
Tehama,6,2022-01-29,405,405,259,146,2160,2166,1385,781,22
Trinity,6,2022-01-29,39,39,27,12,221,221,150,71,0
Tulare,6,2022-01-29,5359,5375,3515,1860,24542,24614,16113,8501,149
Tuolumne,6,2022-01-29,829,832,592,240,3419,3429,2444,985,19
Ventura,6,2022-01-29,5574,5590,4639,951,55445,55607,46200,9407,312
Yolo,6,2022-01-29,1578,1583,1256,327,37795,37907,30178,7729,21
Yuba,6,2022-01-29,611,611,461,150,3072,3082,2329,753,75
Alameda,7,2022-02-05,6829,6850,5826,1024,121431,121814,103744,18070,347
Amador,7,2022-02-05,239,239,182,57,3060,3069,2350,719,16
Butte,7,2022-02-05,865,867,754,113,6583,6604,5746,858,85
Calaveras,7,2022-02-05,212,212,168,44,1565,1570,1244,326,2
Colusa,7,2022-02-05,89,89,71,18,569,570,454,116,4
Contra Costa,7,2022-02-05,4511,4525,3539,986,57645,57827,45292,12535,239
Del Norte,7,2022-02-05,240,240,195,45,3891,3903,3163,740,7
El Dorado,7,2022-02-05,501,501,393,108,5151,5167,4059,1108,29
Fresno,7,2022-02-05,7101,7124,5481,1643,45935,46080,35482,10598,561
Glenn,7,2022-02-05,138,138,111,27,641,642,516,126,4
Humboldt,7,2022-02-05,492,492,395,97,5034,5051,4056,995,21
Imperial,7,2022-02-05,1281,1285,1008,277,8871,8898,6992,1906,81
Inyo,7,2022-02-05,52,52,43,9,448,448,373,75,3
Kern,7,2022-02-05,3917,3929,3154,775,36332,36446,29276,7170,233
Kings,7,2022-02-05,1509,1514,1168,346,10783,10817,8353,2464,57
Lake,7,2022-02-05,387,387,293,94,2746,2753,2085,668,9
Lassen,7,2022-02-05,156,156,129,27,3202,3212,2657,555,5
Los Angeles,7,2022-02-05,43776,43915,41209,2706,1182258,1185985,1113569,72416,2841
Madera,7,2022-02-05,1234,1238,953,285,8417,8442,6505,1937,51
Marin,7,2022-02-05,719,719,569,150,12080,12118,9584,2534,33
Mariposa,7,2022-02-05,56,56,43,13,624,624,480,144,0
Mendocino,7,2022-02-05,353,353,248,105,2985,2995,2106,889,18
Merced,7,2022-02-05,1336,1340,1066,274,8425,8451,6733,1718,64
Modoc,7,2022-02-05,22,22,18,4,159,159,129,30,3
Mono,7,2022-02-05,46,46,33,13,270,270,196,74,0
Monterey,7,2022-02-05,2483,2490,1700,790,23044,23117,15785,7332,96
Napa,7,2022-02-05,791,793,641,152,8029,8054,6504,1550,23
Nevada,7,2022-02-05,396,396,300,96,3288,3299,2502,797,27
Orange,7,2022-02-05,7346,7369,5958,1411,156198,156691,126851,29840,627
Placer,7,2022-02-05,1518,1524,1140,384,12794,12834,9610,3224,184
Plumas,7,2022-02-05,99,99,75,24,575,576,434,142,1
Riverside,7,2022-02-05,9478,9507,7272,2235,100184,100499,76961,23538,720
Sacramento,7,2022-02-05,6915,6936,5590,1346,66336,66545,53660,12885,502
San Benito,7,2022-02-05,333,333,278,55,2818,2827,2363,464,8
San Bernardino,7,2022-02-05,7956,7980,6767,1213,94384,94682,80390,14292,720
San Diego,7,2022-02-05,15749,15798,14697,1101,158233,158732,147734,10998,991
San Francisco,7,2022-02-05,2647,2655,1950,705,57580,57762,42492,15270,225
San Joaquin,7,2022-02-05,3809,3822,3017,805,38107,38226,30183,8043,250
San Luis Obispo,7,2022-02-05,1429,1434,1187,247,13454,13496,11180,2316,40
San Mateo,7,2022-02-05,2844,2853,2463,390,64201,64404,55657,8747,125
Santa Barbara,7,2022-02-05,2703,2711,2181,530,33544,33650,27101,6549,102
Santa Clara,7,2022-02-05,9072,9101,8449,652,179013,179577,166783,12794,452
Santa Cruz,7,2022-02-05,2106,2112,1781,331,39283,39406,33237,6169,38
Shasta,7,2022-02-05,731,732,559,173,7223,7245,5522,1723,75
Siskiyou,7,2022-02-05,103,103,86,17,704,705,587,118,8
Solano,7,2022-02-05,2521,2529,2047,482,24720,24798,20100,4698,121
Sonoma,7,2022-02-05,2310,2318,1872,446,28059,28147,22741,5406,79
Stanislaus,7,2022-02-05,2802,2811,2042,769,19664,19726,14326,5400,285
Sutter,7,2022-02-05,429,429,338,91,3483,3495,2759,736,0
Tehama,7,2022-02-05,328,328,230,98,1720,1725,1213,512,24
Trinity,7,2022-02-05,24,24,18,6,151,151,111,40,0
Tulare,7,2022-02-05,3125,3135,2248,887,18700,18759,13465,5294,164
Tuolumne,7,2022-02-05,405,405,311,94,2681,2689,2068,621,13
Ventura,7,2022-02-05,3008,3018,2620,398,43497,43634,37890,5744,244
Yolo,7,2022-02-05,966,967,811,156,32578,32680,27424,5256,14
Yuba,7,2022-02-05,388,388,312,76,2519,2527,2036,491,58
Alameda,8,2022-02-12,4001,4014,3550,464,103063,103424,91554,11870,256
Amador,8,2022-02-12,112,112,91,21,2427,2435,1984,451,15
Butte,8,2022-02-12,542,542,488,54,5547,5566,5009,557,76
Calaveras,8,2022-02-12,114,114,95,19,1319,1323,1107,216,6
Colusa,8,2022-02-12,46,46,39,7,518,519,436,83,3
Contra Costa,8,2022-02-12,2700,2710,2245,465,46550,46714,38744,7970,172
Del Norte,8,2022-02-12,253,253,215,38,3671,3682,3131,551,9
El Dorado,8,2022-02-12,304,304,253,51,4674,4689,3896,793,25
Fresno,8,2022-02-12,4271,4286,3505,781,37069,37198,30432,6766,459
Glenn,8,2022-02-12,60,60,51,9,480,481,407,74,4
Humboldt,8,2022-02-12,396,396,335,61,4504,4520,3822,698,19
Imperial,8,2022-02-12,697,698,579,119,6667,6689,5560,1129,68
Inyo,8,2022-02-12,28,28,24,4,409,409,356,53,2
Kern,8,2022-02-12,2411,2420,2046,374,30143,30248,25583,4665,205
Kings,8,2022-02-12,914,917,751,166,8410,8438,6914,1524,52
Lake,8,2022-02-12,261,261,211,50,2426,2433,1963,470,10
Lassen,8,2022-02-12,140,140,122,18,3018,3028,2622,406,3
Los Angeles,8,2022-02-12,24933,25019,23856,1163,1084408,1088207,1037957,50250,2086
Madera,8,2022-02-12,708,709,580,129,7088,7112,5820,1292,44
Marin,8,2022-02-12,427,427,356,71,10406,10442,8730,1712,28
Mariposa,8,2022-02-12,28,28,23,5,436,436,357,79,0
Mendocino,8,2022-02-12,234,234,178,56,2482,2490,1894,596,18
Merced,8,2022-02-12,854,855,718,137,7279,7304,6138,1166,47
Modoc,8,2022-02-12,21,21,18,3,189,189,160,29,0
Mono,8,2022-02-12,14,14,11,3,180,180,140,40,0
Monterey,8,2022-02-12,1442,1447,1074,373,18800,18866,14001,4865,88
Napa,8,2022-02-12,474,474,402,72,6888,6911,5868,1043,17
Nevada,8,2022-02-12,206,206,166,40,2702,2710,2187,523,20
Orange,8,2022-02-12,4473,4487,3816,671,136325,136801,116330,20471,456
Placer,8,2022-02-12,762,763,609,154,10569,10606,8487,2119,141
Plumas,8,2022-02-12,49,49,39,10,441,441,354,87,2
Riverside,8,2022-02-12,5408,5428,4419,1009,79679,79957,65139,14818,503
Sacramento,8,2022-02-12,3938,3951,3349,602,55928,56124,47612,8512,427
San Benito,8,2022-02-12,212,212,184,28,2309,2317,2022,295,7
San Bernardino,8,2022-02-12,4427,4442,3919,523,77419,77689,68608,9081,511
San Diego,8,2022-02-12,9538,9572,9067,505,132350,132811,125833,6978,751
San Francisco,8,2022-02-12,1824,1830,1440,390,49106,49279,38868,10411,183
San Joaquin,8,2022-02-12,2296,2304,1923,381,32471,32585,27181,5404,189
San Luis Obispo,8,2022-02-12,878,882,764,118,10690,10726,9295,1431,30
San Mateo,8,2022-02-12,1562,1568,1403,165,56679,56877,50920,5957,75
Santa Barbara,8,2022-02-12,1283,1289,1091,198,23530,23613,20024,3589,78
Santa Clara,8,2022-02-12,5398,5417,5123,294,159885,160443,151779,8664,366
Santa Cruz,8,2022-02-12,1174,1179,1035,144,34162,34281,30105,4176,33
Shasta,8,2022-02-12,509,509,413,96,6178,6199,5029,1170,78
Siskiyou,8,2022-02-12,79,79,69,10,589,590,513,77,5
Solano,8,2022-02-12,1368,1373,1169,204,20376,20447,17414,3033,96
Sonoma,8,2022-02-12,1374,1379,1170,209,23428,23510,19966,3544,60
Stanislaus,8,2022-02-12,1641,1647,1285,362,16389,16445,12838,3607,242
Sutter,8,2022-02-12,248,248,207,41,2995,3006,2509,497,0
Tehama,8,2022-02-12,197,197,150,47,1453,1458,1111,347,19
Trinity,8,2022-02-12,21,21,17,4,162,162,128,34,0
Tulare,8,2022-02-12,1779,1785,1379,406,16307,16364,12671,3693,146
Tuolumne,8,2022-02-12,221,221,180,41,2349,2357,1926,431,12
Ventura,8,2022-02-12,1809,1816,1631,185,38411,38545,34635,3910,190
Yolo,8,2022-02-12,600,600,524,76,28982,29083,25463,3620,15
Yuba,8,2022-02-12,246,246,208,38,2191,2198,1863,335,41
Alameda,9,2022-02-19,2251,2260,2060,200,90481,90841,82838,8003,191
Amador,9,2022-02-19,91,91,78,13,2160,2169,1855,314,9
Butte,9,2022-02-19,307,307,284,23,4630,4649,4295,354,71
Calaveras,9,2022-02-19,52,52,45,7,957,960,838,122,6
Colusa,9,2022-02-19,29,29,25,4,381,381,335,46,6
Contra Costa,9,2022-02-19,1639,1645,1425,220,39867,40025,34697,5328,117
Del Norte,9,2022-02-19,154,154,136,18,3068,3080,2724,356,9
El Dorado,9,2022-02-19,169,169,147,22,4003,4018,3490,528,10
Fresno,9,2022-02-19,2457,2466,2114,352,30236,30357,26046,4311,360
Glenn,9,2022-02-19,33,33,29,4,405,406,357,49,2
Humboldt,9,2022-02-19,237,237,209,28,3796,3811,3356,455,20
Imperial,9,2022-02-19,456,456,396,60,5336,5356,4657,699,47
Inyo,9,2022-02-19,13,13,12,1,379,380,342,38,1
Kern,9,2022-02-19,1403,1408,1240,168,25885,25988,22900,3088,124
Kings,9,2022-02-19,571,571,491,80,7347,7376,6345,1031,33
Lake,9,2022-02-19,226,226,192,34,2194,2202,1870,332,9
Lassen,9,2022-02-19,143,143,128,15,2379,2389,2141,248,4
Los Angeles,9,2022-02-19,14103,14158,13663,495,986300,990219,955800,34419,1391
Madera,9,2022-02-19,416,416,357,59,5896,5920,5080,840,35
Marin,9,2022-02-19,262,262,228,34,9944,9984,8713,1271,20
Mariposa,9,2022-02-19,20,20,17,3,408,408,350,58,0
Mendocino,9,2022-02-19,140,140,113,27,2244,2252,1825,427,10
Merced,9,2022-02-19,555,556,487,69,5981,6005,5261,744,8
Modoc,9,2022-02-19,10,10,9,1,72,72,64,8,1
Mono,9,2022-02-19,8,8,7,1,172,172,142,30,0
Monterey,9,2022-02-19,902,905,720,185,14925,14985,11917,3068,61
Napa,9,2022-02-19,303,303,267,36,5768,5790,5115,675,10
Nevada,9,2022-02-19,129,129,109,20,2374,2382,2023,359,21
Orange,9,2022-02-19,2862,2873,2540,333,127009,127513,112753,14760,352
Placer,9,2022-02-19,381,381,321,60,9382,9419,7946,1473,114
Plumas,9,2022-02-19,25,25,21,4,384,384,324,60,1
Riverside,9,2022-02-19,2965,2977,2543,434,67149,67416,57679,9737,351
Sacramento,9,2022-02-19,2387,2397,2114,283,48771,48964,43217,5747,319
San Benito,9,2022-02-19,134,134,121,13,2050,2058,1857,201,4
San Bernardino,9,2022-02-19,2307,2316,2107,209,65989,66252,60331,5921,366
San Diego,9,2022-02-19,5508,5531,5311,220,111130,111571,107142,4429,589
San Francisco,9,2022-02-19,1133,1138,947,191,45320,45500,37941,7559,140
San Joaquin,9,2022-02-19,1295,1300,1132,168,27657,27766,24190,3576,129
San Luis Obispo,9,2022-02-19,585,586,526,60,9115,9150,8209,941,26
San Mateo,9,2022-02-19,893,896,823,73,49777,49974,45965,4009,60
Santa Barbara,9,2022-02-19,753,756,666,90,21656,21740,19173,2567,56
Santa Clara,9,2022-02-19,3002,3014,2890,124,139673,140227,134507,5720,296
Santa Cruz,9,2022-02-19,664,666,603,63,28324,28437,25785,2652,24
Shasta,9,2022-02-19,323,323,275,48,5418,5440,4637,803,65
Siskiyou,9,2022-02-19,53,53,48,5,534,535,481,54,11
Solano,9,2022-02-19,776,779,689,90,16728,16796,14874,1922,70
Sonoma,9,2022-02-19,790,792,699,93,18962,19036,16818,2218,40
Stanislaus,9,2022-02-19,916,919,759,160,13532,13586,11242,2344,187
Sutter,9,2022-02-19,156,156,136,20,2410,2419,2107,312,0
Tehama,9,2022-02-19,119,119,96,23,1255,1260,1022,238,14
Trinity,9,2022-02-19,16,16,13,3,224,224,187,37,0
Tulare,9,2022-02-19,963,966,792,174,12433,12481,10247,2234,99
Tuolumne,9,2022-02-19,123,123,105,18,1956,1964,1683,281,7
Ventura,9,2022-02-19,1020,1025,946,79,30905,31028,28624,2404,131
Yolo,9,2022-02-19,334,334,302,32,24102,24198,21888,2310,10
Yuba,9,2022-02-19,159,159,140,19,1791,1798,1586,212,29
Alameda,10,2022-02-26,1487,1494,1394,100,68948,69250,64661,4589,144
Amador,10,2022-02-26,64,64,57,7,1993,2001,1780,221,10
Butte,10,2022-02-26,189,189,178,11,3988,4005,3774,231,48
Calaveras,10,2022-02-26,35,35,32,3,1064,1068,965,103,0
Colusa,10,2022-02-26,11,11,10,1,362,363,329,34,3
Contra Costa,10,2022-02-26,962,967,868,99,31615,31752,28530,3222,85
Del Norte,10,2022-02-26,88,88,80,8,2691,2703,2465,238,6
El Dorado,10,2022-02-26,116,116,104,12,3361,3377,3038,339,9
Fresno,10,2022-02-26,1343,1348,1200,148,25157,25266,22510,2756,268
Glenn,10,2022-02-26,21,21,19,2,376,376,341,35,0
Humboldt,10,2022-02-26,137,137,124,13,2765,2778,2524,254,8
Imperial,10,2022-02-26,268,268,241,27,4532,4551,4094,457,24
Inyo,10,2022-02-26,10,10,9,1,326,327,302,25,0
Kern,10,2022-02-26,881,885,804,81,22363,22460,20415,2045,101
Kings,10,2022-02-26,257,257,229,28,5894,5921,5282,639,21
Lake,10,2022-02-26,126,126,111,15,1809,1816,1605,211,3
Lassen,10,2022-02-26,59,59,54,5,1995,2004,1845,159,1
Los Angeles,10,2022-02-26,8513,8550,8326,224,925198,929252,905312,23940,975
Madera,10,2022-02-26,204,204,182,22,4162,4180,3726,454,26
Marin,10,2022-02-26,146,146,132,14,7113,7145,6447,698,14
Mariposa,10,2022-02-26,34,34,30,4,324,324,288,36,0
Mendocino,10,2022-02-26,77,77,65,12,1713,1719,1465,254,10
Merced,10,2022-02-26,281,281,254,27,4724,4744,4295,449,31
Modoc,10,2022-02-26,6,6,5,1,50,50,45,5,1
Mono,10,2022-02-26,5,5,4,1,166,166,144,22,0
Monterey,10,2022-02-26,415,415,347,68,12743,12799,10750,2049,32
Napa,10,2022-02-26,173,173,158,15,4942,4964,4524,440,8
Nevada,10,2022-02-26,78,78,69,9,1985,1993,1762,231,12
Orange,10,2022-02-26,1855,1863,1698,165,114644,115146,105065,10081,252
Placer,10,2022-02-26,272,272,239,33,7933,7967,7003,964,99
Plumas,10,2022-02-26,26,26,23,3,342,342,301,41,0
Riverside,10,2022-02-26,1787,1795,1595,200,59334,59594,52967,6627,258
Sacramento,10,2022-02-26,1200,1206,1097,109,41221,41402,37701,3701,224
San Benito,10,2022-02-26,60,60,56,4,1583,1589,1472,117,1
San Bernardino,10,2022-02-26,1277,1283,1195,88,56427,56673,52834,3839,221
San Diego,10,2022-02-26,3389,3403,3301,102,93903,94314,91518,2796,450
San Francisco,10,2022-02-26,866,871,758,113,36445,36603,31906,4697,99
San Joaquin,10,2022-02-26,734,738,665,73,23403,23504,21190,2314,90
San Luis Obispo,10,2022-02-26,318,318,293,25,7644,7679,7081,598,16
San Mateo,10,2022-02-26,544,544,511,33,35220,35374,33241,2133,46
Santa Barbara,10,2022-02-26,411,411,374,37,19323,19408,17662,1746,44
Santa Clara,10,2022-02-26,1769,1776,1722,54,83550,83915,81369,2546,241
Santa Cruz,10,2022-02-26,479,480,446,34,23772,23876,22197,1679,19
Shasta,10,2022-02-26,173,173,153,20,4571,4591,4068,523,49
Siskiyou,10,2022-02-26,29,29,27,2,396,396,366,30,6
Solano,10,2022-02-26,484,484,441,43,14219,14282,13037,1245,65
Sonoma,10,2022-02-26,458,458,417,41,15054,15121,13780,1341,25
Stanislaus,10,2022-02-26,513,513,444,69,11908,11959,10360,1599,154
Sutter,10,2022-02-26,104,104,94,10,2211,2221,2003,218,0
Tehama,10,2022-02-26,58,58,49,9,1108,1113,949,164,10
Trinity,10,2022-02-26,6,6,5,1,111,111,97,14,0
Tulare,10,2022-02-26,506,506,435,71,11090,11138,9594,1544,82
Tuolumne,10,2022-02-26,82,82,73,9,1430,1435,1277,158,7
Ventura,10,2022-02-26,614,615,579,36,27337,27456,25853,1603,92
Yolo,10,2022-02-26,214,214,198,16,22507,22606,20979,1627,9
Yuba,10,2022-02-26,79,79,72,7,1703,1709,1555,154,20
Alameda,11,2022-03-05,1162,1168,1108,60,73822,74182,70415,3767,108
Amador,11,2022-03-05,75,75,69,6,1384,1390,1270,120,6
Butte,11,2022-03-05,134,134,128,6,3669,3687,3526,161,31
Calaveras,11,2022-03-05,28,28,26,2,1121,1126,1042,84,1
Colusa,11,2022-03-05,10,10,9,1,344,345,320,25,6
Contra Costa,11,2022-03-05,651,654,603,51,31785,31940,29442,2498,66
Del Norte,11,2022-03-05,54,54,50,4,1859,1868,1742,126,6
El Dorado,11,2022-03-05,91,91,84,7,3261,3277,3023,254,6
Fresno,11,2022-03-05,955,960,879,81,22827,22939,21012,1927,175
Glenn,11,2022-03-05,12,12,11,1,366,367,341,26,1
Humboldt,11,2022-03-05,110,110,102,8,3067,3083,2868,215,8
Imperial,11,2022-03-05,172,172,158,14,4535,4556,4205,351,21
Inyo,11,2022-03-05,9,9,8,1,371,372,350,22,1
Kern,11,2022-03-05,515,516,480,36,21598,21702,20185,1517,78
Kings,11,2022-03-05,165,165,151,14,5082,5106,4682,424,13
Lake,11,2022-03-05,69,69,63,6,1823,1831,1667,164,5
Lassen,11,2022-03-05,83,83,78,5,1824,1833,1721,112,0
Los Angeles,11,2022-03-05,6127,6158,6037,121,888281,892618,875169,17449,755
Madera,11,2022-03-05,131,131,120,11,4124,4143,3796,347,14
Marin,11,2022-03-05,169,169,156,13,7703,7741,7159,582,11
Mariposa,11,2022-03-05,14,14,13,1,304,304,278,26,0
Mendocino,11,2022-03-05,75,75,66,9,1773,1780,1575,205,10
Merced,11,2022-03-05,200,200,185,15,4671,4694,4353,341,25
Modoc,11,2022-03-05,1,1,1,0,52,52,48,4,0
Mono,11,2022-03-05,3,3,3,0,130,130,116,14,1
Monterey,11,2022-03-05,268,268,234,34,11527,11583,10130,1453,21
Napa,11,2022-03-05,200,200,186,14,5017,5041,4697,344,9
Nevada,11,2022-03-05,47,47,43,4,1755,1763,1606,157,5
Orange,11,2022-03-05,1337,1344,1254,90,109587,110122,102706,7416,189
Placer,11,2022-03-05,177,177,160,17,7852,7891,7155,736,77
Plumas,11,2022-03-05,4,4,4,0,274,274,248,26,0
Riverside,11,2022-03-05,1096,1102,1007,95,55183,55454,50702,4752,169
Sacramento,11,2022-03-05,848,853,794,59,40178,40375,37604,2771,161
San Benito,11,2022-03-05,37,37,35,2,1537,1545,1457,88,2
San Bernardino,11,2022-03-05,904,909,862,47,54039,54302,51496,2806,145
San Diego,11,2022-03-05,2512,2524,2468,56,96792,97265,95091,2174,314
San Francisco,11,2022-03-05,680,683,614,69,38174,38360,34537,3823,69
San Joaquin,11,2022-03-05,458,459,424,35,21410,21515,19883,1632,60
San Luis Obispo,11,2022-03-05,302,302,284,18,7482,7519,7070,449,9
San Mateo,11,2022-03-05,566,567,541,26,41692,41896,39961,1935,37
Santa Barbara,11,2022-03-05,220,220,205,15,18204,18292,17025,1267,26
Santa Clara,11,2022-03-05,1513,1520,1485,35,116408,116976,114280,2696,197
Santa Cruz,11,2022-03-05,343,343,324,19,25048,25170,23809,1361,17
Shasta,11,2022-03-05,145,145,132,13,4962,4987,4551,436,41
Siskiyou,11,2022-03-05,19,19,18,1,417,418,393,25,1
Solano,11,2022-03-05,387,387,361,26,13954,14022,13081,941,60
Sonoma,11,2022-03-05,377,377,351,26,15514,15590,14529,1061,29
Stanislaus,11,2022-03-05,315,315,282,33,11172,11226,10058,1168,115
Sutter,11,2022-03-05,87,87,80,7,2020,2030,1877,153,0
Tehama,11,2022-03-05,50,50,44,6,1201,1207,1069,138,8
Trinity,11,2022-03-05,6,6,5,1,111,111,100,11,0
Tulare,11,2022-03-05,343,343,306,37,10309,10358,9245,1113,46
Tuolumne,11,2022-03-05,54,54,49,5,1285,1290,1181,109,3
Ventura,11,2022-03-05,415,415,397,18,27245,27376,26161,1215,55
Yolo,11,2022-03-05,169,169,160,9,22594,22706,21447,1259,6
Yuba,11,2022-03-05,68,68,63,5,1618,1626,1514,112,18
Alameda,12,2022-03-12,965,971,933,38,68651,69013,66373,2640,78
Amador,12,2022-03-12,32,32,30,2,1460,1467,1371,96,5
Butte,12,2022-03-12,72,72,70,2,3444,3462,3348,114,19
Calaveras,12,2022-03-12,17,17,16,1,1052,1057,997,60,1
Colusa,12,2022-03-12,6,6,6,0,253,253,239,14,2
Contra Costa,12,2022-03-12,592,595,560,35,29188,29341,27601,1740,31
Del Norte,12,2022-03-12,44,44,42,2,1466,1473,1397,76,5
El Dorado,12,2022-03-12,53,53,50,3,3049,3065,2885,180,7
Fresno,12,2022-03-12,614,617,578,39,21804,21919,20520,1399,145
Glenn,12,2022-03-12,17,17,16,1,320,321,304,17,1
Humboldt,12,2022-03-12,63,63,60,3,2778,2794,2646,148,4
Imperial,12,2022-03-12,88,88,83,5,4670,4694,4418,276,13
Inyo,12,2022-03-12,10,10,10,0,165,165,158,7,0
Kern,12,2022-03-12,315,315,298,17,20080,20185,19119,1066,60
Kings,12,2022-03-12,218,218,204,14,4835,4861,4555,306,16
Lake,12,2022-03-12,65,65,61,4,1599,1607,1497,110,0
Lassen,12,2022-03-12,25,25,24,1,1502,1509,1439,70,0
Los Angeles,12,2022-03-12,4339,4362,4298,64,847877,852354,839898,12456,520
Madera,12,2022-03-12,83,83,78,5,3713,3731,3493,238,15
Marin,12,2022-03-12,162,162,153,9,6643,6679,6298,381,6
Mariposa,12,2022-03-12,8,8,7,1,223,223,209,14,0
Mendocino,12,2022-03-12,41,41,37,4,1481,1487,1356,131,5
Merced,12,2022-03-12,144,144,136,8,4221,4243,4010,233,25
Modoc,12,2022-03-12,3,3,3,0,56,56,53,3,1
Mono,12,2022-03-12,2,2,2,0,106,106,97,9,0
Monterey,12,2022-03-12,181,181,163,18,10341,10396,9393,1003,17
Napa,12,2022-03-12,149,149,141,8,4290,4312,4088,224,7
Nevada,12,2022-03-12,51,51,48,3,1588,1595,1487,108,3
Orange,12,2022-03-12,936,942,894,48,102409,102949,97707,5242,150
Placer,12,2022-03-12,158,158,147,11,7553,7593,7054,539,68
Plumas,12,2022-03-12,10,10,9,1,313,313,291,22,0
Riverside,12,2022-03-12,781,786,735,51,51386,51658,48294,3364,116
Sacramento,12,2022-03-12,626,628,595,33,37198,37395,35449,1946,134
San Benito,12,2022-03-12,26,26,25,1,1448,1455,1393,62,2
San Bernardino,12,2022-03-12,609,612,588,24,51103,51373,49370,2003,119
San Diego,12,2022-03-12,2006,2016,1982,34,96795,97305,95675,1630,225
San Francisco,12,2022-03-12,587,589,544,45,35041,35228,32549,2679,41
San Joaquin,12,2022-03-12,316,316,298,18,20442,20549,19367,1182,41
San Luis Obispo,12,2022-03-12,163,163,156,7,6985,7022,6704,318,6
San Mateo,12,2022-03-12,467,467,451,16,37440,37638,36332,1306,29
Santa Barbara,12,2022-03-12,193,193,183,10,17575,17668,16743,925,20
Santa Clara,12,2022-03-12,1138,1145,1125,20,101383,101918,100163,1755,131
Santa Cruz,12,2022-03-12,247,247,237,10,23057,23178,22232,946,11
Shasta,12,2022-03-12,105,105,98,7,4938,4964,4632,332,21
Siskiyou,12,2022-03-12,17,17,16,1,400,401,383,18,0
Solano,12,2022-03-12,244,244,232,12,12983,13052,12388,664,44
Sonoma,12,2022-03-12,235,235,223,12,13966,14040,13316,724,16
Stanislaus,12,2022-03-12,247,247,227,20,10206,10259,9443,816,106
Sutter,12,2022-03-12,56,56,53,3,1806,1815,1711,104,0
Tehama,12,2022-03-12,27,27,25,2,997,1002,914,88,1
Trinity,12,2022-03-12,2,2,2,0,97,97,90,7,0
Tulare,12,2022-03-12,211,211,193,18,9771,9822,9013,809,37
Tuolumne,12,2022-03-12,29,29,27,2,1246,1251,1170,81,2
Ventura,12,2022-03-12,352,352,340,12,25156,25289,24442,847,40
Yolo,12,2022-03-12,132,132,126,6,21587,21701,20793,908,4
Yuba,12,2022-03-12,44,44,42,2,1446,1452,1376,76,12
Alameda,13,2022-03-19,694,699,679,20,67207,67616,65670,1946,58
Amador,13,2022-03-19,29,29,28,1,1388,1397,1328,69,2
Butte,13,2022-03-19,85,85,83,2,2984,3001,2927,74,17
Calaveras,13,2022-03-19,14,14,13,1,655,659,631,28,0
Colusa,13,2022-03-19,1,1,1,0,241,241,231,10,2
Contra Costa,13,2022-03-19,465,467,446,21,27737,27906,26654,1252,41
Del Norte,13,2022-03-19,19,19,18,1,1282,1290,1240,50,2
El Dorado,13,2022-03-19,41,41,39,2,2826,2844,2718,126,2
Fresno,13,2022-03-19,349,349,332,17,19949,20070,19100,970,101
Glenn,13,2022-03-19,8,8,8,0,339,340,326,14,1
Humboldt,13,2022-03-19,35,35,34,1,2378,2394,2299,95,7
Imperial,13,2022-03-19,62,62,59,3,4058,4082,3901,181,9
Inyo,13,2022-03-19,1,1,1,0,156,156,151,5,0
Kern,13,2022-03-19,218,218,209,9,19393,19511,18732,779,40
Kings,13,2022-03-19,75,75,71,4,4410,4435,4223,212,6
Lake,13,2022-03-19,20,20,19,1,1447,1455,1380,75,0
Lassen,13,2022-03-19,10,10,10,0,1528,1538,1484,54,0
Los Angeles,13,2022-03-19,3982,4006,3962,44,826581,831618,822534,9084,422
Madera,13,2022-03-19,46,46,44,2,3419,3439,3274,165,13
Marin,13,2022-03-19,148,148,142,6,6362,6400,6124,276,7
Mariposa,13,2022-03-19,8,8,8,0,246,246,234,12,0
Mendocino,13,2022-03-19,31,31,29,2,1498,1506,1406,100,5
Merced,13,2022-03-19,98,98,94,4,3903,3927,3764,163,16
Modoc,13,2022-03-19,2,2,2,0,51,51,49,2,0
Mono,13,2022-03-19,2,2,2,0,131,131,123,8,1
Monterey,13,2022-03-19,150,150,139,11,10217,10278,9523,755,19
Napa,13,2022-03-19,65,65,62,3,3532,3554,3415,139,8
Nevada,13,2022-03-19,26,26,25,1,1539,1548,1468,80,1
Orange,13,2022-03-19,752,757,728,29,98294,98892,95093,3799,132
Placer,13,2022-03-19,110,110,104,6,6549,6588,6233,355,40
Plumas,13,2022-03-19,2,2,2,0,223,223,211,12,0
Riverside,13,2022-03-19,670,675,642,33,54673,55006,52289,2717,98
Sacramento,13,2022-03-19,469,471,453,18,32735,32935,31647,1288,113
San Benito,13,2022-03-19,26,26,25,1,1401,1408,1363,45,2
San Bernardino,13,2022-03-19,484,487,473,14,51402,51715,50200,1515,86
San Diego,13,2022-03-19,1536,1546,1527,19,88326,88862,87748,1114,203
San Francisco,13,2022-03-19,653,659,621,38,33550,33756,31810,1946,40
San Joaquin,13,2022-03-19,231,231,221,10,15549,15643,14964,679,34
San Luis Obispo,13,2022-03-19,114,114,110,4,6679,6719,6491,228,3
San Mateo,13,2022-03-19,383,383,373,10,34157,34365,33472,893,28
Santa Barbara,13,2022-03-19,180,180,173,7,16141,16239,15598,641,17
Santa Clara,13,2022-03-19,1021,1028,1015,13,94811,95388,94164,1224,125
Santa Cruz,13,2022-03-19,212,212,205,7,20686,20812,20173,639,10
Shasta,13,2022-03-19,56,56,53,3,4332,4358,4137,221,1
Siskiyou,13,2022-03-19,9,9,9,0,360,360,348,12,1
Solano,13,2022-03-19,195,195,187,8,11623,11694,11247,447,22
Sonoma,13,2022-03-19,225,225,216,9,13337,13420,12900,520,14
Stanislaus,13,2022-03-19,154,154,145,9,8611,8663,8142,521,72
Sutter,13,2022-03-19,30,30,29,1,1488,1496,1431,65,0
Tehama,13,2022-03-19,9,9,8,1,926,931,869,62,1
Trinity,13,2022-03-19,1,1,1,0,96,96,90,6,0
Tulare,13,2022-03-19,129,129,121,8,8465,8517,7984,533,30
Tuolumne,13,2022-03-19,18,18,17,1,1167,1173,1115,58,2
Ventura,13,2022-03-19,288,288,281,7,23861,24006,23403,603,35
Yolo,13,2022-03-19,97,97,94,3,22347,22484,21777,707,4
Yuba,13,2022-03-19,34,34,33,1,1326,1334,1282,52,7
Alameda,14,2022-03-26,877,885,866,19,59342,59766,58476,1290,52
Amador,14,2022-03-26,11,11,11,0,1311,1320,1270,50,3
Butte,14,2022-03-26,69,69,68,1,2731,2750,2699,51,14
Calaveras,14,2022-03-26,14,14,14,0,601,606,587,19,0
Colusa,14,2022-03-26,4,4,4,0,197,197,191,6,0
Contra Costa,14,2022-03-26,508,512,495,17,24836,25013,24169,844,32
Del Norte,14,2022-03-26,17,17,16,1,1036,1042,1012,30,0
El Dorado,14,2022-03-26,51,51,49,2,2789,2809,2715,94,0
Fresno,14,2022-03-26,305,306,295,11,18558,18691,18010,681,95
Glenn,14,2022-03-26,7,7,7,0,308,309,300,9,0
Humboldt,14,2022-03-26,27,27,26,1,2594,2613,2534,79,5
Imperial,14,2022-03-26,54,54,52,2,3704,3731,3606,125,7
Inyo,14,2022-03-26,3,3,3,0,164,164,160,4,1
Kern,14,2022-03-26,153,153,148,5,18452,18583,18024,559,26
Kings,14,2022-03-26,65,65,63,2,4404,4436,4277,159,2
Lake,14,2022-03-26,13,13,12,1,1149,1156,1111,45,0
Lassen,14,2022-03-26,6,6,6,0,1361,1371,1335,36,0
Los Angeles,14,2022-03-26,4349,4379,4343,36,787491,793123,786661,6462,341
Madera,14,2022-03-26,24,24,23,1,3366,3390,3267,123,4
Marin,14,2022-03-26,166,166,161,5,5896,5938,5746,192,3
Mariposa,14,2022-03-26,6,6,6,0,178,178,171,7,0
Mendocino,14,2022-03-26,29,29,28,1,1290,1299,1233,66,0
Merced,14,2022-03-26,64,64,62,2,3337,3361,3256,105,12
Modoc,14,2022-03-26,2,2,2,0,52,52,50,2,0
Mono,14,2022-03-26,3,3,3,0,132,132,126,6,0
Monterey,14,2022-03-26,164,164,155,9,9445,9512,8982,530,19
Napa,14,2022-03-26,62,62,60,2,3331,3354,3256,98,1
Nevada,14,2022-03-26,25,25,24,1,1476,1486,1428,58,1
Orange,14,2022-03-26,798,804,781,23,90151,90795,88177,2618,100
Placer,14,2022-03-26,113,113,108,5,6158,6202,5950,252,33
Plumas,14,2022-03-26,2,2,2,0,272,273,262,11,0
Riverside,14,2022-03-26,518,523,504,19,44568,44887,43222,1665,75
Sacramento,14,2022-03-26,463,467,453,14,31677,31904,30964,940,96
San Benito,14,2022-03-26,10,10,10,0,1305,1313,1281,32,0
San Bernardino,14,2022-03-26,494,499,488,11,41279,41574,40661,913,69
San Diego,14,2022-03-26,1327,1337,1325,12,74035,74562,73865,697,155
San Francisco,14,2022-03-26,768,774,740,34,32751,32987,31551,1436,30
San Joaquin,14,2022-03-26,193,193,187,6,16613,16732,16187,545,31
San Luis Obispo,14,2022-03-26,98,98,95,3,5878,5920,5770,150,5
San Mateo,14,2022-03-26,510,513,503,10,34367,34613,33938,675,28
Santa Barbara,14,2022-03-26,120,120,116,4,8878,8942,8678,264,21
Santa Clara,14,2022-03-26,1224,1232,1220,12,91029,91682,90805,877,102
Santa Cruz,14,2022-03-26,136,136,133,3,18709,18843,18410,433,7
Shasta,14,2022-03-26,41,41,39,2,3902,3928,3778,150,8
Siskiyou,14,2022-03-26,8,8,8,0,305,306,298,8,0
Solano,14,2022-03-26,157,157,153,4,10920,10999,10682,317,26
Sonoma,14,2022-03-26,232,232,225,7,8218,8276,8036,240,14
Stanislaus,14,2022-03-26,127,127,121,6,8025,8082,7714,368,41
Sutter,14,2022-03-26,27,27,26,1,1516,1528,1478,50,0
Tehama,14,2022-03-26,14,14,13,1,808,813,772,41,2
Trinity,14,2022-03-26,0,0,0,0,102,102,97,5,0
Tulare,14,2022-03-26,95,95,90,5,7870,7926,7552,374,19
Tuolumne,14,2022-03-26,9,9,9,0,1113,1121,1080,41,3
Ventura,14,2022-03-26,332,332,326,6,21753,21909,21498,411,23
Yolo,14,2022-03-26,98,98,96,2,17164,17287,16880,407,3
Yuba,14,2022-03-26,34,34,33,1,1254,1263,1226,37,3
Alameda,15,2022-04-02,958,965,950,15,58364,58850,57900,950,37
Amador,15,2022-04-02,4,4,4,0,1181,1191,1157,34,1
Butte,15,2022-04-02,50,50,49,1,2484,2504,2469,35,10
Calaveras,15,2022-04-02,12,12,12,0,586,591,577,14,0
Colusa,15,2022-04-02,4,4,4,0,199,199,194,5,0
Contra Costa,15,2022-04-02,547,552,538,14,24565,24769,24141,628,20
Del Norte,15,2022-04-02,11,11,11,0,1126,1136,1111,25,0
El Dorado,15,2022-04-02,52,52,51,1,2781,2804,2734,70,2
Fresno,15,2022-04-02,199,199,194,5,17048,17190,16720,470,75
Glenn,15,2022-04-02,5,5,5,0,261,262,256,6,0
Humboldt,15,2022-04-02,21,21,21,0,2510,2531,2474,57,5
Imperial,15,2022-04-02,55,55,54,1,3480,3510,3422,88,6
Inyo,15,2022-04-02,8,8,8,0,182,182,179,3,0
Kern,15,2022-04-02,163,163,159,4,17198,17342,16951,391,23
Kings,15,2022-04-02,49,49,48,1,4156,4191,4078,113,3
Lake,15,2022-04-02,12,12,12,0,986,993,964,29,0
Lassen,15,2022-04-02,4,4,4,0,1218,1229,1205,24,0
Los Angeles,15,2022-04-02,5047,5088,5057,31,732951,739078,734624,4454,288
Madera,15,2022-04-02,28,28,27,1,3276,3304,3214,90,5
Marin,15,2022-04-02,155,155,151,4,6561,6616,6456,160,2
Mariposa,15,2022-04-02,5,5,5,0,215,215,209,6,0
Mendocino,15,2022-04-02,26,26,25,1,1253,1266,1217,49,0
Merced,15,2022-04-02,58,58,57,1,3287,3314,3236,78,4
Modoc,15,2022-04-02,4,4,4,0,42,42,41,1,0
Mono,15,2022-04-02,1,1,1,0,154,154,149,5,0
Monterey,15,2022-04-02,126,126,121,5,7545,7607,7288,319,11
Napa,15,2022-04-02,59,59,58,1,3254,3281,3209,72,3
Nevada,15,2022-04-02,28,28,27,1,1402,1414,1373,41,0
Orange,15,2022-04-02,902,909,890,19,88528,89265,87333,1932,72
Placer,15,2022-04-02,124,124,120,4,6580,6634,6432,202,29
Plumas,15,2022-04-02,4,4,4,0,233,234,227,7,0
Riverside,15,2022-04-02,604,611,594,17,39298,39623,38515,1108,51
Sacramento,15,2022-04-02,432,437,427,10,32793,33067,32336,731,63
San Benito,15,2022-04-02,13,13,13,0,1229,1238,1216,22,0
San Bernardino,15,2022-04-02,587,592,582,10,41641,41988,41297,691,35
San Diego,15,2022-04-02,1504,1516,1506,10,65989,66539,66075,464,133
San Francisco,15,2022-04-02,963,970,938,32,28742,28981,28027,954,25
San Joaquin,15,2022-04-02,209,209,204,5,16049,16182,15783,399,16
San Luis Obispo,15,2022-04-02,101,101,99,2,5599,5647,5539,108,4
San Mateo,15,2022-04-02,648,654,645,9,29625,29872,29436,436,16
Santa Barbara,15,2022-04-02,177,177,173,4,15223,15349,15008,341,11
Santa Clara,15,2022-04-02,1401,1413,1403,10,91284,92042,91382,660,102
Santa Cruz,15,2022-04-02,188,188,185,3,20063,20230,19880,350,5
Shasta,15,2022-04-02,25,25,24,1,3527,3554,3452,102,5
Siskiyou,15,2022-04-02,4,4,4,0,313,314,308,6,0
Solano,15,2022-04-02,165,165,161,4,10415,10500,10272,228,26
Sonoma,15,2022-04-02,287,287,281,6,10644,10733,10499,234,9
Stanislaus,15,2022-04-02,100,100,97,3,7811,7877,7606,271,25
Sutter,15,2022-04-02,23,23,22,1,1272,1283,1252,31,0
Tehama,15,2022-04-02,4,4,4,0,746,751,722,29,0
Trinity,15,2022-04-02,1,1,1,0,77,77,75,2,0
Tulare,15,2022-04-02,54,54,52,2,7606,7670,7396,274,15
Tuolumne,15,2022-04-02,11,11,11,0,972,981,954,27,1
Ventura,15,2022-04-02,295,295,291,4,20922,21097,20801,296,22
Yolo,15,2022-04-02,64,64,63,1,28231,28466,27960,506,1
Yuba,15,2022-04-02,12,12,12,0,1024,1033,1010,23,4
Alameda,16,2022-04-09,1354,1367,1351,16,48791,49268,48675,593,49
Amador,16,2022-04-09,7,7,7,0,1101,1112,1088,24,1
Butte,16,2022-04-09,36,36,36,0,2088,2109,2087,22,8
Calaveras,16,2022-04-09,10,10,10,0,643,648,636,12,0
Colusa,16,2022-04-09,4,4,4,0,196,197,193,4,0
Contra Costa,16,2022-04-09,623,630,618,12,19616,19808,19433,375,23
Del Norte,16,2022-04-09,7,7,7,0,982,991,975,16,1
El Dorado,16,2022-04-09,51,51,50,1,2571,2595,2546,49,1
Fresno,16,2022-04-09,196,196,192,4,16689,16852,16507,345,64
Glenn,16,2022-04-09,3,3,3,0,229,230,226,4,0
Humboldt,16,2022-04-09,38,38,37,1,2329,2352,2313,39,7
Imperial,16,2022-04-09,25,25,25,0,3484,3517,3451,66,3
Inyo,16,2022-04-09,6,6,6,0,199,199,196,3,0
Kern,16,2022-04-09,145,145,143,2,17198,17367,17075,292,20
Kings,16,2022-04-09,33,33,32,1,4206,4247,4161,86,3
Lake,16,2022-04-09,19,19,19,0,849,856,837,19,0
Lassen,16,2022-04-09,1,1,1,0,1301,1314,1295,19,1
Los Angeles,16,2022-04-09,6439,6503,6474,29,751209,758567,755137,3430,262
Madera,16,2022-04-09,28,28,27,1,3153,3184,3119,65,3
Marin,16,2022-04-09,188,189,186,3,5451,5504,5404,100,5
Mariposa,16,2022-04-09,7,7,7,0,245,246,241,5,0
Mendocino,16,2022-04-09,30,30,29,1,1152,1164,1131,33,0
Merced,16,2022-04-09,64,64,63,1,3309,3341,3282,59,10
Modoc,16,2022-04-09,1,1,1,0,50,50,49,1,0
Mono,16,2022-04-09,3,3,3,0,135,135,132,3,0
Monterey,16,2022-04-09,115,115,111,4,7166,7235,7007,228,12
Napa,16,2022-04-09,108,108,106,2,3084,3113,3062,51,2
Nevada,16,2022-04-09,34,34,33,1,1508,1523,1490,33,2
Orange,16,2022-04-09,1101,1113,1095,18,54493,55026,54134,892,79
Placer,16,2022-04-09,113,113,110,3,6232,6291,6147,144,23
Plumas,16,2022-04-09,5,5,5,0,260,262,256,6,0
Riverside,16,2022-04-09,724,731,716,15,37759,38127,37328,799,37
Sacramento,16,2022-04-09,475,480,472,8,31264,31569,31046,523,48
San Benito,16,2022-04-09,18,18,18,0,1186,1197,1181,16,0
San Bernardino,16,2022-04-09,816,823,813,10,41942,42353,41833,520,32
San Diego,16,2022-04-09,1823,1841,1831,10,73757,74478,74092,386,111
San Francisco,16,2022-04-09,1144,1156,1127,29,30157,30452,29703,749,27
San Joaquin,16,2022-04-09,232,233,229,4,15626,15778,15488,290,19
San Luis Obispo,16,2022-04-09,109,109,107,2,5012,5062,4990,72,2
San Mateo,16,2022-04-09,821,828,819,9,30514,30812,30476,336,6
Santa Barbara,16,2022-04-09,247,247,243,4,15191,15338,15084,254,9
Santa Clara,16,2022-04-09,1592,1608,1599,9,79342,80118,79691,427,89
Santa Cruz,16,2022-04-09,273,276,272,4,8149,8229,8123,106,6
Shasta,16,2022-04-09,19,19,19,0,3305,3338,3266,72,3
Siskiyou,16,2022-04-09,1,1,1,0,317,321,317,4,0
Solano,16,2022-04-09,233,233,229,4,9869,9966,9805,161,17
Sonoma,16,2022-04-09,400,405,398,7,10564,10666,10492,174,6
Stanislaus,16,2022-04-09,129,129,126,3,7866,7944,7739,205,21
Sutter,16,2022-04-09,23,23,23,0,1324,1337,1312,25,0
Tehama,16,2022-04-09,10,10,10,0,759,765,743,22,0
Trinity,16,2022-04-09,0,0,0,0,82,82,80,2,0
Tulare,16,2022-04-09,46,46,45,1,7907,7984,7770,214,7
Tuolumne,16,2022-04-09,16,16,16,0,1076,1088,1065,23,1
Ventura,16,2022-04-09,302,304,301,3,18089,18265,18074,191,20
Yolo,16,2022-04-09,94,94,93,1,18616,18799,18550,249,1
Yuba,16,2022-04-09,14,14,14,0,1083,1094,1076,18,4
Alameda,17,2022-04-16,1749,1769,1753,16,54532,55142,54646,496,41
Amador,17,2022-04-16,7,7,7,0,1135,1149,1131,18,2
Butte,17,2022-04-16,48,48,48,0,2050,2073,2057,16,5
Calaveras,17,2022-04-16,15,15,15,0,616,623,615,8,0
Colusa,17,2022-04-16,4,4,4,0,169,170,168,2,0
Contra Costa,17,2022-04-16,982,993,979,14,24958,25237,24879,358,29
Del Norte,17,2022-04-16,11,11,11,0,1022,1034,1021,13,0
El Dorado,17,2022-04-16,59,59,58,1,2360,2388,2354,34,0
Fresno,17,2022-04-16,196,196,193,3,13924,14079,13864,215,48
Glenn,17,2022-04-16,3,3,3,0,237,238,235,3,0
Humboldt,17,2022-04-16,79,79,78,1,1974,1995,1970,25,6
Imperial,17,2022-04-16,41,41,40,1,3371,3407,3359,48,3
Inyo,17,2022-04-16,0,0,0,0,152,152,150,2,0
Kern,17,2022-04-16,129,129,127,2,13373,13523,13353,170,19
Kings,17,2022-04-16,38,38,37,1,3615,3655,3600,55,2
Lake,17,2022-04-16,19,19,19,0,815,824,810,14,2
Lassen,17,2022-04-16,2,2,2,0,1317,1332,1317,15,0
Los Angeles,17,2022-04-16,7600,7685,7659,26,371641,375796,374524,1272,213
Madera,17,2022-04-16,23,23,23,0,2603,2632,2592,40,3
Marin,17,2022-04-16,282,283,279,4,6108,6176,6092,84,5
Mariposa,17,2022-04-16,11,11,11,0,257,259,255,4,0
Mendocino,17,2022-04-16,42,42,41,1,1303,1317,1289,28,4
Merced,17,2022-04-16,71,71,70,1,3158,3194,3152,42,9
Modoc,17,2022-04-16,1,1,1,0,36,37,36,1,0
Mono,17,2022-04-16,13,13,13,0,170,171,168,3,0
Monterey,17,2022-04-16,131,131,128,3,6343,6415,6263,152,6
Napa,17,2022-04-16,142,142,140,2,2699,2729,2696,33,1
Nevada,17,2022-04-16,42,42,41,1,1240,1253,1233,20,2
Orange,17,2022-04-16,1347,1361,1345,16,82381,83302,82291,1011,67
Placer,17,2022-04-16,153,153,150,3,4703,4755,4674,81,25
Plumas,17,2022-04-16,7,7,7,0,209,210,206,4,0
Riverside,17,2022-04-16,868,878,864,14,37269,37685,37094,591,45
Sacramento,17,2022-04-16,649,656,648,8,27839,28150,27803,347,53
San Benito,17,2022-04-16,24,24,24,0,1181,1195,1183,12,0
San Bernardino,17,2022-04-16,1025,1038,1028,10,39324,39763,39397,366,43
San Diego,17,2022-04-16,1880,1902,1895,7,68495,69260,68991,269,96
San Francisco,17,2022-04-16,1324,1339,1314,25,30544,30887,30319,568,32
San Joaquin,17,2022-04-16,221,222,219,3,14848,15014,14808,206,13
San Luis Obispo,17,2022-04-16,138,138,137,1,4860,4914,4862,52,3
San Mateo,17,2022-04-16,1037,1050,1042,8,29933,30269,30024,245,11
Santa Barbara,17,2022-04-16,330,334,330,4,14850,15016,14830,186,8
Santa Clara,17,2022-04-16,2028,2050,2042,8,74227,75056,74756,300,74
Santa Cruz,17,2022-04-16,409,413,409,4,12638,12778,12651,127,4
Shasta,17,2022-04-16,27,27,27,0,2836,2867,2821,46,4
Siskiyou,17,2022-04-16,4,4,4,0,325,328,325,3,1
Solano,17,2022-04-16,235,236,233,3,9183,9287,9175,112,10
Sonoma,17,2022-04-16,481,487,481,6,11406,11533,11392,141,15
Stanislaus,17,2022-04-16,146,146,143,3,7857,7944,7791,153,19
Sutter,17,2022-04-16,20,20,20,0,1181,1195,1179,16,0
Tehama,17,2022-04-16,7,7,7,0,649,655,641,14,1
Trinity,17,2022-04-16,0,0,0,0,69,69,68,1,0
Tulare,17,2022-04-16,72,72,71,1,6822,6899,6760,139,13
Tuolumne,17,2022-04-16,26,26,26,0,1060,1072,1055,17,0
Ventura,17,2022-04-16,357,362,359,3,15809,15986,15861,125,9
Yolo,17,2022-04-16,111,111,110,1,18753,18961,18773,188,2
Yuba,17,2022-04-16,21,21,21,0,1007,1019,1006,13,1
Alameda,18,2022-04-23,2246,2275,2260,15,55688,56392,56016,376,53
Amador,18,2022-04-23,18,18,18,0,1320,1337,1321,16,0
Butte,18,2022-04-23,37,37,37,0,2189,2216,2203,13,9
Calaveras,18,2022-04-23,22,22,22,0,611,618,612,6,0
Colusa,18,2022-04-23,3,3,3,0,175,175,173,2,0
Contra Costa,18,2022-04-23,1350,1368,1354,14,25382,25704,25433,271,31
Del Norte,18,2022-04-23,17,17,17,0,1068,1081,1071,10,1
El Dorado,18,2022-04-23,99,99,98,1,2663,2696,2668,28,0
Fresno,18,2022-04-23,327,332,328,4,15695,15893,15711,182,36
Glenn,18,2022-04-23,4,4,4,0,254,255,253,2,0
Humboldt,18,2022-04-23,171,171,169,2,2755,2790,2764,26,4
Imperial,18,2022-04-23,54,54,53,1,3358,3401,3365,36,5
Inyo,18,2022-04-23,6,6,6,0,183,183,182,1,2
Kern,18,2022-04-23,217,218,216,2,16989,17205,17044,161,21
Kings,18,2022-04-23,54,54,53,1,4408,4463,4413,50,2
Lake,18,2022-04-23,15,15,15,0,795,806,796,10,2
Lassen,18,2022-04-23,0,0,0,0,1523,1543,1530,13,0
Los Angeles,18,2022-04-23,10734,10870,10843,27,855829,866648,864474,2174,218
Madera,18,2022-04-23,30,30,30,0,2828,2864,2831,33,2
Marin,18,2022-04-23,347,353,349,4,6086,6162,6100,62,9
Mariposa,18,2022-04-23,15,15,15,0,213,216,213,3,0
Mendocino,18,2022-04-23,64,64,63,1,1192,1207,1188,19,1
Merced,18,2022-04-23,86,86,85,1,2910,2948,2919,29,6
Modoc,18,2022-04-23,1,1,1,0,35,36,35,1,0
Mono,18,2022-04-23,4,4,4,0,88,88,87,1,0
Monterey,18,2022-04-23,251,253,249,4,7378,7471,7339,132,4
Napa,18,2022-04-23,204,205,203,2,3326,3368,3337,31,0
Nevada,18,2022-04-23,48,48,47,1,1360,1377,1360,17,3
Orange,18,2022-04-23,1815,1837,1820,17,83855,84917,84153,764,66
Placer,18,2022-04-23,207,207,204,3,5685,5756,5683,73,25
Plumas,18,2022-04-23,2,2,2,0,233,235,232,3,0
Riverside,18,2022-04-23,1185,1200,1186,14,39029,39522,39061,461,44
Sacramento,18,2022-04-23,919,931,922,9,30668,31055,30770,285,52
San Benito,18,2022-04-23,33,33,33,0,1134,1149,1140,9,0
San Bernardino,18,2022-04-23,1273,1291,1282,9,41985,42515,42224,291,31
San Diego,18,2022-04-23,2725,2761,2753,8,72411,73326,73115,211,97
San Francisco,18,2022-04-23,1817,1840,1815,25,31033,31425,30993,432,32
San Joaquin,18,2022-04-23,352,357,353,4,15219,15411,15253,158,13
San Luis Obispo,18,2022-04-23,190,191,189,2,4988,5050,5010,40,5
San Mateo,18,2022-04-23,1375,1393,1385,8,31638,32038,31844,194,19
Santa Barbara,18,2022-04-23,351,356,353,3,14666,14852,14715,137,7
Santa Clara,18,2022-04-23,2803,2839,2831,8,68870,69740,69534,206,83
Santa Cruz,18,2022-04-23,455,461,458,3,19434,19680,19539,141,2
Shasta,18,2022-04-23,50,50,49,1,3053,3092,3055,37,0
Siskiyou,18,2022-04-23,8,8,8,0,329,333,330,3,0
Solano,18,2022-04-23,408,414,410,4,10136,10265,10173,92,11
Sonoma,18,2022-04-23,626,633,627,6,11568,11714,11608,106,18
Stanislaus,18,2022-04-23,204,204,201,3,7441,7533,7424,109,21
Sutter,18,2022-04-23,33,33,33,0,1307,1323,1310,13,0
Tehama,18,2022-04-23,15,15,15,0,658,665,654,11,1
Trinity,18,2022-04-23,2,2,2,0,77,77,76,1,0
Tulare,18,2022-04-23,81,81,80,1,6943,7029,6924,105,12
Tuolumne,18,2022-04-23,34,34,34,0,1105,1120,1107,13,1
Ventura,18,2022-04-23,555,561,558,3,18623,18859,18749,110,16
Yolo,18,2022-04-23,184,185,184,1,18477,18712,18575,137,0
Yuba,18,2022-04-23,34,34,34,0,1086,1101,1091,10,1
Alameda,19,2022-04-30,3071,3115,3099,16,69155,70148,69797,351,43
Amador,19,2022-04-30,32,32,32,0,1344,1363,1351,12,0
Butte,19,2022-04-30,89,89,89,0,2285,2318,2308,10,4
Calaveras,19,2022-04-30,32,32,32,0,737,747,741,6,0
Colusa,19,2022-04-30,4,4,4,0,220,224,222,2,0
Contra Costa,19,2022-04-30,1690,1715,1702,13,28712,29124,28893,231,42
Del Norte,19,2022-04-30,37,37,37,0,1205,1223,1215,8,0
El Dorado,19,2022-04-30,114,114,113,1,2749,2788,2766,22,3
Fresno,19,2022-04-30,455,461,457,4,16946,17188,17041,147,39
Glenn,19,2022-04-30,4,4,4,0,244,246,244,2,0
Humboldt,19,2022-04-30,203,204,203,1,2908,2949,2928,21,7
Imperial,19,2022-04-30,110,110,109,1,3699,3751,3722,29,2
Inyo,19,2022-04-30,5,5,5,0,207,210,209,1,0
Kern,19,2022-04-30,277,282,280,2,17908,18165,18038,127,15
Kings,19,2022-04-30,45,45,45,0,4736,4805,4765,40,3
Lake,19,2022-04-30,28,28,28,0,1023,1038,1028,10,1
Lassen,19,2022-04-30,9,9,9,0,1606,1629,1619,10,0
Los Angeles,19,2022-04-30,13691,13889,13863,26,921376,934613,932863,1750,226
Madera,19,2022-04-30,67,67,66,1,3225,3272,3244,28,3
Marin,19,2022-04-30,381,387,384,3,6397,6488,6439,49,9
Mariposa,19,2022-04-30,7,7,7,0,239,242,240,2,0
Mendocino,19,2022-04-30,48,48,47,1,1259,1278,1263,15,0
Merced,19,2022-04-30,116,116,115,1,3252,3298,3274,24,6
Modoc,19,2022-04-30,0,0,0,0,44,45,44,1,0
Mono,19,2022-04-30,4,4,4,0,81,81,80,1,0
Monterey,19,2022-04-30,326,333,329,4,8332,8451,8339,112,8
Napa,19,2022-04-30,215,216,215,1,3495,3547,3523,24,5
Nevada,19,2022-04-30,69,69,68,1,1506,1528,1514,14,2
Orange,19,2022-04-30,2456,2491,2474,17,87799,89061,88461,600,83
Placer,19,2022-04-30,265,269,266,3,6282,6372,6311,61,27
Plumas,19,2022-04-30,7,7,7,0,253,257,254,3,0
Riverside,19,2022-04-30,1753,1778,1763,15,41970,42572,42200,372,41
Sacramento,19,2022-04-30,1236,1253,1244,9,32568,33035,32808,227,51
San Benito,19,2022-04-30,44,44,44,0,1203,1221,1214,7,0
San Bernardino,19,2022-04-30,1335,1354,1347,7,42642,43255,43034,221,37
San Diego,19,2022-04-30,3716,3769,3761,8,71459,72484,72328,156,97
San Francisco,19,2022-04-30,2281,2313,2289,24,35040,35545,35180,365,44
San Joaquin,19,2022-04-30,476,483,479,4,15179,15395,15277,118,17
San Luis Obispo,19,2022-04-30,254,257,255,2,5149,5224,5193,31,9
San Mateo,19,2022-04-30,1678,1702,1694,8,36025,36542,36377,165,20
Santa Barbara,19,2022-04-30,387,393,390,3,15587,15811,15702,109,9
Santa Clara,19,2022-04-30,3875,3930,3921,9,95281,96649,96436,213,86
Santa Cruz,19,2022-04-30,635,644,641,3,22270,22591,22470,121,3
Shasta,19,2022-04-30,60,60,59,1,3425,3474,3443,31,7
Siskiyou,19,2022-04-30,11,11,11,0,323,328,326,2,0
Solano,19,2022-04-30,600,608,604,4,11534,11700,11622,78,14
Sonoma,19,2022-04-30,765,777,772,5,12398,12577,12492,85,19
Stanislaus,19,2022-04-30,274,279,276,3,8275,8393,8302,91,20
Sutter,19,2022-04-30,48,48,48,0,1277,1295,1285,10,0
Tehama,19,2022-04-30,17,17,17,0,676,687,679,8,0
Trinity,19,2022-04-30,1,1,1,0,84,84,83,1,0
Tulare,19,2022-04-30,142,142,140,2,7123,7226,7145,81,10
Tuolumne,19,2022-04-30,81,81,80,1,1236,1253,1242,11,5
Ventura,19,2022-04-30,659,669,666,3,19483,19762,19676,86,16
Yolo,19,2022-04-30,243,246,245,1,19193,19468,19361,107,2
Yuba,19,2022-04-30,36,36,36,0,1044,1060,1053,7,2
Alameda,20,2022-05-07,3954,4019,4004,15,70083,71248,70984,264,68
Amador,20,2022-05-07,13,13,13,0,1400,1424,1415,9,0
Butte,20,2022-05-07,115,115,115,0,2380,2418,2410,8,4
Calaveras,20,2022-05-07,27,27,27,0,694,707,703,4,1
Colusa,20,2022-05-07,3,3,3,0,216,220,219,1,0
Contra Costa,20,2022-05-07,2351,2390,2376,14,30558,31065,30882,183,50
Del Norte,20,2022-05-07,42,42,42,0,1226,1246,1240,6,0
El Dorado,20,2022-05-07,169,169,168,1,2814,2862,2845,17,4
Fresno,20,2022-05-07,662,674,670,4,17890,18187,18071,116,32
Glenn,20,2022-05-07,6,6,6,0,229,232,231,1,0
Humboldt,20,2022-05-07,296,302,300,2,3267,3321,3304,17,4
Imperial,20,2022-05-07,111,111,110,1,3790,3854,3831,23,1
Inyo,20,2022-05-07,18,18,18,0,200,203,202,1,0
Kern,20,2022-05-07,427,434,432,2,18523,18830,18732,98,23
Kings,20,2022-05-07,88,88,87,1,4934,5016,4985,31,2
Lake,20,2022-05-07,30,30,30,0,1009,1026,1019,7,1
Lassen,20,2022-05-07,2,2,2,0,1681,1709,1701,8,0
Los Angeles,20,2022-05-07,17455,17746,17721,25,912803,927964,926672,1292,248
Madera,20,2022-05-07,129,129,128,1,3754,3817,3793,24,3
Marin,20,2022-05-07,636,646,642,4,7597,7724,7681,43,12
Mariposa,20,2022-05-07,25,25,25,0,271,276,274,2,0
Mendocino,20,2022-05-07,87,87,86,1,1236,1256,1245,11,1
Merced,20,2022-05-07,179,180,179,1,3426,3483,3464,19,5
Modoc,20,2022-05-07,2,2,2,0,38,39,38,1,0
Mono,20,2022-05-07,10,10,10,0,126,127,126,1,0
Monterey,20,2022-05-07,434,441,437,4,9207,9359,9266,93,8
Napa,20,2022-05-07,230,235,234,1,3251,3306,3289,17,2
Nevada,20,2022-05-07,100,100,99,1,1636,1664,1653,11,3
Orange,20,2022-05-07,3330,3386,3369,17,90856,92365,91902,463,108
Placer,20,2022-05-07,465,473,470,3,6702,6813,6764,49,27
Plumas,20,2022-05-07,13,13,13,0,275,280,278,2,0
Riverside,20,2022-05-07,2362,2401,2385,16,44951,45697,45400,297,43
Sacramento,20,2022-05-07,1963,1995,1985,10,36290,36893,36704,189,70
San Benito,20,2022-05-07,62,62,62,0,1433,1455,1449,6,0
San Bernardino,20,2022-05-07,1758,1787,1780,7,45274,46027,45852,175,38
San Diego,20,2022-05-07,4904,4987,4979,8,85779,87203,87064,139,94
San Francisco,20,2022-05-07,2837,2884,2862,22,37441,38065,37773,292,52
San Joaquin,20,2022-05-07,681,693,689,4,15791,16053,15962,91,14
San Luis Obispo,20,2022-05-07,286,291,290,1,5196,5282,5259,23,2
San Mateo,20,2022-05-07,2145,2180,2173,7,36740,37350,37225,125,27
Santa Barbara,20,2022-05-07,585,595,592,3,15281,15535,15455,80,14
Santa Clara,20,2022-05-07,5425,5516,5507,9,102428,104128,103957,171,110
Santa Cruz,20,2022-05-07,692,703,700,3,23026,23409,23316,93,5
Shasta,20,2022-05-07,93,93,92,1,3458,3515,3492,23,7
Siskiyou,20,2022-05-07,14,14,14,0,292,297,296,1,0
Solano,20,2022-05-07,797,810,806,4,12187,12390,12328,62,19
Sonoma,20,2022-05-07,1147,1166,1160,6,13907,14138,14067,71,23
Stanislaus,20,2022-05-07,385,391,388,3,8632,8776,8706,70,27
Sutter,20,2022-05-07,44,44,44,0,1523,1548,1539,9,0
Tehama,20,2022-05-07,25,25,25,0,692,705,699,6,1
Trinity,20,2022-05-07,2,2,2,0,68,68,67,1,0
Tulare,20,2022-05-07,173,175,174,1,7588,7714,7649,65,12
Tuolumne,20,2022-05-07,80,80,79,1,1330,1353,1344,9,1
Ventura,20,2022-05-07,1055,1073,1070,3,20979,21329,21260,69,16
Yolo,20,2022-05-07,331,338,337,1,19404,19727,19647,80,1
Yuba,20,2022-05-07,63,63,63,0,1211,1231,1225,6,2
Alameda,21,2022-05-14,4703,4797,4784,13,74057,75526,75317,209,69
Amador,21,2022-05-14,45,45,45,0,1679,1713,1705,8,1
Butte,21,2022-05-14,157,160,160,0,2561,2612,2606,6,6
Calaveras,21,2022-05-14,36,36,36,0,745,760,757,3,2
Colusa,21,2022-05-14,5,5,5,0,202,207,206,1,0
Contra Costa,21,2022-05-14,3059,3120,3106,14,32354,32995,32850,145,55
Del Norte,21,2022-05-14,108,109,109,0,1745,1780,1773,7,0
El Dorado,21,2022-05-14,232,238,237,1,3013,3072,3059,13,6
Fresno,21,2022-05-14,953,971,966,5,18856,19230,19139,91,44
Glenn,21,2022-05-14,12,12,12,0,244,248,247,1,0
Humboldt,21,2022-05-14,280,287,286,1,3200,3263,3250,13,10
Imperial,21,2022-05-14,197,202,201,1,4214,4298,4279,19,4
Inyo,21,2022-05-14,20,20,20,0,226,230,229,1,1
Kern,21,2022-05-14,564,576,574,2,19459,19845,19768,77,20
Kings,21,2022-05-14,164,168,167,1,5253,5356,5331,25,0
Lake,21,2022-05-14,57,57,57,0,1122,1145,1139,6,0
Lassen,21,2022-05-14,14,14,14,0,1683,1717,1711,6,0
Los Angeles,21,2022-05-14,19920,20316,20295,21,930070,948508,947525,983,318
Madera,21,2022-05-14,170,174,173,1,3589,3660,3643,17,3
Marin,21,2022-05-14,729,742,739,3,8064,8224,8189,35,11
Mariposa,21,2022-05-14,27,27,27,0,349,357,355,2,0
Mendocino,21,2022-05-14,97,97,96,1,1322,1348,1339,9,2
Merced,21,2022-05-14,260,266,265,1,3807,3882,3866,16,8
Modoc,21,2022-05-14,2,2,2,0,39,40,39,1,0
Mono,21,2022-05-14,9,9,9,0,116,117,116,1,0
Monterey,21,2022-05-14,489,498,494,4,9403,9588,9517,71,10
Napa,21,2022-05-14,292,299,298,1,3495,3564,3551,13,3
Nevada,21,2022-05-14,134,135,134,1,1837,1874,1865,9,3
Orange,21,2022-05-14,4142,4226,4210,16,93170,95022,94667,355,88
Placer,21,2022-05-14,621,633,630,3,7353,7498,7458,40,37
Plumas,21,2022-05-14,41,41,41,0,256,261,260,1,1
Riverside,21,2022-05-14,2924,2982,2968,14,46339,47259,47030,229,59
Sacramento,21,2022-05-14,2791,2846,2835,11,38376,39138,38989,149,71
San Benito,21,2022-05-14,99,99,99,0,1523,1554,1549,5,3
San Bernardino,21,2022-05-14,2234,2278,2272,6,47396,48337,48200,137,47
San Diego,21,2022-05-14,6051,6172,6165,7,91908,93732,93621,111,111
San Francisco,21,2022-05-14,3316,3382,3363,19,38731,39500,39273,227,63
San Joaquin,21,2022-05-14,1101,1123,1118,5,17914,18268,18191,77,12
San Luis Obispo,21,2022-05-14,350,357,356,1,5772,5887,5868,19,2
San Mateo,21,2022-05-14,2627,2679,2672,7,39412,40196,40096,100,37
Santa Barbara,21,2022-05-14,783,797,794,3,16393,16719,16655,64,10
Santa Clara,21,2022-05-14,6634,6765,6757,8,109569,111741,111605,136,124
Santa Cruz,21,2022-05-14,883,900,897,3,24848,25339,25264,75,4
Shasta,21,2022-05-14,118,120,119,1,3726,3800,3781,19,6
Siskiyou,21,2022-05-14,19,19,19,0,383,390,389,1,1
Solano,21,2022-05-14,1070,1092,1088,4,13287,13550,13500,50,24
Sonoma,21,2022-05-14,1437,1466,1461,5,15218,15520,15462,58,23
Stanislaus,21,2022-05-14,637,650,646,4,9650,9841,9782,59,35
Sutter,21,2022-05-14,103,103,103,0,1753,1788,1780,8,0
Tehama,21,2022-05-14,22,22,22,0,799,815,810,5,2
Trinity,21,2022-05-14,5,5,5,0,68,69,68,1,0
Tulare,21,2022-05-14,295,301,299,2,7838,7993,7943,50,11
Tuolumne,21,2022-05-14,93,93,93,0,1443,1473,1466,7,2
Ventura,21,2022-05-14,1369,1396,1393,3,22952,23408,23352,56,25
Yolo,21,2022-05-14,464,473,472,1,21375,21801,21735,66,2
Yuba,21,2022-05-14,104,104,104,0,1252,1276,1271,5,2
Alameda,22,2022-05-21,5514,5653,5641,12,76091,78015,77854,161,92
Amador,22,2022-05-21,70,70,70,0,1573,1612,1606,6,0
Butte,22,2022-05-21,269,275,275,0,2722,2792,2787,5,7
Calaveras,22,2022-05-21,58,58,58,0,765,783,781,2,0
Colusa,22,2022-05-21,6,6,6,0,223,227,226,1,0
Contra Costa,22,2022-05-21,3864,3961,3948,13,34940,35823,35706,117,76
Del Norte,22,2022-05-21,120,122,122,0,1566,1606,1601,5,0
El Dorado,22,2022-05-21,336,343,342,1,3301,3384,3373,11,4
Fresno,22,2022-05-21,1526,1564,1558,6,21019,21551,21475,76,66
Glenn,22,2022-05-21,17,17,17,0,275,282,281,1,0
Humboldt,22,2022-05-21,242,249,248,1,2865,2937,2929,8,13
Imperial,22,2022-05-21,311,320,319,1,4667,4784,4769,15,4
Inyo,22,2022-05-21,26,26,26,0,236,242,241,1,0
Kern,22,2022-05-21,919,943,940,3,20289,20799,20739,60,39
Kings,22,2022-05-21,248,254,253,1,5608,5750,5730,20,0
Lake,22,2022-05-21,79,79,79,0,1235,1265,1260,5,0
Lassen,22,2022-05-21,32,32,32,0,1704,1746,1742,4,0
Los Angeles,22,2022-05-21,25906,26563,26543,20,936829,960479,959738,741,385
Madera,22,2022-05-21,207,213,212,1,3737,3831,3818,13,2
Marin,22,2022-05-21,831,851,848,3,8837,9061,9033,28,16
Mariposa,22,2022-05-21,32,32,32,0,335,344,343,1,0
Mendocino,22,2022-05-21,138,142,141,1,1618,1658,1650,8,5
Merced,22,2022-05-21,415,427,426,1,4135,4239,4226,13,3
Modoc,22,2022-05-21,2,2,2,0,42,43,42,1,0
Mono,22,2022-05-21,16,16,16,0,148,152,151,1,0
Monterey,22,2022-05-21,650,667,663,4,9639,9881,9826,55,11
Napa,22,2022-05-21,300,308,307,1,3973,4074,4063,11,5
Nevada,22,2022-05-21,154,158,157,1,1832,1878,1871,7,1
Orange,22,2022-05-21,5331,5466,5451,15,95344,97757,97485,272,112
Placer,22,2022-05-21,880,902,898,4,7912,8111,8079,32,39
Plumas,22,2022-05-21,43,43,43,0,256,262,261,1,0
Riverside,22,2022-05-21,4236,4344,4328,16,50757,52040,51852,188,79
Sacramento,22,2022-05-21,3738,3834,3823,11,40676,41702,41583,119,116
San Benito,22,2022-05-21,157,161,161,0,1560,1598,1594,4,0
San Bernardino,22,2022-05-21,3060,3137,3130,7,49202,50446,50340,106,51
San Diego,22,2022-05-21,8565,8783,8775,8,102078,104655,104562,93,142
San Francisco,22,2022-05-21,3690,3784,3768,16,41396,42444,42263,181,94
San Joaquin,22,2022-05-21,1478,1515,1510,5,20364,20876,20810,66,26
San Luis Obispo,22,2022-05-21,586,601,600,1,6881,7056,7039,17,11
San Mateo,22,2022-05-21,3097,3176,3170,6,40440,41460,41383,77,47
Santa Barbara,22,2022-05-21,1078,1103,1100,3,17927,18378,18326,52,20
Santa Clara,22,2022-05-21,7785,7982,7975,7,111425,114234,114130,104,129
Santa Cruz,22,2022-05-21,516,528,527,1,7980,8180,8162,18,13
Shasta,22,2022-05-21,180,185,184,1,3557,3646,3633,13,7
Siskiyou,22,2022-05-21,21,21,21,0,338,346,345,1,1
Solano,22,2022-05-21,1442,1479,1475,4,14494,14861,14820,41,27
Sonoma,22,2022-05-21,1547,1586,1582,4,16205,16614,16568,46,36
Stanislaus,22,2022-05-21,864,887,883,4,10439,10700,10652,48,42
Sutter,22,2022-05-21,136,140,140,0,1797,1841,1835,6,0
Tehama,22,2022-05-21,66,66,66,0,803,824,820,4,1
Trinity,22,2022-05-21,4,4,4,0,88,90,89,1,0
Tulare,22,2022-05-21,537,550,547,3,9001,9228,9185,43,22
Tuolumne,22,2022-05-21,174,178,177,1,1587,1628,1622,6,1
Ventura,22,2022-05-21,1897,1946,1943,3,24061,24668,24624,44,36
Yolo,22,2022-05-21,569,583,582,1,22313,22880,22828,52,2
Yuba,22,2022-05-21,154,159,159,0,1433,1469,1465,4,6
Alameda,23,2022-05-28,5561,5758,5749,9,73559,76128,76011,117,97
Amador,23,2022-05-28,101,105,105,0,1291,1337,1333,4,1
Butte,23,2022-05-28,319,331,331,0,3133,3243,3239,4,14
Calaveras,23,2022-05-28,56,56,56,0,726,751,749,2,0
Colusa,23,2022-05-28,10,10,10,0,207,215,214,1,0
Contra Costa,23,2022-05-28,3777,3910,3900,10,34383,35591,35504,87,77
Del Norte,23,2022-05-28,50,50,50,0,1128,1168,1166,2,2
El Dorado,23,2022-05-28,382,395,394,1,3440,3561,3552,9,6
Fresno,23,2022-05-28,1860,1925,1920,5,22215,22995,22934,61,64
Glenn,23,2022-05-28,29,29,29,0,311,321,320,1,2
Humboldt,23,2022-05-28,217,225,225,0,2803,2900,2894,6,13
Imperial,23,2022-05-28,378,392,391,1,5010,5187,5175,12,4
Inyo,23,2022-05-28,26,26,26,0,197,204,203,1,0
Kern,23,2022-05-28,1225,1269,1266,3,21151,21891,21844,47,31
Kings,23,2022-05-28,329,341,340,1,5367,5554,5540,14,3
Lake,23,2022-05-28,110,114,114,0,1152,1193,1190,3,0
Lassen,23,2022-05-28,61,62,62,0,1848,1911,1907,4,1
Los Angeles,23,2022-05-28,29453,30487,30469,18,914771,946765,946220,545,438
Madera,23,2022-05-28,266,277,276,1,3723,3853,3843,10,6
Marin,23,2022-05-28,743,771,769,2,8378,8673,8653,20,16
Mariposa,23,2022-05-28,36,36,36,0,344,357,356,1,0
Mendocino,23,2022-05-28,147,153,152,1,1436,1485,1479,6,4
Merced,23,2022-05-28,434,450,449,1,4082,4225,4215,10,6
Modoc,23,2022-05-28,5,5,5,0,45,46,45,1,0
Mono,23,2022-05-28,8,8,8,0,126,131,130,1,0
Monterey,23,2022-05-28,605,626,623,3,8846,9152,9114,38,11
Napa,23,2022-05-28,336,348,347,1,3777,3910,3902,8,5
Nevada,23,2022-05-28,188,193,192,1,1955,2023,2017,6,2
Orange,23,2022-05-28,6119,6334,6321,13,94769,98104,97901,203,129
Placer,23,2022-05-28,867,899,896,3,7346,7601,7578,23,54
Plumas,23,2022-05-28,36,36,36,0,258,267,266,1,1
Riverside,23,2022-05-28,4424,4580,4568,12,51605,53413,53269,144,99
Sacramento,23,2022-05-28,4252,4402,4393,9,38923,40287,40202,85,142
San Benito,23,2022-05-28,174,179,179,0,1553,1606,1603,3,0
San Bernardino,23,2022-05-28,3707,3837,3831,6,49300,51030,50950,80,63
San Diego,23,2022-05-28,9233,9559,9553,6,100224,103730,103661,69,189
San Francisco,23,2022-05-28,3414,3534,3523,11,38335,39680,39553,127,88
San Joaquin,23,2022-05-28,1527,1581,1577,4,20010,20704,20655,49,37
San Luis Obispo,23,2022-05-28,787,815,814,1,6869,7107,7094,13,14
San Mateo,23,2022-05-28,3108,3218,3214,4,37843,39163,39108,55,40
Santa Barbara,23,2022-05-28,1121,1161,1159,2,17279,17886,17848,38,32
Santa Clara,23,2022-05-28,7723,7993,7988,5,100074,103556,103486,70,161
Santa Cruz,23,2022-05-28,534,553,552,1,7455,7714,7701,13,8
Shasta,23,2022-05-28,169,175,175,0,3511,3633,3623,10,11
Siskiyou,23,2022-05-28,52,52,52,0,379,393,392,1,3
Solano,23,2022-05-28,1375,1423,1420,3,13874,14360,14330,30,45
Sonoma,23,2022-05-28,1384,1433,1430,3,15559,16102,16068,34,46
Stanislaus,23,2022-05-28,866,897,894,3,10394,10753,10717,36,58
Sutter,23,2022-05-28,163,169,169,0,1953,2020,2015,5,0
Tehama,23,2022-05-28,49,49,49,0,880,911,908,3,4
Trinity,23,2022-05-28,6,6,6,0,97,101,100,1,0
Tulare,23,2022-05-28,639,662,660,2,9040,9352,9319,33,20
Tuolumne,23,2022-05-28,117,121,121,0,1532,1584,1580,4,2
Ventura,23,2022-05-28,1906,1973,1970,3,22886,23687,23655,32,38
Yolo,23,2022-05-28,558,578,577,1,20827,21564,21528,36,3
Yuba,23,2022-05-28,154,160,160,0,1430,1480,1477,3,11
Alameda,24,2022-06-04,7007,7462,7453,9,80941,86179,86076,103,118
Amador,24,2022-06-04,92,97,97,0,1900,2026,2022,4,3
Butte,24,2022-06-04,428,458,458,0,3786,4030,4026,4,26
Calaveras,24,2022-06-04,67,72,72,0,762,810,809,1,0
Colusa,24,2022-06-04,23,23,23,0,271,289,288,1,3
Contra Costa,24,2022-06-04,4547,4841,4832,9,39018,41532,41453,79,97
Del Norte,24,2022-06-04,64,69,69,0,1395,1486,1484,2,1
El Dorado,24,2022-06-04,415,441,440,1,3930,4186,4178,8,9
Fresno,24,2022-06-04,2482,2643,2638,5,25290,26921,26866,55,100
Glenn,24,2022-06-04,38,39,39,0,353,374,373,1,3
Humboldt,24,2022-06-04,280,298,297,1,3192,3399,3393,6,15
Imperial,24,2022-06-04,449,479,478,1,5311,5650,5639,11,5
Inyo,24,2022-06-04,21,21,21,0,194,207,206,1,0
Kern,24,2022-06-04,1568,1670,1667,3,24920,26518,26474,44,45
Kings,24,2022-06-04,425,450,449,1,6164,6557,6544,13,8
Lake,24,2022-06-04,148,158,158,0,1275,1357,1354,3,5
Lassen,24,2022-06-04,78,83,83,0,2702,2873,2869,4,1
Los Angeles,24,2022-06-04,36012,38353,38336,17,1103993,1175224,1174701,523,540
Madera,24,2022-06-04,350,373,372,1,4232,4507,4498,9,5
Marin,24,2022-06-04,787,839,837,2,8658,9223,9206,17,11
Mariposa,24,2022-06-04,84,87,87,0,456,486,485,1,0
Mendocino,24,2022-06-04,228,244,243,1,1870,1991,1985,6,9
Merced,24,2022-06-04,507,540,539,1,4853,5164,5155,9,11
Modoc,24,2022-06-04,10,10,10,0,49,52,51,1,0
Mono,24,2022-06-04,15,15,15,0,136,147,146,1,0
Monterey,24,2022-06-04,997,1063,1060,3,11496,12228,12189,39,22
Napa,24,2022-06-04,496,529,528,1,4275,4555,4548,7,10
Nevada,24,2022-06-04,265,283,282,1,2275,2422,2417,5,5
Orange,24,2022-06-04,8199,8734,8720,14,78875,84005,83869,136,138
Placer,24,2022-06-04,899,959,957,2,7953,8471,8452,19,79
Plumas,24,2022-06-04,41,42,42,0,325,345,344,1,0
Riverside,24,2022-06-04,5497,5854,5842,12,59413,63258,63126,132,107
Sacramento,24,2022-06-04,5276,5619,5610,9,46104,49078,48997,81,146
San Benito,24,2022-06-04,286,304,304,0,2214,2354,2351,3,0
San Bernardino,24,2022-06-04,5277,5620,5613,7,59337,63170,63093,77,88
San Diego,24,2022-06-04,11683,12443,12437,6,113274,120574,120512,62,207
San Francisco,24,2022-06-04,3954,4209,4199,10,42822,45601,45488,113,89
San Joaquin,24,2022-06-04,2174,2315,2311,4,23391,24902,24857,45,46
San Luis Obispo,24,2022-06-04,965,1028,1027,1,8342,8875,8862,13,13
San Mateo,24,2022-06-04,3534,3761,3757,4,41495,44151,44103,48,32
Santa Barbara,24,2022-06-04,1438,1531,1528,3,17389,18504,18473,31,23
Santa Clara,24,2022-06-04,9229,9828,9823,5,113224,120502,120439,63,180
Santa Cruz,24,2022-06-04,852,911,910,1,9410,10023,10010,13,17
Shasta,24,2022-06-04,204,216,216,0,5038,5350,5339,11,11
Siskiyou,24,2022-06-04,54,57,57,0,497,528,527,1,2
Solano,24,2022-06-04,1614,1720,1717,3,15746,16771,16744,27,33
Sonoma,24,2022-06-04,1669,1779,1776,3,15192,16173,16147,26,42
Stanislaus,24,2022-06-04,1221,1301,1298,3,12071,12841,12808,33,55
Sutter,24,2022-06-04,222,236,236,0,2357,2505,2500,5,0
Tehama,24,2022-06-04,78,85,85,0,1051,1118,1115,3,1
Trinity,24,2022-06-04,10,10,10,0,126,135,134,1,0
Tulare,24,2022-06-04,889,947,944,3,11500,12234,12201,33,27
Tuolumne,24,2022-06-04,133,142,142,0,1885,2007,2003,4,2
Ventura,24,2022-06-04,2073,2209,2207,2,27584,29348,29318,30,48
Yolo,24,2022-06-04,665,708,707,1,23457,24989,24956,33,2
Yuba,24,2022-06-04,183,197,197,0,1718,1830,1827,3,6
Alameda,25,2022-06-11,4725,11362,11349,13,53448,118470,118329,141,125
Amador,25,2022-06-11,121,253,252,1,1365,3259,3252,7,1
Butte,25,2022-06-11,364,943,942,1,3241,7701,7693,8,24
Calaveras,25,2022-06-11,63,217,217,0,658,1740,1737,3,1
Colusa,25,2022-06-11,12,19,19,0,255,480,479,1,17
Contra Costa,25,2022-06-11,3099,7134,7121,13,28232,66318,66193,125,92
Del Norte,25,2022-06-11,57,165,165,0,641,1440,1438,2,2
El Dorado,25,2022-06-11,307,713,712,1,2999,6788,6775,13,7
Fresno,25,2022-06-11,2070,5128,5118,10,19126,50261,50159,102,117
Glenn,25,2022-06-11,34,90,90,0,308,618,617,1,6
Humboldt,25,2022-06-11,200,543,542,1,2312,5215,5206,9,15
Imperial,25,2022-06-11,368,761,760,1,4244,9055,9038,17,6
Inyo,25,2022-06-11,11,22,22,0,186,453,452,1,0
Kern,25,2022-06-11,1236,2537,2533,4,18339,37312,37250,62,36
Kings,25,2022-06-11,324,660,659,1,4729,10503,10482,21,6
Lake,25,2022-06-11,123,367,366,1,1072,3007,3000,7,2
Lassen,25,2022-06-11,59,164,164,0,1928,4483,4477,6,3
Los Angeles,25,2022-06-11,25030,53231,53207,24,411728,537099,536861,238,574
Madera,25,2022-06-11,322,755,753,2,3802,8514,8497,17,10
Marin,25,2022-06-11,584,1823,1820,3,6480,17375,17344,31,18
Mariposa,25,2022-06-11,31,82,82,0,355,925,923,2,0
Mendocino,25,2022-06-11,138,425,424,1,1567,3989,3978,11,7
Merced,25,2022-06-11,410,976,974,2,3486,7850,7836,14,13
Modoc,25,2022-06-11,9,13,13,0,35,55,54,1,1
Mono,25,2022-06-11,12,35,35,0,73,185,184,1,0
Monterey,25,2022-06-11,638,1650,1645,5,8242,19917,19854,63,27
Napa,25,2022-06-11,437,1002,1000,2,3807,8999,8984,15,5
Nevada,25,2022-06-11,152,330,329,1,1683,3178,3171,7,6
Orange,25,2022-06-11,6205,14207,14184,23,58088,131025,130815,210,189
Placer,25,2022-06-11,690,1580,1576,4,6542,14973,14939,34,80
Plumas,25,2022-06-11,23,52,52,0,282,733,731,2,0
Riverside,25,2022-06-11,4232,10155,10134,21,44990,101152,100942,210,96
Sacramento,25,2022-06-11,4020,10319,10302,17,33774,77650,77523,127,175
San Benito,25,2022-06-11,220,505,504,1,1758,4369,4363,6,3
San Bernardino,25,2022-06-11,4058,8830,8819,11,44347,94446,94332,114,85
San Diego,25,2022-06-11,8924,21506,21495,11,80471,195067,194968,99,216
San Francisco,25,2022-06-11,2764,7321,7303,18,30637,75583,75397,186,79
San Joaquin,25,2022-06-11,1730,3844,3837,7,17498,36555,36489,66,43
San Luis Obispo,25,2022-06-11,558,1173,1171,2,5557,11073,11057,16,20
San Mateo,25,2022-06-11,2359,5675,5669,6,28231,65172,65102,70,47
Santa Barbara,25,2022-06-11,837,1879,1876,3,9540,21429,21394,35,23
Santa Clara,25,2022-06-11,6532,17638,17629,9,77128,178846,178753,93,198
Santa Cruz,25,2022-06-11,741,1732,1730,2,9991,20320,20294,26,13
Shasta,25,2022-06-11,156,248,247,1,3069,5115,5104,11,10
Siskiyou,25,2022-06-11,35,141,141,0,352,902,901,1,1
Solano,25,2022-06-11,1415,3613,3607,6,11394,27096,27053,43,43
Sonoma,25,2022-06-11,1181,2749,2745,4,10857,24985,24945,40,46
Stanislaus,25,2022-06-11,992,2518,2512,6,8866,20858,20805,53,59
Sutter,25,2022-06-11,187,508,507,1,1758,4204,4196,8,0
Tehama,25,2022-06-11,70,145,145,0,729,1422,1418,4,3
Trinity,25,2022-06-11,4,21,21,0,64,126,125,1,0
Tulare,25,2022-06-11,689,1581,1577,4,8764,16948,16903,45,23
Tuolumne,25,2022-06-11,101,321,320,1,1448,3634,3627,7,3
Ventura,25,2022-06-11,1589,3687,3683,4,19540,46180,46132,48,36
Yolo,25,2022-06-11,664,1892,1890,2,14835,34168,34123,45,2
Yuba,25,2022-06-11,166,402,401,1,1411,3627,3621,6,9
