county,time,date,cases,est_cases,est_omicron_cases,est_other_cases,tests,est_tests,est_omicron_tests,est_other_tests,hospitalizations
Alameda,0.42857142857142855,2021-12-15,854,866,218,648,46790,47438,11763,35675,116
Amador,0.42857142857142855,2021-12-15,17,17,4,13,979,992,251,741,8
Butte,0.42857142857142855,2021-12-15,79,79,20,59,2455,2489,606,1883,27
Calaveras,0.42857142857142855,2021-12-15,29,29,7,22,1130,1146,289,857,5
Colusa,0.42857142857142855,2021-12-15,9,9,2,7,254,258,63,195,0
Contra Costa,0.42857142857142855,2021-12-15,509,516,129,387,23191,23512,5805,17707,46
Del Norte,0.42857142857142855,2021-12-15,10,10,2,8,729,739,179,560,0
El Dorado,0.42857142857142855,2021-12-15,92,92,23,69,2306,2338,564,1774,10
Fresno,0.42857142857142855,2021-12-15,475,481,121,360,14512,14713,3643,11070,200
Glenn,0.42857142857142855,2021-12-15,6,6,1,5,263,267,60,207,0
Humboldt,0.42857142857142855,2021-12-15,67,67,16,51,1835,1860,463,1397,15
Imperial,0.42857142857142855,2021-12-15,283,287,66,221,3305,3351,801,2550,66
Inyo,0.42857142857142855,2021-12-15,6,6,1,5,197,200,47,153,2
Kern,0.42857142857142855,2021-12-15,427,433,106,327,16418,16644,3942,12702,127
Kings,0.42857142857142855,2021-12-15,133,136,33,103,4499,4561,1109,3452,25
Lake,0.42857142857142855,2021-12-15,19,19,5,14,820,832,199,633,0
Lassen,0.42857142857142855,2021-12-15,3,3,1,2,1204,1221,277,944,0
Los Angeles,0.42857142857142855,2021-12-15,9134,9261,2381,6880,576209,584199,149612,434587,861
Madera,0.42857142857142855,2021-12-15,84,84,21,63,3582,3632,901,2731,23
Marin,0.42857142857142855,2021-12-15,161,164,41,123,5447,5522,1370,4152,10
Mariposa,0.42857142857142855,2021-12-15,7,7,2,5,203,206,52,154,0
Mendocino,0.42857142857142855,2021-12-15,53,53,14,39,1379,1397,343,1054,3
Merced,0.42857142857142855,2021-12-15,116,118,31,87,3191,3235,767,2468,24
Modoc,0.42857142857142855,2021-12-15,2,2,1,1,30,30,8,22,3
Mono,0.42857142857142855,2021-12-15,8,8,2,6,134,135,39,96,0
Monterey,0.42857142857142855,2021-12-15,163,166,43,123,5893,5975,1501,4474,27
Napa,0.42857142857142855,2021-12-15,84,85,20,65,3400,3447,842,2605,7
Nevada,0.42857142857142855,2021-12-15,71,71,18,53,1535,1556,382,1174,8
Orange,0.42857142857142855,2021-12-15,1502,1523,385,1138,48359,49029,12391,36638,206
Placer,0.42857142857142855,2021-12-15,202,205,52,153,6082,6167,1519,4648,92
Plumas,0.42857142857142855,2021-12-15,12,12,3,9,290,294,71,223,0
Riverside,0.42857142857142855,2021-12-15,1923,1949,488,1461,41773,42350,10421,31929,334
Sacramento,0.42857142857142855,2021-12-15,855,867,220,647,29212,29616,7300,22316,169
San Benito,0.42857142857142855,2021-12-15,47,47,12,35,1170,1186,287,899,5
San Bernardino,0.42857142857142855,2021-12-15,1802,1827,457,1370,42647,43238,10794,32444,422
San Diego,0.42857142857142855,2021-12-15,2843,2882,741,2141,76175,77230,19283,57947,375
San Francisco,0.42857142857142855,2021-12-15,812,823,210,613,24157,24493,6329,18164,43
San Joaquin,0.42857142857142855,2021-12-15,393,399,100,299,15764,15982,3902,12080,83
San Luis Obispo,0.42857142857142855,2021-12-15,157,160,41,119,5670,5749,1426,4323,12
San Mateo,0.42857142857142855,2021-12-15,394,399,103,296,24794,25138,6452,18686,30
Santa Barbara,0.42857142857142855,2021-12-15,257,260,67,193,8549,8668,2180,6488,44
Santa Clara,0.42857142857142855,2021-12-15,861,873,221,652,65767,66678,16655,50023,144
Santa Cruz,0.42857142857142855,2021-12-15,167,170,44,126,11593,11754,2803,8951,15
Shasta,0.42857142857142855,2021-12-15,75,75,19,56,4014,4069,991,3078,30
Siskiyou,0.42857142857142855,2021-12-15,9,9,3,6,304,308,74,234,4
Solano,0.42857142857142855,2021-12-15,175,178,43,135,8047,8159,2007,6152,38
Sonoma,0.42857142857142855,2021-12-15,270,273,68,205,12320,12491,3079,9412,28
Stanislaus,0.42857142857142855,2021-12-15,302,306,76,230,8170,8283,2019,6264,120
Sutter,0.42857142857142855,2021-12-15,31,31,8,23,1205,1222,306,916,0
Tehama,0.42857142857142855,2021-12-15,27,27,6,21,746,756,188,568,6
Trinity,0.42857142857142855,2021-12-15,2,2,0,2,66,66,17,49,0
Tulare,0.42857142857142855,2021-12-15,204,207,52,155,7656,7762,1856,5906,64
Tuolumne,0.42857142857142855,2021-12-15,40,40,10,30,1078,1092,273,819,6
Ventura,0.42857142857142855,2021-12-15,640,649,164,485,21441,21738,5405,16333,70
Yolo,0.42857142857142855,2021-12-15,129,131,31,100,13170,13353,3320,10033,2
Yuba,0.42857142857142855,2021-12-15,48,48,12,36,981,994,241,753,16
Alameda,0.8571428571428571,2021-12-18,982,996,504,492,32852,33332,16219,17113,101
Amador,0.8571428571428571,2021-12-18,21,21,11,10,581,590,287,303,5
Butte,0.8571428571428571,2021-12-18,56,56,29,27,1455,1476,725,751,27
Calaveras,0.8571428571428571,2021-12-18,18,18,9,9,492,499,245,254,1
Colusa,0.8571428571428571,2021-12-18,2,2,1,1,185,188,87,101,0
Contra Costa,0.8571428571428571,2021-12-18,636,645,325,320,16151,16386,7972,8414,46
Del Norte,0.8571428571428571,2021-12-18,5,5,3,2,551,559,275,284,0
El Dorado,0.8571428571428571,2021-12-18,96,97,49,48,1843,1870,907,963,9
Fresno,0.8571428571428571,2021-12-18,389,395,198,197,9791,9934,4853,5081,198
Glenn,0.8571428571428571,2021-12-18,5,5,3,2,135,138,71,67,0
Humboldt,0.8571428571428571,2021-12-18,65,65,33,32,1478,1499,711,788,11
Imperial,0.8571428571428571,2021-12-18,216,219,109,110,2213,2245,1078,1167,63
Inyo,0.8571428571428571,2021-12-18,14,14,7,7,141,143,69,74,1
Kern,0.8571428571428571,2021-12-18,368,373,185,188,10708,10863,5187,5676,124
Kings,0.8571428571428571,2021-12-18,70,70,34,36,2476,2513,1213,1300,20
Lake,0.8571428571428571,2021-12-18,17,17,8,9,507,515,254,261,0
Lassen,0.8571428571428571,2021-12-18,3,3,2,1,1018,1033,504,529,0
Los Angeles,0.8571428571428571,2021-12-18,11823,11997,6073,5924,415596,421651,200614,221037,828
Madera,0.8571428571428571,2021-12-18,62,62,31,31,2180,2212,1064,1148,16
Marin,0.8571428571428571,2021-12-18,182,185,95,90,5003,5075,2502,2573,13
Mariposa,0.8571428571428571,2021-12-18,10,10,5,5,222,225,111,114,0
Mendocino,0.8571428571428571,2021-12-18,26,26,14,12,1036,1051,509,542,5
Merced,0.8571428571428571,2021-12-18,106,108,54,54,1911,1939,931,1008,22
Modoc,0.8571428571428571,2021-12-18,0,0,0,0,19,19,9,10,2
Mono,0.8571428571428571,2021-12-18,15,15,8,7,156,158,82,76,0
Monterey,0.8571428571428571,2021-12-18,150,153,77,76,4017,4075,1970,2105,25
Napa,0.8571428571428571,2021-12-18,87,87,44,43,2020,2049,997,1052,6
Nevada,0.8571428571428571,2021-12-18,59,59,29,30,1003,1018,498,520,6
Orange,0.8571428571428571,2021-12-18,1708,1733,876,857,39714,40294,19624,20670,199
Placer,0.8571428571428571,2021-12-18,181,184,93,91,4080,4140,2001,2139,102
Plumas,0.8571428571428571,2021-12-18,5,5,2,3,167,169,80,89,0
Riverside,0.8571428571428571,2021-12-18,2148,2180,1097,1083,30336,30779,15068,15711,332
Sacramento,0.8571428571428571,2021-12-18,807,818,407,411,20652,20953,10141,10812,167
San Benito,0.8571428571428571,2021-12-18,22,22,10,12,617,626,295,331,5
San Bernardino,0.8571428571428571,2021-12-18,1693,1718,870,848,31041,31494,15351,16143,412
San Diego,0.8571428571428571,2021-12-18,3290,3338,1668,1670,58762,59622,29477,30145,379
San Francisco,0.8571428571428571,2021-12-18,989,1004,508,496,22412,22740,11171,11569,52
San Joaquin,0.8571428571428571,2021-12-18,338,343,167,176,8839,8968,4275,4693,83
San Luis Obispo,0.8571428571428571,2021-12-18,144,146,72,74,3566,3617,1736,1881,15
San Mateo,0.8571428571428571,2021-12-18,471,478,246,232,17275,17527,8501,9026,21
Santa Barbara,0.8571428571428571,2021-12-18,276,280,142,138,6028,6116,2993,3123,32
Santa Clara,0.8571428571428571,2021-12-18,1010,1025,524,501,46452,47130,22939,24191,150
Santa Cruz,0.8571428571428571,2021-12-18,133,136,69,67,9011,9142,4308,4834,14
Shasta,0.8571428571428571,2021-12-18,58,58,29,29,1783,1809,857,952,31
Siskiyou,0.8571428571428571,2021-12-18,6,6,3,3,123,125,61,64,4
Solano,0.8571428571428571,2021-12-18,200,203,103,100,5290,5367,2619,2748,41
Sonoma,0.8571428571428571,2021-12-18,276,279,142,137,7596,7707,3697,4010,32
Stanislaus,0.8571428571428571,2021-12-18,246,250,121,129,4388,4452,2134,2318,116
Sutter,0.8571428571428571,2021-12-18,44,44,21,23,800,812,396,416,0
Tehama,0.8571428571428571,2021-12-18,21,21,11,10,490,497,237,260,7
Trinity,0.8571428571428571,2021-12-18,1,1,0,1,33,33,16,17,0
Tulare,0.8571428571428571,2021-12-18,142,145,73,72,4212,4273,2046,2227,51
Tuolumne,0.8571428571428571,2021-12-18,40,40,21,19,731,742,357,385,8
Ventura,0.8571428571428571,2021-12-18,732,743,379,364,14492,14704,7180,7524,79
Yolo,0.8571428571428571,2021-12-18,109,110,56,54,10570,10725,5201,5524,6
Yuba,0.8571428571428571,2021-12-18,37,37,19,18,756,767,374,393,7
Alameda,1.2857142857142858,2021-12-21,2115,2148,1583,565,36990,37570,27857,9713,80
Amador,1.2857142857142858,2021-12-21,31,31,23,8,748,760,561,199,5
Butte,1.2857142857142858,2021-12-21,132,134,100,34,1942,1973,1454,519,26
Calaveras,1.2857142857142858,2021-12-21,33,33,24,9,530,539,397,142,1
Colusa,1.2857142857142858,2021-12-21,4,4,3,1,117,119,88,31,2
Contra Costa,1.2857142857142858,2021-12-21,1195,1213,894,319,19944,20256,14967,5289,51
Del Norte,1.2857142857142858,2021-12-21,9,9,6,3,598,607,445,162,0
El Dorado,1.2857142857142858,2021-12-21,145,147,108,39,2089,2121,1568,553,6
Fresno,1.2857142857142858,2021-12-21,570,580,427,153,10808,10978,8112,2866,191
Glenn,1.2857142857142858,2021-12-21,15,15,11,4,253,257,189,68,0
Humboldt,1.2857142857142858,2021-12-21,98,100,74,26,1702,1729,1273,456,14
Imperial,1.2857142857142858,2021-12-21,301,306,224,82,2751,2794,2071,723,69
Inyo,1.2857142857142858,2021-12-21,18,18,13,5,179,182,134,48,2
Kern,1.2857142857142858,2021-12-21,479,486,357,129,10159,10318,7624,2694,111
Kings,1.2857142857142858,2021-12-21,132,134,98,36,2925,2971,2203,768,16
Lake,1.2857142857142858,2021-12-21,15,15,11,4,511,519,384,135,0
Lassen,1.2857142857142858,2021-12-21,8,8,6,2,1135,1153,839,314,1
Los Angeles,1.2857142857142858,2021-12-21,23797,24170,17897,6273,300070,304775,225760,79015,872
Madera,1.2857142857142858,2021-12-21,68,68,50,18,2244,2279,1680,599,16
Marin,1.2857142857142858,2021-12-21,487,495,364,131,5953,6047,4478,1569,13
Mariposa,1.2857142857142858,2021-12-21,16,16,12,4,212,215,161,54,0
Mendocino,1.2857142857142858,2021-12-21,35,35,26,9,1372,1393,1033,360,5
Merced,1.2857142857142858,2021-12-21,185,188,137,51,2677,2719,2005,714,23
Modoc,1.2857142857142858,2021-12-21,3,3,2,1,39,39,29,10,3
Mono,1.2857142857142858,2021-12-21,25,25,19,6,189,192,147,45,1
Monterey,1.2857142857142858,2021-12-21,176,179,131,48,4104,4168,3075,1093,27
Napa,1.2857142857142858,2021-12-21,181,183,136,47,2156,2190,1625,565,4
Nevada,1.2857142857142858,2021-12-21,97,99,73,26,1466,1489,1105,384,5
Orange,1.2857142857142858,2021-12-21,3589,3645,2689,956,46390,47117,34811,12306,224
Placer,1.2857142857142858,2021-12-21,348,354,257,97,5317,5400,3968,1432,98
Plumas,1.2857142857142858,2021-12-21,5,5,4,1,222,225,167,58,0
Riverside,1.2857142857142858,2021-12-21,3539,3595,2643,952,36962,37541,27659,9882,359
Sacramento,1.2857142857142858,2021-12-21,1288,1309,965,344,23594,23963,17698,6265,167
San Benito,1.2857142857142858,2021-12-21,86,87,65,22,1020,1036,767,269,4
San Bernardino,1.2857142857142858,2021-12-21,3328,3381,2491,890,37973,38569,28637,9932,432
San Diego,1.2857142857142858,2021-12-21,6665,6769,5025,1744,74733,75904,56150,19754,387
San Francisco,1.2857142857142858,2021-12-21,2384,2421,1783,638,26526,26942,19928,7014,50
San Joaquin,1.2857142857142858,2021-12-21,587,596,440,156,10524,10689,7921,2768,73
San Luis Obispo,1.2857142857142858,2021-12-21,262,267,197,70,5200,5282,3927,1355,17
San Mateo,1.2857142857142858,2021-12-21,1057,1073,790,283,18793,19087,14112,4975,26
Santa Barbara,1.2857142857142858,2021-12-21,522,529,389,140,6920,7028,5189,1839,35
Santa Clara,1.2857142857142858,2021-12-21,2315,2351,1729,622,46571,47301,34875,12426,145
Santa Cruz,1.2857142857142858,2021-12-21,233,237,173,64,5622,5709,4249,1460,14
Shasta,1.2857142857142858,2021-12-21,78,79,57,22,2694,2736,2028,708,35
Siskiyou,1.2857142857142858,2021-12-21,6,6,4,2,175,178,130,48,2
Solano,1.2857142857142858,2021-12-21,291,296,219,77,6641,6746,5019,1727,38
Sonoma,1.2857142857142858,2021-12-21,480,488,357,131,9130,9273,6871,2402,24
Stanislaus,1.2857142857142858,2021-12-21,344,349,255,94,5417,5502,4039,1463,127
Sutter,1.2857142857142858,2021-12-21,79,80,58,22,1027,1043,767,276,0
Tehama,1.2857142857142858,2021-12-21,21,21,15,6,547,556,411,145,9
Trinity,1.2857142857142858,2021-12-21,0,0,0,0,51,51,38,13,0
Tulare,1.2857142857142858,2021-12-21,216,219,161,58,5912,6005,4441,1564,46
Tuolumne,1.2857142857142858,2021-12-21,42,42,30,12,873,886,652,234,8
Ventura,1.2857142857142858,2021-12-21,1372,1393,1021,372,16553,16811,12350,4461,82
Yolo,1.2857142857142858,2021-12-21,198,201,148,53,9674,9825,7266,2559,5
Yuba,1.2857142857142858,2021-12-21,44,44,32,12,815,828,611,217,11
Alameda,1.7142857142857142,2021-12-24,2476,2516,2124,392,37919,38545,32357,6188,107
Amador,1.7142857142857142,2021-12-24,35,35,30,5,672,683,573,110,3
Butte,1.7142857142857142,2021-12-24,158,161,136,25,1723,1752,1472,280,26
Calaveras,1.7142857142857142,2021-12-24,32,32,27,5,410,417,349,68,2
Colusa,1.7142857142857142,2021-12-24,8,8,7,1,107,108,90,18,2
Contra Costa,1.7142857142857142,2021-12-24,1555,1581,1335,246,20807,21150,17772,3378,61
Del Norte,1.7142857142857142,2021-12-24,4,4,3,1,596,606,513,93,0
El Dorado,1.7142857142857142,2021-12-24,179,182,154,28,1959,1991,1672,319,11
Fresno,1.7142857142857142,2021-12-24,704,715,604,111,10970,11151,9388,1763,167
Glenn,1.7142857142857142,2021-12-24,24,24,20,4,144,146,122,24,0
Humboldt,1.7142857142857142,2021-12-24,179,182,154,28,1340,1362,1136,226,11
Imperial,1.7142857142857142,2021-12-24,235,238,201,37,2409,2448,2066,382,54
Inyo,1.7142857142857142,2021-12-24,42,42,36,6,224,229,192,37,0
Kern,1.7142857142857142,2021-12-24,593,603,509,94,8682,8826,7445,1381,102
Kings,1.7142857142857142,2021-12-24,140,143,121,22,2274,2312,1951,361,20
Lake,1.7142857142857142,2021-12-24,21,21,18,3,578,588,492,96,0
Lassen,1.7142857142857142,2021-12-24,8,8,7,1,961,977,828,149,1
Los Angeles,1.7142857142857142,2021-12-24,35723,36315,30647,5668,335205,340742,286415,54327,947
Madera,1.7142857142857142,2021-12-24,105,108,91,17,1782,1811,1530,281,14
Marin,1.7142857142857142,2021-12-24,523,532,450,82,7749,7877,6639,1238,8
Mariposa,1.7142857142857142,2021-12-24,13,13,11,2,286,290,243,47,0
Mendocino,1.7142857142857142,2021-12-24,33,33,28,5,1059,1077,901,176,6
Merced,1.7142857142857142,2021-12-24,188,191,161,30,2011,2044,1720,324,18
Modoc,1.7142857142857142,2021-12-24,2,2,2,0,15,15,13,2,2
Mono,1.7142857142857142,2021-12-24,34,34,28,6,159,162,134,28,1
Monterey,1.7142857142857142,2021-12-24,213,217,184,33,3724,3785,3177,608,34
Napa,1.7142857142857142,2021-12-24,308,313,265,48,3285,3339,2814,525,5
Nevada,1.7142857142857142,2021-12-24,79,79,67,12,981,996,835,161,6
Orange,1.7142857142857142,2021-12-24,5946,6045,5111,934,55248,56161,47299,8862,237
Placer,1.7142857142857142,2021-12-24,434,441,374,67,4657,4733,3982,751,88
Plumas,1.7142857142857142,2021-12-24,3,3,3,0,148,150,126,24,0
Riverside,1.7142857142857142,2021-12-24,4663,4741,4004,737,36891,37500,31530,5970,381
Sacramento,1.7142857142857142,2021-12-24,1667,1694,1431,263,22840,23217,19534,3683,187
San Benito,1.7142857142857142,2021-12-24,111,113,95,18,983,999,839,160,5
San Bernardino,1.7142857142857142,2021-12-24,4241,4312,3642,670,38845,39486,33136,6350,419
San Diego,1.7142857142857142,2021-12-24,9580,9739,8202,1537,77180,78455,65901,12554,352
San Francisco,1.7142857142857142,2021-12-24,2570,2613,2209,404,30835,31345,26385,4960,41
San Joaquin,1.7142857142857142,2021-12-24,766,779,658,121,9599,9757,8206,1551,70
San Luis Obispo,1.7142857142857142,2021-12-24,359,365,307,58,4653,4730,3970,760,21
San Mateo,1.7142857142857142,2021-12-24,1495,1520,1287,233,20962,21308,17916,3392,29
Santa Barbara,1.7142857142857142,2021-12-24,675,686,581,105,6500,6608,5555,1053,42
Santa Clara,1.7142857142857142,2021-12-24,3019,3068,2598,470,48143,48939,41179,7760,124
Santa Cruz,1.7142857142857142,2021-12-24,329,335,284,51,5670,5764,4808,956,14
Shasta,1.7142857142857142,2021-12-24,84,84,71,13,1749,1778,1485,293,37
Siskiyou,1.7142857142857142,2021-12-24,4,4,3,1,147,150,127,23,0
Solano,1.7142857142857142,2021-12-24,435,442,373,69,6746,6857,5773,1084,41
Sonoma,1.7142857142857142,2021-12-24,675,687,581,106,9484,9641,8099,1542,17
Stanislaus,1.7142857142857142,2021-12-24,419,425,359,66,4328,4399,3695,704,117
Sutter,1.7142857142857142,2021-12-24,76,77,65,12,867,881,742,139,0
Tehama,1.7142857142857142,2021-12-24,34,34,29,5,456,463,388,75,11
Trinity,1.7142857142857142,2021-12-24,0,0,0,0,37,37,31,6,0
Tulare,1.7142857142857142,2021-12-24,257,261,221,40,4235,4304,3623,681,44
Tuolumne,1.7142857142857142,2021-12-24,62,62,52,10,794,807,679,128,4
Ventura,1.7142857142857142,2021-12-24,1758,1787,1512,275,15761,16021,13457,2564,81
Yolo,1.7142857142857142,2021-12-24,247,251,212,39,10117,10283,8567,1716,6
Yuba,1.7142857142857142,2021-12-24,47,47,40,7,605,615,518,97,12
Alameda,2.142857142857143,2021-12-27,3584,3648,3335,313,28154,28663,26277,2386,134
Amador,2.142857142857143,2021-12-27,41,41,37,4,482,491,450,41,5
Butte,2.142857142857143,2021-12-27,293,299,273,26,1863,1896,1739,157,40
Calaveras,2.142857142857143,2021-12-27,56,56,51,5,400,407,374,33,2
Colusa,2.142857142857143,2021-12-27,16,16,15,1,77,78,72,6,4
Contra Costa,2.142857142857143,2021-12-27,2712,2761,2529,232,16335,16630,15242,1388,77
Del Norte,2.142857142857143,2021-12-27,19,19,17,2,614,625,574,51,1
El Dorado,2.142857142857143,2021-12-27,245,250,229,21,1262,1285,1179,106,11
Fresno,2.142857142857143,2021-12-27,1086,1106,1012,94,8760,8919,8177,742,177
Glenn,2.142857142857143,2021-12-27,17,17,16,1,213,217,199,18,0
Humboldt,2.142857142857143,2021-12-27,274,279,255,24,1419,1445,1326,119,10
Imperial,2.142857142857143,2021-12-27,464,472,432,40,2334,2376,2179,197,61
Inyo,2.142857142857143,2021-12-27,65,65,59,6,158,160,147,13,0
Kern,2.142857142857143,2021-12-27,1172,1193,1092,101,9626,9800,8987,813,115
Kings,2.142857142857143,2021-12-27,282,287,262,25,1930,1965,1804,161,20
Lake,2.142857142857143,2021-12-27,35,35,32,3,367,373,342,31,0
Lassen,2.142857142857143,2021-12-27,10,10,9,1,946,964,880,84,0
Los Angeles,2.142857142857143,2021-12-27,44641,45446,41649,3797,238998,243315,223106,20209,1160
Madera,2.142857142857143,2021-12-27,199,203,186,17,1639,1669,1532,137,15
Marin,2.142857142857143,2021-12-27,857,872,796,76,6131,6242,5712,530,6
Mariposa,2.142857142857143,2021-12-27,14,14,13,1,76,77,71,6,0
Mendocino,2.142857142857143,2021-12-27,103,105,96,9,773,787,722,65,7
Merced,2.142857142857143,2021-12-27,385,392,359,33,2121,2160,1983,177,21
Modoc,2.142857142857143,2021-12-27,1,1,1,0,12,12,11,1,1
Mono,2.142857142857143,2021-12-27,25,25,23,2,67,68,62,6,1
Monterey,2.142857142857143,2021-12-27,350,356,325,31,2736,2785,2552,233,32
Napa,2.142857142857143,2021-12-27,404,411,376,35,2444,2488,2286,202,7
Nevada,2.142857142857143,2021-12-27,110,111,101,10,409,416,381,35,7
Orange,2.142857142857143,2021-12-27,9984,10164,9311,853,53662,54631,50082,4549,341
Placer,2.142857142857143,2021-12-27,630,641,586,55,4118,4192,3845,347,107
Plumas,2.142857142857143,2021-12-27,10,10,9,1,49,50,46,4,0
Riverside,2.142857142857143,2021-12-27,7285,7417,6785,632,34947,35578,32624,2954,408
Sacramento,2.142857142857143,2021-12-27,2674,2722,2492,230,19566,19920,18278,1642,194
San Benito,2.142857142857143,2021-12-27,155,158,145,13,843,858,786,72,4
San Bernardino,2.142857142857143,2021-12-27,7511,7646,6996,650,30983,31543,28936,2607,527
San Diego,2.142857142857143,2021-12-27,13620,13866,12708,1158,66483,67683,62047,5636,427
San Francisco,2.142857142857143,2021-12-27,3008,3063,2798,265,19383,19733,18081,1652,51
San Joaquin,2.142857142857143,2021-12-27,1306,1330,1217,113,8746,8904,8171,733,89
San Luis Obispo,2.142857142857143,2021-12-27,619,630,578,52,4321,4399,4041,358,19
San Mateo,2.142857142857143,2021-12-27,2274,2314,2114,200,14226,14482,13263,1219,33
Santa Barbara,2.142857142857143,2021-12-27,1211,1232,1126,106,5869,5975,5480,495,44
Santa Clara,2.142857142857143,2021-12-27,4964,5053,4619,434,36755,37419,34310,3109,163
Santa Cruz,2.142857142857143,2021-12-27,517,526,481,45,4144,4219,3876,343,13
Shasta,2.142857142857143,2021-12-27,145,149,136,13,1816,1849,1698,151,44
Siskiyou,2.142857142857143,2021-12-27,16,16,15,1,165,168,154,14,0
Solano,2.142857142857143,2021-12-27,665,677,621,56,5813,5918,5434,484,43
Sonoma,2.142857142857143,2021-12-27,1014,1033,944,89,7995,8140,7469,671,26
Stanislaus,2.142857142857143,2021-12-27,692,705,644,61,4763,4849,4439,410,119
Sutter,2.142857142857143,2021-12-27,123,125,114,11,862,878,804,74,0
Tehama,2.142857142857143,2021-12-27,59,60,55,5,415,422,387,35,9
Trinity,2.142857142857143,2021-12-27,3,3,3,0,34,34,31,3,0
Tulare,2.142857142857143,2021-12-27,412,419,383,36,4582,4665,4284,381,48
Tuolumne,2.142857142857143,2021-12-27,91,93,85,8,533,542,496,46,6
Ventura,2.142857142857143,2021-12-27,3430,3492,3193,299,17612,17929,16426,1503,94
Yolo,2.142857142857143,2021-12-27,460,468,428,40,7602,7740,7125,615,12
Yuba,2.142857142857143,2021-12-27,96,97,89,8,589,599,549,50,12
Alameda,2.5714285714285716,2021-12-30,8727,8896,8355,541,63593,64821,60852,3969,159
Amador,2.5714285714285716,2021-12-30,70,71,67,4,1167,1189,1117,72,7
Butte,2.5714285714285716,2021-12-30,404,412,387,25,3159,3221,3025,196,38
Calaveras,2.5714285714285716,2021-12-30,62,62,58,4,622,634,595,39,2
Colusa,2.5714285714285716,2021-12-30,25,25,23,2,205,209,196,13,4
Contra Costa,2.5714285714285716,2021-12-30,6448,6573,6170,403,36553,37258,34975,2283,88
Del Norte,2.5714285714285716,2021-12-30,28,28,26,2,1070,1092,1025,67,1
El Dorado,2.5714285714285716,2021-12-30,582,593,557,36,3441,3507,3292,215,15
Fresno,2.5714285714285716,2021-12-30,2851,2907,2730,177,21902,22324,20957,1367,176
Glenn,2.5714285714285716,2021-12-30,43,43,40,3,270,276,259,17,0
Humboldt,2.5714285714285716,2021-12-30,339,345,324,21,2730,2783,2612,171,15
Imperial,2.5714285714285716,2021-12-30,682,695,652,43,4741,4833,4536,297,63
Inyo,2.5714285714285716,2021-12-30,117,120,113,7,375,383,360,23,2
Kern,2.5714285714285716,2021-12-30,2108,2148,2017,131,16580,16899,15859,1040,118
Kings,2.5714285714285716,2021-12-30,412,420,394,26,4653,4743,4450,293,21
Lake,2.5714285714285716,2021-12-30,62,63,59,4,901,918,863,55,1
Lassen,2.5714285714285716,2021-12-30,17,17,16,1,1405,1432,1344,88,2
Los Angeles,2.5714285714285716,2021-12-30,96429,98286,92211,6075,508968,518777,486766,32011,1599
Madera,2.5714285714285716,2021-12-30,346,352,330,22,3451,3517,3300,217,15
Marin,2.5714285714285716,2021-12-30,1148,1170,1098,72,10278,10476,9833,643,14
Mariposa,2.5714285714285716,2021-12-30,48,48,45,3,421,429,403,26,0
Mendocino,2.5714285714285716,2021-12-30,183,186,175,11,1977,2015,1890,125,7
Merced,2.5714285714285716,2021-12-30,689,702,659,43,4521,4608,4325,283,21
Modoc,2.5714285714285716,2021-12-30,5,5,5,0,37,37,35,2,0
Mono,2.5714285714285716,2021-12-30,138,141,132,9,302,308,288,20,3
Monterey,2.5714285714285716,2021-12-30,737,752,706,46,6812,6943,6518,425,28
Napa,2.5714285714285716,2021-12-30,899,916,860,56,6413,6537,6138,399,8
Nevada,2.5714285714285716,2021-12-30,248,253,238,15,1520,1550,1457,93,4
Orange,2.5714285714285716,2021-12-30,22231,22660,21269,1391,113538,115729,108629,7100,466
Placer,2.5714285714285716,2021-12-30,1323,1349,1267,82,8240,8399,7883,516,124
Plumas,2.5714285714285716,2021-12-30,16,16,15,1,256,261,245,16,2
Riverside,2.5714285714285716,2021-12-30,14837,15124,14202,922,73620,75040,70436,4604,494
Sacramento,2.5714285714285716,2021-12-30,6292,6414,6022,392,43000,43831,41148,2683,237
San Benito,2.5714285714285716,2021-12-30,397,405,380,25,1885,1922,1804,118,4
San Bernardino,2.5714285714285716,2021-12-30,15782,16087,15097,990,78430,79943,75038,4905,617
San Diego,2.5714285714285716,2021-12-30,30646,31238,29327,1911,133533,136110,127749,8361,535
San Francisco,2.5714285714285716,2021-12-30,4823,4916,4614,302,41298,42095,39516,2579,96
San Joaquin,2.5714285714285716,2021-12-30,3121,3181,2988,193,19881,20265,19029,1236,96
San Luis Obispo,2.5714285714285716,2021-12-30,1357,1384,1299,85,9236,9415,8835,580,28
San Mateo,2.5714285714285716,2021-12-30,3791,3864,3627,237,32778,33411,31365,2046,43
Santa Barbara,2.5714285714285716,2021-12-30,2192,2234,2097,137,12983,13234,12420,814,55
Santa Clara,2.5714285714285716,2021-12-30,9206,9384,8809,575,77672,79170,74311,4859,206
Santa Cruz,2.5714285714285716,2021-12-30,923,940,882,58,9330,9509,8923,586,17
Shasta,2.5714285714285716,2021-12-30,211,214,201,13,3245,3308,3104,204,46
Siskiyou,2.5714285714285716,2021-12-30,30,30,28,2,235,239,224,15,0
Solano,2.5714285714285716,2021-12-30,2230,2274,2134,140,14202,14475,13584,891,72
Sonoma,2.5714285714285716,2021-12-30,2210,2253,2116,137,17525,17864,16773,1091,28
Stanislaus,2.5714285714285716,2021-12-30,1428,1455,1366,89,9550,9734,9135,599,122
Sutter,2.5714285714285716,2021-12-30,169,172,162,10,1426,1454,1365,89,0
Tehama,2.5714285714285716,2021-12-30,53,53,50,3,644,656,615,41,6
Trinity,2.5714285714285716,2021-12-30,3,3,3,0,56,57,54,3,0
Tulare,2.5714285714285716,2021-12-30,774,789,741,48,8498,8662,8127,535,51
Tuolumne,2.5714285714285716,2021-12-30,133,136,128,8,1151,1173,1102,71,7
Ventura,2.5714285714285716,2021-12-30,6145,6263,5878,385,31144,31744,29794,1950,109
Yolo,2.5714285714285716,2021-12-30,840,856,803,53,16963,17290,16223,1067,12
Yuba,2.5714285714285716,2021-12-30,177,180,169,11,1172,1195,1122,73,23
Alameda,3,2022-01-02,3638,3715,3542,173,21929,22392,21341,1051,212
Amador,3,2022-01-02,73,74,71,3,407,416,396,20,6
Butte,3,2022-01-02,366,374,357,17,1476,1508,1437,71,33
Calaveras,3,2022-01-02,59,59,56,3,234,239,228,11,2
Colusa,3,2022-01-02,8,8,8,0,50,51,49,2,5
Contra Costa,3,2022-01-02,3186,3253,3101,152,13273,13554,12917,637,113
Del Norte,3,2022-01-02,25,25,24,1,478,488,465,23,0
El Dorado,3,2022-01-02,309,315,300,15,1128,1151,1097,54,17
Fresno,3,2022-01-02,1410,1440,1373,67,8050,8219,7830,389,219
Glenn,3,2022-01-02,12,12,11,1,86,88,84,4,0
Humboldt,3,2022-01-02,281,287,274,13,1092,1115,1063,52,11
Imperial,3,2022-01-02,393,401,382,19,1877,1915,1823,92,58
Inyo,3,2022-01-02,73,75,72,3,102,104,99,5,2
Kern,3,2022-01-02,1678,1713,1633,80,7580,7739,7374,365,131
Kings,3,2022-01-02,343,350,334,16,1570,1603,1527,76,14
Lake,3,2022-01-02,60,61,58,3,241,246,234,12,3
Lassen,3,2022-01-02,23,23,22,1,787,804,766,38,2
Los Angeles,3,2022-01-02,48684,49708,47356,2352,230744,235598,224461,11137,2168
Madera,3,2022-01-02,223,228,217,11,1183,1207,1150,57,23
Marin,3,2022-01-02,615,628,599,29,3423,3496,3334,162,23
Mariposa,3,2022-01-02,22,22,21,1,64,66,63,3,0
Mendocino,3,2022-01-02,139,142,136,6,665,679,648,31,11
Merced,3,2022-01-02,292,299,285,14,1361,1390,1324,66,26
Modoc,3,2022-01-02,8,8,8,0,8,8,8,0,0
Mono,3,2022-01-02,10,10,10,0,45,46,44,2,1
Monterey,3,2022-01-02,397,406,387,19,2618,2673,2547,126,36
Napa,3,2022-01-02,385,393,375,18,1833,1871,1781,90,11
Nevada,3,2022-01-02,182,185,176,9,494,504,480,24,8
Orange,3,2022-01-02,11355,11594,11045,549,48575,49595,47241,2354,568
Placer,3,2022-01-02,758,773,737,36,3078,3143,2994,149,146
Plumas,3,2022-01-02,17,17,16,1,52,53,50,3,1
Riverside,3,2022-01-02,8085,8256,7868,388,29542,30165,28744,1421,625
Sacramento,3,2022-01-02,2985,3048,2904,144,15641,15969,15212,757,291
San Benito,3,2022-01-02,147,150,143,7,644,658,627,31,6
San Bernardino,3,2022-01-02,7192,7344,7001,343,22700,23178,22086,1092,697
San Diego,3,2022-01-02,13518,13803,13156,647,58265,59495,56700,2795,688
San Francisco,3,2022-01-02,3140,3206,3056,150,17553,17924,17081,843,105
San Joaquin,3,2022-01-02,1856,1896,1807,89,6769,6911,6584,327,97
San Luis Obispo,3,2022-01-02,404,412,393,19,2426,2477,2360,117,22
San Mateo,3,2022-01-02,2771,2829,2697,132,13682,13972,13321,651,43
Santa Barbara,3,2022-01-02,1523,1554,1482,72,7587,7747,7384,363,57
Santa Clara,3,2022-01-02,7156,7307,6965,342,37639,38435,36631,1804,256
Santa Cruz,3,2022-01-02,744,760,724,36,3980,4065,3876,189,22
Shasta,3,2022-01-02,192,196,187,9,908,927,884,43,44
Siskiyou,3,2022-01-02,16,16,15,1,127,130,124,6,0
Solano,3,2022-01-02,746,762,726,36,4448,4541,4324,217,83
Sonoma,3,2022-01-02,887,906,863,43,5337,5450,5196,254,32
Stanislaus,3,2022-01-02,1023,1045,996,49,4004,4089,3898,191,140
Sutter,3,2022-01-02,194,198,189,9,743,758,723,35,0
Tehama,3,2022-01-02,88,91,87,4,251,256,244,12,3
Trinity,3,2022-01-02,7,7,7,0,24,24,23,1,0
Tulare,3,2022-01-02,578,590,562,28,2876,2936,2796,140,59
Tuolumne,3,2022-01-02,138,141,134,7,537,547,521,26,8
Ventura,3,2022-01-02,3551,3626,3456,170,13078,13352,12721,631,154
Yolo,3,2022-01-02,764,781,745,36,6172,6305,6023,282,8
Yuba,3,2022-01-02,165,168,160,8,533,544,518,26,24
Alameda,3.4285714285714284,2022-01-05,15623,15989,15340,649,97269,99547,95501,4046,253
Amador,3.4285714285714284,2022-01-05,187,191,183,8,1713,1753,1682,71,7
Butte,3.4285714285714284,2022-01-05,908,929,891,38,5439,5566,5339,227,48
Calaveras,3.4285714285714284,2022-01-05,190,194,186,8,1467,1501,1440,61,3
Colusa,3.4285714285714284,2022-01-05,25,25,24,1,382,391,375,16,5
Contra Costa,3.4285714285714284,2022-01-05,9575,9798,9399,399,53620,54875,52641,2234,149
Del Norte,3.4285714285714284,2022-01-05,80,82,79,3,1352,1383,1326,57,0
El Dorado,3.4285714285714284,2022-01-05,970,993,953,40,4719,4830,4634,196,15
Fresno,3.4285714285714284,2022-01-05,5807,5943,5702,241,29630,30323,29090,1233,269
Glenn,3.4285714285714284,2022-01-05,86,89,85,4,496,508,487,21,3
Humboldt,3.4285714285714284,2022-01-05,700,716,687,29,4189,4287,4113,174,18
Imperial,3.4285714285714284,2022-01-05,1825,1868,1792,76,7594,7771,7454,317,64
Inyo,3.4285714285714284,2022-01-05,213,218,209,9,696,712,683,29,4
Kern,3.4285714285714284,2022-01-05,5528,5658,5428,230,31258,31988,30683,1305,151
Kings,3.4285714285714284,2022-01-05,856,877,841,36,6619,6774,6498,276,23
Lake,3.4285714285714284,2022-01-05,198,203,195,8,1385,1417,1359,58,4
Lassen,3.4285714285714284,2022-01-05,54,55,53,2,1819,1861,1785,76,2
Los Angeles,3.4285714285714284,2022-01-05,163726,167566,160759,6807,923524,945166,906752,38414,2847
Madera,3.4285714285714284,2022-01-05,871,892,856,36,5722,5856,5618,238,30
Marin,3.4285714285714284,2022-01-05,1571,1607,1542,65,11185,11446,10980,466,20
Mariposa,3.4285714285714284,2022-01-05,109,112,107,5,570,583,559,24,0
Mendocino,3.4285714285714284,2022-01-05,385,394,378,16,3092,3165,3036,129,8
Merced,3.4285714285714284,2022-01-05,1710,1751,1680,71,7437,7611,7301,310,33
Modoc,3.4285714285714284,2022-01-05,7,7,7,0,63,64,61,3,0
Mono,3.4285714285714284,2022-01-05,193,198,190,8,517,529,508,21,3
Monterey,3.4285714285714284,2022-01-05,1551,1588,1524,64,11405,11673,11198,475,57
Napa,3.4285714285714284,2022-01-05,1584,1621,1555,66,8787,8991,8624,367,12
Nevada,3.4285714285714284,2022-01-05,478,489,469,20,2765,2830,2715,115,13
Orange,3.4285714285714284,2022-01-05,32010,32759,31426,1333,158761,162479,155872,6607,745
Placer,3.4285714285714284,2022-01-05,2228,2281,2188,93,11172,11433,10968,465,161
Plumas,3.4285714285714284,2022-01-05,45,45,43,2,377,385,369,16,3
Riverside,3.4285714285714284,2022-01-05,24821,25402,24369,1033,96005,98251,94252,3999,828
Sacramento,3.4285714285714284,2022-01-05,12727,13025,12496,529,65240,66766,64049,2717,329
San Benito,3.4285714285714284,2022-01-05,524,536,514,22,2265,2318,2224,94,6
San Bernardino,3.4285714285714284,2022-01-05,23405,23953,22979,974,97242,99520,95474,4046,861
San Diego,3.4285714285714284,2022-01-05,46376,47462,45532,1930,184634,188956,181269,7687,800
San Francisco,3.4285714285714284,2022-01-05,8029,8217,7883,334,57877,59231,56821,2410,138
San Joaquin,3.4285714285714284,2022-01-05,6593,6748,6474,274,32498,33260,31908,1352,130
San Luis Obispo,3.4285714285714284,2022-01-05,2345,2399,2301,98,12312,12600,12086,514,32
San Mateo,3.4285714285714284,2022-01-05,6597,6751,6476,275,51909,53124,50962,2162,76
Santa Barbara,3.4285714285714284,2022-01-05,4266,4366,4188,178,23361,23908,22936,972,64
Santa Clara,3.4285714285714284,2022-01-05,17971,18391,17642,749,137729,140948,135206,5742,337
Santa Cruz,3.4285714285714284,2022-01-05,2172,2222,2132,90,22069,22584,21663,921,17
Shasta,3.4285714285714284,2022-01-05,511,522,501,21,5005,5122,4913,209,49
Siskiyou,3.4285714285714284,2022-01-05,66,68,65,3,509,521,500,21,2
Solano,3.4285714285714284,2022-01-05,3448,3529,3386,143,19314,19766,18962,804,93
Sonoma,3.4285714285714284,2022-01-05,4532,4639,4451,188,26423,27040,25938,1102,41
Stanislaus,3.4285714285714284,2022-01-05,2859,2926,2807,119,14454,14792,14191,601,175
Sutter,3.4285714285714284,2022-01-05,465,477,458,19,2384,2439,2340,99,0
Tehama,3.4285714285714284,2022-01-05,217,222,213,9,1384,1416,1358,58,10
Trinity,3.4285714285714284,2022-01-05,14,14,13,1,139,143,137,6,0
Tulare,3.4285714285714284,2022-01-05,1995,2041,1958,83,12580,12874,12349,525,65
Tuolumne,3.4285714285714284,2022-01-05,325,333,319,14,2249,2301,2207,94,13
Ventura,3.4285714285714284,2022-01-05,9107,9320,8941,379,46538,47628,45690,1938,190
Yolo,3.4285714285714284,2022-01-05,1896,1940,1861,79,25939,26546,25466,1080,12
Yuba,3.4285714285714284,2022-01-05,430,440,422,18,1895,1939,1860,79,21
Alameda,3.857142857142857,2022-01-08,12918,13255,12735,520,77585,79604,76482,3122,338
Amador,3.857142857142857,2022-01-08,135,138,133,5,881,904,869,35,6
Butte,3.857142857142857,2022-01-08,803,824,792,32,3779,3877,3725,152,47
Calaveras,3.857142857142857,2022-01-08,205,210,202,8,873,896,861,35,2
Colusa,3.857142857142857,2022-01-08,40,41,39,2,221,226,217,9,5
Contra Costa,3.857142857142857,2022-01-08,7603,7802,7496,306,41503,42585,40915,1670,204
Del Norte,3.857142857142857,2022-01-08,67,69,66,3,2334,2395,2301,94,2
El Dorado,3.857142857142857,2022-01-08,789,809,777,32,3497,3587,3446,141,18
Fresno,3.857142857142857,2022-01-08,5453,5596,5376,220,25054,25709,24700,1009,306
Glenn,3.857142857142857,2022-01-08,95,98,94,4,330,339,326,13,2
Humboldt,3.857142857142857,2022-01-08,599,614,590,24,3295,3382,3249,133,16
Imperial,3.857142857142857,2022-01-08,1319,1354,1301,53,5418,5559,5341,218,74
Inyo,3.857142857142857,2022-01-08,149,153,147,6,515,528,507,21,4
Kern,3.857142857142857,2022-01-08,4221,4332,4162,170,20866,21409,20569,840,191
Kings,3.857142857142857,2022-01-08,835,857,823,34,4701,4823,4634,189,22
Lake,3.857142857142857,2022-01-08,199,204,196,8,1022,1048,1007,41,2
Lassen,3.857142857142857,2022-01-08,56,57,55,2,1368,1403,1348,55,2
Los Angeles,3.857142857142857,2022-01-08,137680,141275,135732,5543,785059,805518,773922,31596,3510
Madera,3.857142857142857,2022-01-08,733,752,722,30,3843,3943,3788,155,29
Marin,3.857142857142857,2022-01-08,1078,1106,1063,43,8365,8583,8246,337,30
Mariposa,3.857142857142857,2022-01-08,61,62,60,2,504,516,496,20,0
Mendocino,3.857142857142857,2022-01-08,310,318,306,12,1884,1933,1857,76,7
Merced,3.857142857142857,2022-01-08,1292,1325,1273,52,5101,5233,5028,205,39
Modoc,3.857142857142857,2022-01-08,4,4,4,0,28,28,27,1,0
Mono,3.857142857142857,2022-01-08,94,97,93,4,299,307,295,12,1
Monterey,3.857142857142857,2022-01-08,1505,1545,1484,61,8974,9207,8846,361,65
Napa,3.857142857142857,2022-01-08,975,1000,961,39,5517,5661,5439,222,15
Nevada,3.857142857142857,2022-01-08,486,499,479,20,1895,1945,1869,76,15
Orange,3.857142857142857,2022-01-08,23737,24356,23401,955,123628,126844,121870,4974,934
Placer,3.857142857142857,2022-01-08,1968,2019,1940,79,8652,8877,8529,348,180
Plumas,3.857142857142857,2022-01-08,35,35,34,1,260,266,256,10,4
Riverside,3.857142857142857,2022-01-08,18292,18769,18033,736,71230,73085,70219,2866,893
Sacramento,3.857142857142857,2022-01-08,10040,10301,9897,404,47254,48482,46581,1901,424
San Benito,3.857142857142857,2022-01-08,334,343,330,13,1556,1597,1534,63,6
San Bernardino,3.857142857142857,2022-01-08,18686,19173,18421,752,76107,78087,75025,3062,961
San Diego,3.857142857142857,2022-01-08,31594,32418,31146,1272,131020,134439,129164,5275,986
San Francisco,3.857142857142857,2022-01-08,6140,6299,6052,247,44687,45851,44053,1798,158
San Joaquin,3.857142857142857,2022-01-08,5611,5758,5532,226,24593,25230,24241,989,158
San Luis Obispo,3.857142857142857,2022-01-08,1710,1754,1685,69,8428,8646,8307,339,41
San Mateo,3.857142857142857,2022-01-08,5197,5334,5125,209,36619,37571,36098,1473,109
Santa Barbara,3.857142857142857,2022-01-08,3119,3201,3075,126,18438,18918,18176,742,77
Santa Clara,3.857142857142857,2022-01-08,13950,14315,13753,562,104806,107533,103316,4217,432
Santa Cruz,3.857142857142857,2022-01-08,1747,1793,1723,70,17251,17700,17006,694,18
Shasta,3.857142857142857,2022-01-08,394,405,389,16,2795,2867,2755,112,57
Siskiyou,3.857142857142857,2022-01-08,35,35,34,1,276,283,272,11,5
Solano,3.857142857142857,2022-01-08,2550,2617,2514,103,13913,14275,13715,560,103
Sonoma,3.857142857142857,2022-01-08,3161,3243,3116,127,17624,18082,17373,709,73
Stanislaus,3.857142857142857,2022-01-08,2617,2685,2580,105,10661,10939,10510,429,184
Sutter,3.857142857142857,2022-01-08,524,538,517,21,1818,1865,1792,73,0
Tehama,3.857142857142857,2022-01-08,208,213,205,8,913,936,899,37,12
Trinity,3.857142857142857,2022-01-08,15,15,14,1,117,120,115,5,0
Tulare,3.857142857142857,2022-01-08,1759,1805,1734,71,8697,8923,8573,350,65
Tuolumne,3.857142857142857,2022-01-08,274,281,270,11,1533,1573,1511,62,14
Ventura,3.857142857142857,2022-01-08,6997,7180,6898,282,34520,35419,34030,1389,233
Yolo,3.857142857142857,2022-01-08,1458,1497,1438,59,19146,19644,18874,770,8
Yuba,3.857142857142857,2022-01-08,414,426,409,17,1626,1668,1603,65,35
Alameda,4.285714285714286,2022-01-11,11191,11532,11047,485,76663,79000,75674,3326,366
Amador,4.285714285714286,2022-01-11,221,228,218,10,1903,1961,1878,83,9
Butte,4.285714285714286,2022-01-11,922,950,910,40,4523,4661,4465,196,64
Calaveras,4.285714285714286,2022-01-11,252,260,249,11,1125,1159,1110,49,2
Colusa,4.285714285714286,2022-01-11,62,64,61,3,315,325,311,14,4
Contra Costa,4.285714285714286,2022-01-11,6943,7153,6853,300,39214,40407,38709,1698,233
Del Norte,4.285714285714286,2022-01-11,80,82,79,3,1602,1650,1580,70,4
El Dorado,4.285714285714286,2022-01-11,1019,1050,1006,44,4286,4417,4231,186,16
Fresno,4.285714285714286,2022-01-11,6374,6569,6292,277,27424,28261,27070,1191,375
Glenn,4.285714285714286,2022-01-11,121,125,120,5,480,495,474,21,2
Humboldt,4.285714285714286,2022-01-11,612,630,604,26,3718,3831,3670,161,19
Imperial,4.285714285714286,2022-01-11,1591,1640,1571,69,6320,6513,6238,275,86
Inyo,4.285714285714286,2022-01-11,175,180,172,8,559,577,553,24,4
Kern,4.285714285714286,2022-01-11,6027,6210,5949,261,28543,29414,28176,1238,236
Kings,4.285714285714286,2022-01-11,1525,1572,1506,66,6931,7142,6841,301,38
Lake,4.285714285714286,2022-01-11,212,218,209,9,1117,1152,1104,48,2
Lassen,4.285714285714286,2022-01-11,119,123,118,5,1704,1756,1682,74,1
Los Angeles,4.285714285714286,2022-01-11,106528,109768,105156,4612,705293,726830,696195,30635,4071
Madera,4.285714285714286,2022-01-11,999,1029,986,43,4905,5056,4843,213,40
Marin,4.285714285714286,2022-01-11,1255,1294,1240,54,8229,8479,8123,356,23
Mariposa,4.285714285714286,2022-01-11,101,104,100,4,484,499,478,21,0
Mendocino,4.285714285714286,2022-01-11,460,473,453,20,2663,2744,2628,116,10
Merced,4.285714285714286,2022-01-11,1811,1867,1788,79,6742,6948,6655,293,48
Modoc,4.285714285714286,2022-01-11,4,4,4,0,60,62,59,3,0
Mono,4.285714285714286,2022-01-11,105,108,103,5,343,354,339,15,0
Monterey,4.285714285714286,2022-01-11,1610,1659,1589,70,9669,9963,9545,418,65
Napa,4.285714285714286,2022-01-11,894,921,883,38,4961,5112,4897,215,22
Nevada,4.285714285714286,2022-01-11,508,524,502,22,2546,2623,2513,110,12
Orange,4.285714285714286,2022-01-11,22117,22789,21832,957,122739,126479,121159,5320,1093
Placer,4.285714285714286,2022-01-11,2155,2220,2127,93,10039,10344,9909,435,229
Plumas,4.285714285714286,2022-01-11,59,61,58,3,364,375,359,16,6
Riverside,4.285714285714286,2022-01-11,20277,20893,20016,877,78590,80982,77579,3403,996
Sacramento,4.285714285714286,2022-01-11,9935,10238,9807,431,51164,52727,50505,2222,479
San Benito,4.285714285714286,2022-01-11,505,520,498,22,2186,2252,2158,94,7
San Bernardino,4.285714285714286,2022-01-11,18500,19063,18262,801,74999,77286,74033,3253,1077
San Diego,4.285714285714286,2022-01-11,29904,30813,29518,1295,124970,128776,123359,5417,1103
San Francisco,4.285714285714286,2022-01-11,4523,4660,4465,195,36518,37626,36048,1578,222
San Joaquin,4.285714285714286,2022-01-11,6706,6910,6620,290,30146,31064,29759,1305,229
San Luis Obispo,4.285714285714286,2022-01-11,1779,1834,1757,77,9869,10170,9741,429,43
San Mateo,4.285714285714286,2022-01-11,5147,5303,5081,222,39060,40248,38557,1691,129
Santa Barbara,4.285714285714286,2022-01-11,3581,3690,3535,155,20741,21371,20474,897,98
Santa Clara,4.285714285714286,2022-01-11,14941,15393,14748,645,113782,117245,112316,4929,486
Santa Cruz,4.285714285714286,2022-01-11,1994,2054,1968,86,20485,21111,20221,890,34
Shasta,4.285714285714286,2022-01-11,500,515,493,22,4494,4631,4436,195,51
Siskiyou,4.285714285714286,2022-01-11,71,73,70,3,563,580,556,24,4
Solano,4.285714285714286,2022-01-11,2560,2637,2526,111,14792,15243,14602,641,135
Sonoma,4.285714285714286,2022-01-11,3691,3804,3644,160,21753,22416,21472,944,83
Stanislaus,4.285714285714286,2022-01-11,3288,3388,3246,142,14139,14569,13957,612,205
Sutter,4.285714285714286,2022-01-11,627,645,618,27,2522,2599,2490,109,0
Tehama,4.285714285714286,2022-01-11,257,265,254,11,1253,1292,1237,55,19
Trinity,4.285714285714286,2022-01-11,15,15,14,1,90,92,88,4,0
Tulare,4.285714285714286,2022-01-11,3036,3129,2997,132,12913,13307,12746,561,85
Tuolumne,4.285714285714286,2022-01-11,358,370,355,15,1980,2040,1954,86,10
Ventura,4.285714285714286,2022-01-11,6779,6985,6692,293,35709,36796,35249,1547,268
Yolo,4.285714285714286,2022-01-11,1403,1446,1385,61,18929,19504,18685,819,12
Yuba,4.285714285714286,2022-01-11,524,540,517,23,1904,1963,1880,83,40
Alameda,4.714285714285714,2022-01-14,13034,13488,12843,645,89474,92596,88165,4431,442
Amador,4.714285714285714,2022-01-14,190,197,188,9,1666,1724,1643,81,7
Butte,4.714285714285714,2022-01-14,1028,1063,1012,51,4390,4542,4326,216,54
Calaveras,4.714285714285714,2022-01-14,330,342,326,16,1483,1535,1462,73,5
Colusa,4.714285714285714,2022-01-14,91,94,89,5,437,452,431,21,2
Contra Costa,4.714285714285714,2022-01-14,7890,8165,7775,390,47142,48781,46454,2327,242
Del Norte,4.714285714285714,2022-01-14,89,92,88,4,2179,2253,2148,105,2
El Dorado,4.714285714285714,2022-01-14,862,892,850,42,3929,4066,3872,194,13
Fresno,4.714285714285714,2022-01-14,8410,8704,8288,416,34453,35655,33950,1705,435
Glenn,4.714285714285714,2022-01-14,160,166,158,8,497,514,490,24,0
Humboldt,4.714285714285714,2022-01-14,564,584,556,28,4446,4600,4381,219,37
Imperial,4.714285714285714,2022-01-14,1750,1811,1724,87,7264,7518,7158,360,93
Inyo,4.714285714285714,2022-01-14,202,209,199,10,616,637,607,30,3
Kern,4.714285714285714,2022-01-14,5699,5896,5615,281,27583,28541,27181,1360,255
Kings,4.714285714285714,2022-01-14,1650,1708,1627,81,8713,9016,8586,430,47
Lake,4.714285714285714,2022-01-14,249,257,245,12,1521,1574,1498,76,5
Lassen,4.714285714285714,2022-01-14,102,105,100,5,1766,1828,1741,87,1
Los Angeles,4.714285714285714,2022-01-14,116049,120094,114355,5739,915233,947145,901859,45286,4549
Madera,4.714285714285714,2022-01-14,1207,1249,1189,60,5395,5582,5316,266,36
Marin,4.714285714285714,2022-01-14,1179,1220,1162,58,9026,9341,8895,446,35
Mariposa,4.714285714285714,2022-01-14,74,77,73,4,648,670,638,32,0
Mendocino,4.714285714285714,2022-01-14,411,425,405,20,2278,2356,2245,111,24
Merced,4.714285714285714,2022-01-14,2077,2150,2047,103,7216,7467,7110,357,55
Modoc,4.714285714285714,2022-01-14,6,6,6,0,43,44,42,2,0
Mono,4.714285714285714,2022-01-14,119,123,117,6,414,427,407,20,0
Monterey,4.714285714285714,2022-01-14,2127,2201,2096,105,11269,11662,11105,557,64
Napa,4.714285714285714,2022-01-14,810,838,798,40,5498,5690,5418,272,25
Nevada,4.714285714285714,2022-01-14,675,699,666,33,2836,2934,2794,140,24
Orange,4.714285714285714,2022-01-14,21053,21786,20746,1040,134518,139199,132556,6643,1220
Placer,4.714285714285714,2022-01-14,2035,2106,2005,101,9702,10040,9560,480,235
Plumas,4.714285714285714,2022-01-14,63,66,63,3,345,358,341,17,4
Riverside,4.714285714285714,2022-01-14,20274,20979,19978,1001,84013,86942,82786,4156,1049
Sacramento,4.714285714285714,2022-01-14,10400,10762,10249,513,51868,53671,51112,2559,531
San Benito,4.714285714285714,2022-01-14,364,376,358,18,1919,1986,1891,95,8
San Bernardino,4.714285714285714,2022-01-14,18626,19272,18354,918,88504,91583,87213,4370,1141
San Diego,4.714285714285714,2022-01-14,30208,31255,29768,1487,134621,139296,132659,6637,1250
San Francisco,4.714285714285714,2022-01-14,5273,5456,5196,260,46233,47842,45558,2284,241
San Joaquin,4.714285714285714,2022-01-14,6719,6953,6621,332,31485,32582,31025,1557,242
San Luis Obispo,4.714285714285714,2022-01-14,2064,2136,2034,102,11691,12097,11521,576,46
San Mateo,4.714285714285714,2022-01-14,5021,5195,4947,248,43623,45140,42988,2152,148
Santa Barbara,4.714285714285714,2022-01-14,3479,3599,3428,171,21671,22427,21355,1072,113
Santa Clara,4.714285714285714,2022-01-14,14184,14677,13977,700,119973,124136,118226,5910,518
Santa Cruz,4.714285714285714,2022-01-14,1839,1904,1812,92,21704,22471,21384,1087,31
Shasta,4.714285714285714,2022-01-14,674,697,664,33,4812,4979,4742,237,72
Siskiyou,4.714285714285714,2022-01-14,73,76,72,4,410,424,404,20,5
Solano,4.714285714285714,2022-01-14,2956,3059,2913,146,15863,16415,15631,784,146
Sonoma,4.714285714285714,2022-01-14,3826,3959,3771,188,22296,23069,21972,1097,92
Stanislaus,4.714285714285714,2022-01-14,3746,3876,3691,185,14415,14917,14205,712,239
Sutter,4.714285714285714,2022-01-14,583,603,574,29,2178,2254,2146,108,0
Tehama,4.714285714285714,2022-01-14,308,319,304,15,1240,1283,1222,61,19
Trinity,4.714285714285714,2022-01-14,25,25,24,1,152,157,150,7,0
Tulare,4.714285714285714,2022-01-14,3316,3432,3268,164,13752,14233,13552,681,104
Tuolumne,4.714285714285714,2022-01-14,389,403,384,19,2108,2181,2077,104,10
Ventura,4.714285714285714,2022-01-14,5855,6058,5769,289,35585,36821,35067,1754,341
Yolo,4.714285714285714,2022-01-14,1307,1352,1288,64,21897,22659,21578,1081,17
Yuba,4.714285714285714,2022-01-14,466,482,459,23,1679,1737,1654,83,47
Alameda,5.142857142857143,2022-01-17,6143,6413,6033,380,39903,41652,39180,2472,473
Amador,5.142857142857143,2022-01-17,177,184,173,11,695,726,683,43,13
Butte,5.142857142857143,2022-01-17,646,674,634,40,2759,2882,2709,173,64
Calaveras,5.142857142857143,2022-01-17,166,173,163,10,543,567,533,34,6
Colusa,5.142857142857143,2022-01-17,29,30,28,2,134,140,132,8,3
Contra Costa,5.142857142857143,2022-01-17,4471,4666,4390,276,22416,23398,22010,1388,267
Del Norte,5.142857142857143,2022-01-17,73,77,72,5,822,858,806,52,4
El Dorado,5.142857142857143,2022-01-17,473,494,465,29,2068,2159,2030,129,12
Fresno,5.142857142857143,2022-01-17,5086,5310,4994,316,19057,19897,18709,1188,471
Glenn,5.142857142857143,2022-01-17,85,89,84,5,336,351,330,21,3
Humboldt,5.142857142857143,2022-01-17,354,369,347,22,1951,2037,1916,121,14
Imperial,5.142857142857143,2022-01-17,860,899,844,55,3145,3287,3086,201,98
Inyo,5.142857142857143,2022-01-17,71,74,70,4,226,236,222,14,4
Kern,5.142857142857143,2022-01-17,2882,3007,2830,177,11639,12154,11428,726,290
Kings,5.142857142857143,2022-01-17,780,814,766,48,3088,3223,3032,191,41
Lake,5.142857142857143,2022-01-17,185,194,182,12,1001,1046,983,63,4
Lassen,5.142857142857143,2022-01-17,82,86,81,5,939,980,922,58,0
Los Angeles,5.142857142857143,2022-01-17,52009,54271,51075,3196,310643,324239,305028,19211,4877
Madera,5.142857142857143,2022-01-17,738,770,724,46,2770,2892,2719,173,46
Marin,5.142857142857143,2022-01-17,746,778,732,46,4854,5067,4766,301,48
Mariposa,5.142857142857143,2022-01-17,49,51,48,3,219,229,215,14,0
Mendocino,5.142857142857143,2022-01-17,323,337,317,20,1314,1371,1290,81,22
Merced,5.142857142857143,2022-01-17,933,975,916,59,2998,3133,2942,191,54
Modoc,5.142857142857143,2022-01-17,6,6,6,0,24,25,23,2,0
Mono,5.142857142857143,2022-01-17,34,35,33,2,179,186,175,11,2
Monterey,5.142857142857143,2022-01-17,1233,1287,1211,76,6450,6735,6332,403,83
Napa,5.142857142857143,2022-01-17,459,479,450,29,2226,2325,2186,139,26
Nevada,5.142857142857143,2022-01-17,388,404,380,24,1592,1664,1563,101,20
Orange,5.142857142857143,2022-01-17,11562,12069,11353,716,60383,63045,59283,3762,1229
Placer,5.142857142857143,2022-01-17,1439,1503,1413,90,5440,5682,5340,342,229
Plumas,5.142857142857143,2022-01-17,60,63,59,4,173,181,170,11,3
Riverside,5.142857142857143,2022-01-17,11360,11859,11154,705,45703,47716,44873,2843,1128
Sacramento,5.142857142857143,2022-01-17,5639,5887,5537,350,25175,26287,24716,1571,594
San Benito,5.142857142857143,2022-01-17,304,317,298,19,1242,1298,1219,79,8
San Bernardino,5.142857142857143,2022-01-17,8531,8902,8377,525,36388,37980,35730,2250,1193
San Diego,5.142857142857143,2022-01-17,15607,16288,15326,962,73224,76432,71900,4532,1289
San Francisco,5.142857142857143,2022-01-17,3315,3461,3255,206,23358,24384,22935,1449,265
San Joaquin,5.142857142857143,2022-01-17,3144,3283,3086,197,13942,14564,13685,879,265
San Luis Obispo,5.142857142857143,2022-01-17,960,1003,942,61,4826,5044,4736,308,57
San Mateo,5.142857142857143,2022-01-17,3003,3134,2949,185,19674,20539,19318,1221,138
Santa Barbara,5.142857142857143,2022-01-17,2051,2142,2014,128,10893,11377,10693,684,139
Santa Clara,5.142857142857143,2022-01-17,8429,8797,8276,521,58479,61051,57416,3635,562
Santa Cruz,5.142857142857143,2022-01-17,1294,1351,1270,81,10870,11350,10672,678,26
Shasta,5.142857142857143,2022-01-17,438,458,431,27,2310,2415,2268,147,78
Siskiyou,5.142857142857143,2022-01-17,44,45,42,3,198,207,195,12,5
Solano,5.142857142857143,2022-01-17,1427,1489,1401,88,7726,8066,7585,481,154
Sonoma,5.142857142857143,2022-01-17,2142,2236,2102,134,10673,11146,10478,668,89
Stanislaus,5.142857142857143,2022-01-17,2197,2294,2157,137,8265,8632,8114,518,254
Sutter,5.142857142857143,2022-01-17,398,416,391,25,1502,1568,1473,95,0
Tehama,5.142857142857143,2022-01-17,165,173,163,10,554,579,544,35,17
Trinity,5.142857142857143,2022-01-17,10,10,9,1,53,55,52,3,0
Tulare,5.142857142857143,2022-01-17,2108,2202,2069,133,7420,7754,7282,472,115
Tuolumne,5.142857142857143,2022-01-17,293,306,288,18,994,1037,976,61,11
Ventura,5.142857142857143,2022-01-17,3438,3589,3376,213,15927,16631,15636,995,374
Yolo,5.142857142857143,2022-01-17,753,786,739,47,9461,9876,9289,587,19
Yuba,5.142857142857143,2022-01-17,335,350,329,21,1128,1178,1108,70,65
Alameda,5.571428571428571,2022-01-20,11117,11739,10866,873,91452,96581,89384,7197,490
Amador,5.571428571428571,2022-01-20,318,336,311,25,2710,2861,2650,211,12
Butte,5.571428571428571,2022-01-20,1045,1103,1021,82,4797,5065,4688,377,72
Calaveras,5.571428571428571,2022-01-20,321,338,313,25,1411,1490,1380,110,8
Colusa,5.571428571428571,2022-01-20,82,87,80,7,533,563,521,42,5
Contra Costa,5.571428571428571,2022-01-20,6932,7322,6775,547,45069,47615,44047,3568,362
Del Norte,5.571428571428571,2022-01-20,158,167,154,13,2509,2647,2452,195,2
El Dorado,5.571428571428571,2022-01-20,805,851,787,64,4262,4501,4165,336,25
Fresno,5.571428571428571,2022-01-20,9567,10105,9351,754,38166,40313,37301,3012,546
Glenn,5.571428571428571,2022-01-20,140,148,137,11,472,498,461,37,1
Humboldt,5.571428571428571,2022-01-20,552,584,540,44,4099,4329,4006,323,23
Imperial,5.571428571428571,2022-01-20,2105,2226,2058,168,7075,7474,6915,559,92
Inyo,5.571428571428571,2022-01-20,86,90,83,7,355,375,347,28,2
Kern,5.571428571428571,2022-01-20,5899,6228,5765,463,30817,32536,30122,2414,316
Kings,5.571428571428571,2022-01-20,2578,2722,2521,201,11115,11732,10864,868,44
Lake,5.571428571428571,2022-01-20,323,342,316,26,1555,1642,1521,121,6
Lassen,5.571428571428571,2022-01-20,252,266,246,20,2136,2253,2088,165,1
Los Angeles,5.571428571428571,2022-01-20,99398,104963,97150,7813,950848,1004250,929316,74934,4943
Madera,5.571428571428571,2022-01-20,1502,1586,1469,117,7169,7565,7008,557,46
Marin,5.571428571428571,2022-01-20,1008,1064,985,79,9560,10100,9344,756,43
Mariposa,5.571428571428571,2022-01-20,76,80,74,6,529,559,517,42,0
Mendocino,5.571428571428571,2022-01-20,562,593,549,44,2821,2978,2758,220,28
Merced,5.571428571428571,2022-01-20,1814,1916,1773,143,6754,7133,6602,531,66
Modoc,5.571428571428571,2022-01-20,8,8,7,1,67,71,66,5,0
Mono,5.571428571428571,2022-01-20,69,72,67,5,272,286,265,21,1
Monterey,5.571428571428571,2022-01-20,2463,2602,2407,195,14031,14818,13714,1104,113
Napa,5.571428571428571,2022-01-20,815,861,797,64,5890,6217,5757,460,29
Nevada,5.571428571428571,2022-01-20,537,567,525,42,2474,2613,2418,195,26
Orange,5.571428571428571,2022-01-20,16234,17145,15867,1278,128016,135223,125113,10110,1163
Placer,5.571428571428571,2022-01-20,1965,2075,1921,154,9908,10462,9684,778,248
Plumas,5.571428571428571,2022-01-20,88,93,86,7,411,433,401,32,5
Riverside,5.571428571428571,2022-01-20,17911,18918,17505,1413,85193,89992,83261,6731,1111
Sacramento,5.571428571428571,2022-01-20,9742,10287,9522,765,55594,58705,54338,4367,657
San Benito,5.571428571428571,2022-01-20,447,472,437,35,2108,2227,2060,167,9
San Bernardino,5.571428571428571,2022-01-20,15125,15971,14783,1188,84926,89677,83007,6670,1275
San Diego,5.571428571428571,2022-01-20,30007,31687,29329,2358,136518,144201,133423,10778,1330
San Francisco,5.571428571428571,2022-01-20,4232,4469,4137,332,42747,45148,41779,3369,284
San Joaquin,5.571428571428571,2022-01-20,6642,7012,6492,520,34276,36190,33503,2687,306
San Luis Obispo,5.571428571428571,2022-01-20,2047,2162,2001,161,12575,13279,12291,988,55
San Mateo,5.571428571428571,2022-01-20,4401,4648,4302,346,48158,50859,47067,3792,156
Santa Barbara,5.571428571428571,2022-01-20,3592,3793,3510,283,23909,25250,23369,1881,151
Santa Clara,5.571428571428571,2022-01-20,12315,13008,12037,971,128891,136148,125968,10180,569
Santa Cruz,5.571428571428571,2022-01-20,2706,2861,2643,218,21879,23142,21377,1765,39
Shasta,5.571428571428571,2022-01-20,830,877,811,66,5788,6111,5657,454,84
Siskiyou,5.571428571428571,2022-01-20,91,96,89,7,514,543,503,40,3
Solano,5.571428571428571,2022-01-20,2626,2773,2566,207,16318,17232,15949,1283,175
Sonoma,5.571428571428571,2022-01-20,3969,4191,3879,312,24723,26106,24164,1942,113
Stanislaus,5.571428571428571,2022-01-20,3469,3664,3391,273,15108,15953,14767,1186,299
Sutter,5.571428571428571,2022-01-20,522,552,511,41,2483,2622,2427,195,0
Tehama,5.571428571428571,2022-01-20,361,381,353,28,1457,1539,1425,114,18
Trinity,5.571428571428571,2022-01-20,37,40,37,3,194,205,190,15,0
Tulare,5.571428571428571,2022-01-20,4148,4380,4054,326,16327,17241,15957,1284,133
Tuolumne,5.571428571428571,2022-01-20,415,438,405,33,2112,2231,2065,166,14
Ventura,5.571428571428571,2022-01-20,5284,5579,5164,415,37599,39707,36749,2958,366
Yolo,5.571428571428571,2022-01-20,1124,1188,1100,88,22323,23581,21818,1763,26
Yuba,5.571428571428571,2022-01-20,509,538,498,40,1984,2095,1939,156,59
Alameda,6,2022-01-23,5448,5880,5318,562,43192,46599,42160,4439,484
Amador,6,2022-01-23,141,152,137,15,1288,1386,1257,129,12
Butte,6,2022-01-23,481,519,469,50,2198,2374,2146,228,91
Calaveras,6,2022-01-23,174,187,169,18,610,657,595,62,7
Colusa,6,2022-01-23,44,47,43,4,168,181,164,17,5
Contra Costa,6,2022-01-23,3887,4199,3794,405,22729,24546,22189,2357,312
Del Norte,6,2022-01-23,102,110,99,11,842,910,822,88,5
El Dorado,6,2022-01-23,301,325,294,31,1671,1802,1631,171,19
Fresno,6,2022-01-23,4567,4929,4458,471,18064,19487,17632,1855,590
Glenn,6,2022-01-23,56,59,53,6,204,219,198,21,0
Humboldt,6,2022-01-23,249,269,243,26,1856,2003,1811,192,28
Imperial,6,2022-01-23,943,1018,921,97,3326,3586,3246,340,92
Inyo,6,2022-01-23,24,26,23,3,95,102,92,10,1
Kern,6,2022-01-23,2477,2673,2417,256,12137,13094,11848,1246,313
Kings,6,2022-01-23,829,895,809,86,4214,4545,4114,431,43
Lake,6,2022-01-23,164,177,160,17,608,655,593,62,8
Lassen,6,2022-01-23,121,131,118,13,1112,1207,1087,120,1
Los Angeles,6,2022-01-23,41546,44809,40551,4258,378523,407738,369411,38327,4745
Madera,6,2022-01-23,723,780,705,75,2812,3037,2744,293,63
Marin,6,2022-01-23,599,646,584,62,4672,5046,4561,485,59
Mariposa,6,2022-01-23,41,44,40,4,270,290,263,27,0
Mendocino,6,2022-01-23,218,236,213,23,1125,1214,1098,116,23
Merced,6,2022-01-23,714,771,698,73,2928,3156,2858,298,65
Modoc,6,2022-01-23,3,3,3,0,16,17,15,2,2
Mono,6,2022-01-23,29,31,28,3,109,117,106,11,1
Monterey,6,2022-01-23,1244,1341,1214,127,6381,6880,6228,652,96
Napa,6,2022-01-23,377,408,369,39,2841,3065,2774,291,22
Nevada,6,2022-01-23,296,319,289,30,1124,1212,1097,115,30
Orange,6,2022-01-23,8008,8647,7817,830,58521,63105,57119,5986,1182
Placer,6,2022-01-23,1048,1133,1023,110,4887,5278,4771,507,271
Plumas,6,2022-01-23,44,47,42,5,173,186,169,17,6
Riverside,6,2022-01-23,8504,9185,8302,883,41338,44647,40355,4292,1096
Sacramento,6,2022-01-23,4456,4814,4351,463,23795,25683,23227,2456,656
San Benito,6,2022-01-23,208,225,203,22,974,1053,951,102,8
San Bernardino,6,2022-01-23,6765,7301,6603,698,38889,41947,37958,3989,1203
San Diego,6,2022-01-23,13178,14228,12863,1365,68902,74414,67261,7153,1320
San Francisco,6,2022-01-23,2231,2411,2178,233,22653,24464,22115,2349,289
San Joaquin,6,2022-01-23,2539,2737,2478,259,12451,13425,12153,1272,310
San Luis Obispo,6,2022-01-23,654,704,638,66,4325,4658,4221,437,52
San Mateo,6,2022-01-23,2234,2414,2181,233,21018,22689,20517,2172,170
Santa Barbara,6,2022-01-23,1773,1916,1731,185,10964,11842,10704,1138,139
Santa Clara,6,2022-01-23,6645,7182,6487,695,58177,62838,56797,6041,586
Santa Cruz,6,2022-01-23,1749,1886,1706,180,18706,20149,18252,1897,39
Shasta,6,2022-01-23,336,362,327,35,2013,2171,1965,206,81
Siskiyou,6,2022-01-23,22,24,22,2,143,155,140,15,6
Solano,6,2022-01-23,1269,1369,1238,131,7814,8431,7627,804,172
Sonoma,6,2022-01-23,1844,1991,1800,191,10207,11021,9964,1057,106
Stanislaus,6,2022-01-23,1785,1929,1743,186,7514,8121,7337,784,326
Sutter,6,2022-01-23,302,326,295,31,1342,1449,1310,139,0
Tehama,6,2022-01-23,138,148,134,14,597,643,583,60,19
Trinity,6,2022-01-23,20,22,20,2,92,99,89,10,0
Tulare,6,2022-01-23,1658,1790,1619,171,6461,6963,6306,657,135
Tuolumne,6,2022-01-23,246,265,239,26,990,1068,966,102,19
Ventura,6,2022-01-23,2782,3007,2716,291,17685,19091,17264,1827,350
Yolo,6,2022-01-23,566,613,553,60,10983,11870,10724,1146,21
Yuba,6,2022-01-23,260,282,254,28,982,1061,958,103,65
Alameda,6.428571428571429,2022-01-26,6677,7799,6778,1021,76895,89927,78132,11795,498
Amador,6.428571428571429,2022-01-26,134,158,137,21,1731,2046,1773,273,16
Butte,6.428571428571429,2022-01-26,634,741,644,97,4676,5444,4737,707,94
Calaveras,6.428571428571429,2022-01-26,165,193,168,25,1177,1384,1201,183,9
Colusa,6.428571428571429,2022-01-26,61,70,61,9,345,404,351,53,7
Contra Costa,6.428571428571429,2022-01-26,4317,5038,4380,658,38364,44983,39059,5924,327
Del Norte,6.428571428571429,2022-01-26,217,255,221,34,2447,2886,2503,383,7
El Dorado,6.428571428571429,2022-01-26,408,477,415,62,3537,4144,3598,546,23
Fresno,6.428571428571429,2022-01-26,6700,7850,6817,1033,32729,38355,33305,5050,589
Glenn,6.428571428571429,2022-01-26,111,129,112,17,470,546,475,71,3
Humboldt,6.428571428571429,2022-01-26,291,340,295,45,3342,3909,3397,512,28
Imperial,6.428571428571429,2022-01-26,1549,1812,1574,238,6863,8022,6972,1050,103
Inyo,6.428571428571429,2022-01-26,40,46,40,6,331,383,334,49,3
Kern,6.428571428571429,2022-01-26,3155,3686,3203,483,24822,29009,25207,3802,331
Kings,6.428571428571429,2022-01-26,1614,1886,1639,247,8979,10506,9128,1378,45
Lake,6.428571428571429,2022-01-26,276,320,279,41,1765,2054,1787,267,16
Lassen,6.428571428571429,2022-01-26,172,200,174,26,1899,2219,1928,291,5
Los Angeles,6.428571428571429,2022-01-26,46345,54157,47068,7089,747944,876011,760847,115164,4506
Madera,6.428571428571429,2022-01-26,929,1090,946,144,6115,7163,6220,943,64
Marin,6.428571428571429,2022-01-26,619,723,628,95,7584,8864,7703,1161,59
Mariposa,6.428571428571429,2022-01-26,47,55,48,7,426,499,433,66,0
Mendocino,6.428571428571429,2022-01-26,309,361,314,47,2068,2423,2104,319,21
Merced,6.428571428571429,2022-01-26,1395,1629,1416,213,6205,7240,6294,946,69
Modoc,6.428571428571429,2022-01-26,6,6,5,1,59,68,59,9,2
Mono,6.428571428571429,2022-01-26,27,32,28,4,181,214,185,29,0
Monterey,6.428571428571429,2022-01-26,1909,2228,1936,292,12031,14091,12236,1855,121
Napa,6.428571428571429,2022-01-26,540,634,551,83,4542,5323,4622,701,27
Nevada,6.428571428571429,2022-01-26,407,476,414,62,2642,3084,2682,402,31
Orange,6.428571428571429,2022-01-26,8101,9469,8229,1240,101794,119184,103518,15666,1088
Placer,6.428571428571429,2022-01-26,1426,1664,1447,217,9102,10635,9242,1393,282
Plumas,6.428571428571429,2022-01-26,55,65,56,9,436,511,444,67,5
Riverside,6.428571428571429,2022-01-26,9698,11320,9841,1479,64469,75456,65545,9911,1091
Sacramento,6.428571428571429,2022-01-26,6677,7805,6782,1023,47134,55157,47913,7244,654
San Benito,6.428571428571429,2022-01-26,309,361,314,47,1890,2211,1921,290,9
San Bernardino,6.428571428571429,2022-01-26,7432,8684,7547,1137,64643,75738,65771,9967,1210
San Diego,6.428571428571429,2022-01-26,16445,19238,16714,2524,108060,126452,109855,16597,1300
San Francisco,6.428571428571429,2022-01-26,2664,3114,2706,408,36237,42404,36837,5567,307
San Joaquin,6.428571428571429,2022-01-26,3647,4244,3692,552,27584,32124,27942,4182,323
San Luis Obispo,6.428571428571429,2022-01-26,1358,1578,1374,204,10640,12426,10801,1625,55
San Mateo,6.428571428571429,2022-01-26,2453,2864,2489,375,40283,47239,41013,6226,181
Santa Barbara,6.428571428571429,2022-01-26,2619,3054,2656,398,21188,24709,21485,3224,137
Santa Clara,6.428571428571429,2022-01-26,8165,9545,8294,1251,114656,134763,116932,17831,535
Santa Cruz,6.428571428571429,2022-01-26,1890,2224,1928,296,23064,27326,23650,3676,44
Shasta,6.428571428571429,2022-01-26,563,653,569,84,5383,6271,5454,817,93
Siskiyou,6.428571428571429,2022-01-26,52,61,53,8,391,459,398,61,10
Solano,6.428571428571429,2022-01-26,1984,2317,2014,303,14669,17183,14922,2261,169
Sonoma,6.428571428571429,2022-01-26,2375,2778,2413,365,19709,22978,19976,3002,110
Stanislaus,6.428571428571429,2022-01-26,2028,2370,2060,310,12513,14611,12700,1911,357
Sutter,6.428571428571429,2022-01-26,355,413,359,54,2105,2451,2132,319,0
Tehama,6.428571428571429,2022-01-26,211,245,213,32,1224,1419,1236,183,25
Trinity,6.428571428571429,2022-01-26,17,20,17,3,136,161,139,22,0
Tulare,6.428571428571429,2022-01-26,2723,3176,2761,415,14571,16991,14775,2216,162
Tuolumne,6.428571428571429,2022-01-26,390,460,399,61,2000,2347,2037,310,20
Ventura,6.428571428571429,2022-01-26,2816,3287,2857,430,31361,36682,31871,4811,345
Yolo,6.428571428571429,2022-01-26,772,900,783,117,19984,23559,20425,3134,24
Yuba,6.428571428571429,2022-01-26,283,329,286,43,1564,1826,1587,239,63
Alameda,6.857142857142857,2022-01-29,3367,6459,5341,1118,39286,71191,59027,12164,451
Amador,6.857142857142857,2022-01-29,66,171,140,31,1119,2129,1761,368,19
Butte,6.857142857142857,2022-01-29,370,702,581,121,1963,3739,3093,646,102
Calaveras,6.857142857142857,2022-01-29,73,128,106,22,514,952,788,164,4
Colusa,6.857142857142857,2022-01-29,35,65,54,11,252,475,393,82,2
Contra Costa,6.857142857142857,2022-01-29,2108,4027,3330,697,20499,38094,31542,6552,295
Del Norte,6.857142857142857,2022-01-29,101,167,139,28,1275,2069,1725,344,9
El Dorado,6.857142857142857,2022-01-29,193,342,284,58,1536,2825,2340,485,20
Fresno,6.857142857142857,2022-01-29,3471,6771,5595,1176,17530,33972,28077,5895,603
Glenn,6.857142857142857,2022-01-29,56,109,90,19,187,382,315,67,4
Humboldt,6.857142857142857,2022-01-29,163,303,251,52,1917,3346,2780,566,26
Imperial,6.857142857142857,2022-01-29,578,1022,848,174,3167,5461,4538,923,103
Inyo,6.857142857142857,2022-01-29,12,26,21,5,96,177,147,30,4
Kern,6.857142857142857,2022-01-29,1464,2719,2252,467,12215,21404,17772,3632,309
Kings,6.857142857142857,2022-01-29,749,1400,1159,241,4500,7878,6543,1335,53
Lake,6.857142857142857,2022-01-29,106,184,153,31,759,1346,1118,228,10
Lassen,6.857142857142857,2022-01-29,55,88,73,15,696,1119,934,185,5
Los Angeles,6.857142857142857,2022-01-29,20731,38790,32109,6681,267484,424600,354474,70126,3997
Madera,6.857142857142857,2022-01-29,432,879,725,154,2631,5047,4173,874,58
Marin,6.857142857142857,2022-01-29,401,779,644,135,4505,8465,7006,1459,48
Mariposa,6.857142857142857,2022-01-29,46,98,81,17,379,767,633,134,0
Mendocino,6.857142857142857,2022-01-29,92,207,170,37,996,2019,1666,353,14
Merced,6.857142857142857,2022-01-29,529,892,742,150,2699,4685,3892,793,64
Modoc,6.857142857142857,2022-01-29,1,1,1,0,13,19,16,3,2
Mono,6.857142857142857,2022-01-29,9,21,17,4,126,280,230,50,0
Monterey,6.857142857142857,2022-01-29,857,1698,1402,296,5846,10872,9001,1871,121
Napa,6.857142857142857,2022-01-29,301,561,464,97,2581,4831,3998,833,25
Nevada,6.857142857142857,2022-01-29,156,284,235,49,1066,1951,1617,334,30
Orange,6.857142857142857,2022-01-29,3850,7250,6000,1250,55803,100986,83723,17263,979
Placer,6.857142857142857,2022-01-29,630,1174,972,202,4222,7679,6364,1315,232
Plumas,6.857142857142857,2022-01-29,23,42,35,7,219,390,324,66,2
Riverside,6.857142857142857,2022-01-29,4497,8492,7027,1465,34991,64735,53614,11121,1001
Sacramento,6.857142857142857,2022-01-29,2928,5385,4462,923,22468,40843,33855,6988,602
San Benito,6.857142857142857,2022-01-29,135,256,212,44,1011,1798,1492,306,7
San Bernardino,6.857142857142857,2022-01-29,3970,7680,6348,1332,36931,69182,57260,11922,1027
San Diego,6.857142857142857,2022-01-29,7490,14624,12084,2540,56814,109109,90221,18888,1237
San Francisco,6.857142857142857,2022-01-29,1235,2368,1958,410,20962,39434,32633,6801,267
San Joaquin,6.857142857142857,2022-01-29,1737,3064,2543,521,11278,19631,16306,3325,312
San Luis Obispo,6.857142857142857,2022-01-29,488,872,723,149,4392,7686,6382,1304,67
San Mateo,6.857142857142857,2022-01-29,1144,2153,1782,371,18501,33239,27569,5670,161
Santa Barbara,6.857142857142857,2022-01-29,867,1589,1317,272,10495,19314,15998,3316,117
Santa Clara,6.857142857142857,2022-01-29,4557,9202,7591,1611,64014,117586,97430,20156,554
Santa Cruz,6.857142857142857,2022-01-29,1293,2520,2081,439,21080,38794,32113,6681,45
Shasta,6.857142857142857,2022-01-29,210,346,288,58,1279,2132,1775,357,90
Siskiyou,6.857142857142857,2022-01-29,35,59,49,10,170,317,262,55,13
Solano,6.857142857142857,2022-01-29,1076,2176,1795,381,7794,15494,12791,2703,175
Sonoma,6.857142857142857,2022-01-29,1027,1824,1514,310,8886,15866,13163,2703,103
Stanislaus,6.857142857142857,2022-01-29,996,1902,1573,329,5819,10802,8945,1857,340
Sutter,6.857142857142857,2022-01-29,210,413,341,72,1181,2264,1872,392,0
Tehama,6.857142857142857,2022-01-29,90,148,123,25,451,764,635,129,22
Trinity,6.857142857142857,2022-01-29,6,10,8,2,35,55,46,9,0
Tulare,6.857142857142857,2022-01-29,1213,2301,1903,398,6384,11610,9623,1987,152
Tuolumne,6.857142857142857,2022-01-29,201,374,310,64,1110,2010,1667,343,19
Ventura,6.857142857142857,2022-01-29,1451,3009,2480,529,15559,29211,24176,5035,321
Yolo,6.857142857142857,2022-01-29,341,690,569,121,13473,26909,22209,4700,21
Yuba,6.857142857142857,2022-01-29,162,320,264,56,908,1747,1444,303,86
