county,time,date,cases,est_cases,est_omicron_cases,est_other_cases,tests,est_tests,est_omicron_tests,est_other_tests,hospitalizations,deaths,est_deaths,icu,cum_deaths,cum_est_deaths,prev_cum_deaths,prev_cum_est_deaths
Alameda,1,2021-12-22,4290,4293,2126,2167,93655,93753,45979,47774,51,12,12,16,1547,1547,1535,1535
Amador,1,2021-12-22,63,63,24,39,1664,1664,620,1044,4,0,0,2,70,70,70,70
Butte,1,2021-12-22,262,262,144,118,4370,4375,2378,1997,23,5,5,5,361,361,356,356
Calaveras,1,2021-12-22,63,63,26,37,1240,1240,502,738,1,1,1,0,93,93,92,92
Colusa,1,2021-12-22,9,9,4,5,388,388,173,215,2,0,0,0,21,21,21,21
Contra Costa,1,2021-12-22,2511,2514,926,1588,46140,46187,16829,29358,29,2,2,11,1075,1075,1073,1073
Del Norte,1,2021-12-22,15,15,6,9,1366,1366,591,775,0,0,0,0,42,42,42,42
El Dorado,1,2021-12-22,305,305,125,180,4813,4818,1960,2858,8,3,3,2,178,178,175,175
Fresno,1,2021-12-22,1262,1262,480,782,25071,25098,9466,15632,110,19,19,47,2423,2423,2404,2404
Glenn,1,2021-12-22,35,35,15,20,499,499,208,291,0,0,0,0,38,38,38,38
Humboldt,1,2021-12-22,229,229,99,130,3937,3942,1681,2261,7,1,1,1,120,120,119,119
Imperial,1,2021-12-22,643,643,259,384,5732,5737,2303,3434,34,7,7,28,818,818,811,811
Inyo,1,2021-12-22,43,43,19,24,418,418,188,230,2,1,1,0,49,49,48,48
Kern,1,2021-12-22,1072,1072,485,587,24163,24190,10842,13348,78,22,22,27,2027,2027,2005,2005
Kings,1,2021-12-22,265,265,108,157,6238,6243,2519,3724,18,4,4,3,387,387,383,383
Lake,1,2021-12-22,36,36,13,23,1330,1330,498,832,0,0,0,0,115,115,115,115
Lassen,1,2021-12-22,13,13,6,7,2405,2406,1136,1270,1,0,0,0,54,54,54,54
Los Angeles,1,2021-12-22,50523,50576,36080,14496,870975,871889,614618,257271,627,105,105,174,27398,27398,27293,27293
Madera,1,2021-12-22,169,169,64,105,5035,5040,1875,3165,8,1,1,7,333,333,332,332
Marin,1,2021-12-22,843,843,328,515,13812,13826,5314,8512,7,1,1,1,256,256,255,255
Mariposa,1,2021-12-22,26,26,10,16,549,549,201,348,0,0,0,0,21,21,21,21
Mendocino,1,2021-12-22,78,78,25,53,2944,2947,923,2024,2,1,1,1,103,103,102,102
Merced,1,2021-12-22,366,366,163,203,5389,5395,2384,3011,10,8,8,10,696,696,688,688
Modoc,1,2021-12-22,5,5,2,3,66,66,30,36,3,0,0,0,6,6,6,6
Mono,1,2021-12-22,65,65,18,47,456,456,128,328,1,0,0,0,4,4,4,4
Monterey,1,2021-12-22,530,530,147,383,13617,13631,3757,9874,19,2,2,8,643,643,641,641
Napa,1,2021-12-22,373,373,180,193,5486,5491,2615,2876,2,0,0,1,107,107,107,107
Nevada,1,2021-12-22,185,185,70,115,2938,2940,1118,1822,3,1,1,3,111,111,110,110
Orange,1,2021-12-22,7546,7555,3893,3662,109357,109472,55776,53696,159,30,30,58,6003,6003,5973,5973
Placer,1,2021-12-22,682,682,245,437,11356,11369,4056,7313,49,5,5,24,501,501,496,496
Plumas,1,2021-12-22,11,11,4,7,478,478,191,287,0,0,0,0,12,12,12,12
Riverside,1,2021-12-22,7498,7508,3294,4214,82891,82978,36128,46850,288,36,36,81,5505,5505,5469,5469
Sacramento,1,2021-12-22,2774,2777,1168,1609,53960,54017,22500,31517,121,23,23,39,2500,2500,2477,2477
San Benito,1,2021-12-22,147,147,70,77,2098,2098,987,1111,0,4,4,2,82,82,78,78
San Bernardino,1,2021-12-22,6997,7006,3459,3547,86616,86707,42476,44231,296,70,70,124,6553,6553,6483,6483
San Diego,1,2021-12-22,13684,13698,9617,4081,166950,167125,116653,50472,259,29,29,96,4488,4488,4459,4459
San Francisco,1,2021-12-22,4415,4419,1159,3260,64888,64955,16834,48121,25,3,3,12,692,692,689,689
San Joaquin,1,2021-12-22,1229,1229,488,741,23271,23295,9161,14134,39,14,14,22,1976,1976,1962,1962
San Luis Obispo,1,2021-12-22,591,591,273,318,10817,10828,4963,5865,15,2,2,6,371,371,369,369
San Mateo,1,2021-12-22,2399,2401,1235,1166,52073,52129,26512,25617,12,1,1,4,592,592,591,591
Santa Barbara,1,2021-12-22,1038,1038,449,589,15810,15826,6782,9044,17,6,6,13,570,570,564,564
Santa Clara,1,2021-12-22,4338,4341,2990,1351,113781,113902,77759,36143,65,8,8,42,1979,1979,1971,1971
Santa Cruz,1,2021-12-22,481,481,227,254,18040,18060,8387,9673,13,1,1,3,230,230,229,229
Shasta,1,2021-12-22,167,167,70,97,5474,5480,2304,3176,26,6,6,8,450,450,444,444
Siskiyou,1,2021-12-22,13,13,6,7,351,351,170,181,0,2,2,0,63,63,61,61
Solano,1,2021-12-22,657,657,288,369,14966,14981,6522,8459,23,2,2,6,388,388,386,386
Sonoma,1,2021-12-22,985,985,438,547,20618,20639,9103,11536,20,1,1,5,420,420,419,419
Stanislaus,1,2021-12-22,747,747,248,499,11818,11831,3903,7928,81,18,18,23,1439,1439,1421,1421
Sutter,1,2021-12-22,150,150,65,85,2186,2187,941,1246,0,0,0,0,193,193,193,193
Tehama,1,2021-12-22,52,52,18,34,1298,1298,443,855,10,0,0,2,163,163,163,163
Trinity,1,2021-12-22,2,2,1,1,104,104,35,69,0,1,1,0,19,19,18,18
Tulare,1,2021-12-22,461,461,152,309,11879,11892,3882,8010,33,18,18,10,1312,1312,1294,1294
Tuolumne,1,2021-12-22,111,111,42,69,1953,1953,737,1216,8,0,0,0,153,153,153,153
Ventura,1,2021-12-22,2722,2725,1453,1272,38375,38416,20308,18108,57,11,11,14,1213,1213,1202,1202
Yolo,1,2021-12-22,435,435,203,232,25935,25963,11977,13986,4,0,0,3,270,270,270,270
Yuba,1,2021-12-22,99,99,44,55,1836,1836,818,1018,3,0,0,5,101,101,101,101
Alameda,2,2021-12-29,11237,11250,6290,4960,92677,92781,51532,41249,100,9,9,19,1556,1556,1547,1547
Amador,2,2021-12-29,116,116,50,66,1588,1589,693,896,4,1,1,2,71,71,70,70
Butte,2,2021-12-29,697,697,424,273,5032,5038,3059,1979,37,1,1,3,362,362,361,361
Calaveras,2,2021-12-29,121,121,57,64,1017,1017,479,538,1,0,0,1,93,93,93,93
Colusa,2,2021-12-29,41,41,21,20,278,278,145,133,2,0,0,0,21,21,21,21
Contra Costa,2,2021-12-29,8432,8441,3636,4805,53069,53129,22681,30448,51,5,5,20,1080,1080,1075,1075
Del Norte,2,2021-12-29,37,37,18,19,1684,1685,840,845,0,0,0,1,42,42,42,42
El Dorado,2,2021-12-29,770,770,365,405,4654,4658,2201,2457,7,3,3,5,181,181,178,178
Fresno,2,2021-12-29,3707,3710,1653,2057,29358,29391,12994,16397,127,17,17,45,2440,2440,2423,2423
Glenn,2,2021-12-29,66,66,32,34,479,479,231,248,0,0,0,0,38,38,38,38
Humboldt,2,2021-12-29,629,629,309,320,3918,3922,1942,1980,10,1,1,1,121,121,120,120
Imperial,2,2021-12-29,1204,1204,565,639,7127,7135,3331,3804,33,11,11,28,829,829,818,818
Inyo,2,2021-12-29,182,182,94,88,509,509,261,248,0,1,1,0,50,50,49,49
Kern,2,2021-12-29,2950,2953,1537,1416,26195,26225,13570,12655,82,15,15,33,2042,2042,2027,2027
Kings,2,2021-12-29,688,688,324,364,6434,6441,3028,3413,19,1,1,3,388,388,387,387
Lake,2,2021-12-29,99,99,43,56,1229,1229,537,692,0,1,1,0,116,116,115,115
Lassen,2,2021-12-29,32,32,17,15,2593,2597,1393,1204,1,0,0,0,54,54,54,54
Los Angeles,2,2021-12-29,139212,139367,106118,33249,800218,801111,608514,192597,1155,125,125,217,27523,27523,27398,27398
Madera,2,2021-12-29,521,521,230,291,5175,5179,2272,2907,6,1,1,1,334,334,333,333
Marin,2,2021-12-29,2022,2022,903,1119,18158,18179,8077,10102,9,1,1,0,257,257,256,256
Mariposa,2,2021-12-29,52,52,22,30,481,481,204,277,0,0,0,0,21,21,21,21
Mendocino,2,2021-12-29,251,251,94,157,2721,2724,1017,1707,6,0,0,1,103,103,103,103
Merced,2,2021-12-29,992,992,507,485,6374,6381,3251,3130,11,5,5,11,701,701,696,696
Modoc,2,2021-12-29,3,3,2,1,46,46,24,22,0,0,0,0,6,6,6,6
Mono,2,2021-12-29,167,167,56,111,357,357,120,237,0,0,0,0,4,4,4,4
Monterey,2,2021-12-29,1501,1501,499,1002,14623,14639,4850,9789,17,3,3,11,646,646,643,643
Napa,2,2021-12-29,1213,1213,658,555,8517,8525,4617,3908,6,0,0,1,107,107,107,107
Nevada,2,2021-12-29,327,327,146,181,1821,1822,805,1017,3,0,0,1,111,111,111,111
Orange,2,2021-12-29,29386,29418,17006,12412,165522,165706,95368,70338,334,32,32,86,6035,6035,6003,6003
Placer,2,2021-12-29,1806,1807,761,1046,12448,12461,5231,7230,69,4,4,27,505,505,501,501
Plumas,2,2021-12-29,20,20,9,11,317,317,147,170,2,0,0,0,12,12,12,12
Riverside,2,2021-12-29,20332,20355,10247,10108,107051,107169,53780,53389,347,60,60,85,5565,5565,5505,5505
Sacramento,2,2021-12-29,8281,8290,4030,4260,61140,61209,29554,31655,153,22,22,42,2522,2522,2500,2500
San Benito,2,2021-12-29,497,497,267,230,2741,2744,1469,1275,1,3,3,3,85,85,82,82
San Bernardino,2,2021-12-29,23026,23051,12871,10180,105924,106043,58972,47071,425,74,74,141,6627,6627,6553,6553
San Diego,2,2021-12-29,41058,41102,30914,10188,200579,200803,150526,50277,364,32,32,111,4520,4520,4488,4488
San Francisco,2,2021-12-29,8205,8215,2557,5658,68754,68831,21350,47481,54,2,2,11,694,694,692,692
San Joaquin,2,2021-12-29,3808,3811,1762,2049,27029,27060,12423,14637,72,11,11,25,1987,1987,1976,1976
San Luis Obispo,2,2021-12-29,1785,1786,941,845,13067,13082,6857,6225,21,1,1,7,372,372,371,371
San Mateo,2,2021-12-29,7151,7160,4110,3050,61133,61201,34994,26207,22,1,1,6,593,593,592,592
Santa Barbara,2,2021-12-29,3132,3135,1555,1580,18027,18046,8935,9111,42,7,7,8,577,577,570,570
Santa Clara,2,2021-12-29,13136,13151,9726,3425,118614,118748,87612,31136,114,11,11,48,1990,1990,1979,1979
Santa Cruz,2,2021-12-29,1409,1409,756,653,13611,13627,7331,6296,10,1,1,2,231,231,230,230
Shasta,2,2021-12-29,340,340,165,175,4972,4977,2426,2551,27,4,4,15,454,454,450,450
Siskiyou,2,2021-12-29,37,37,20,17,404,404,221,183,0,0,0,0,63,63,63,63
Solano,2,2021-12-29,2662,2665,1349,1316,21874,21899,10963,10936,42,6,6,6,394,394,388,388
Sonoma,2,2021-12-29,2935,2938,1496,1442,25037,25065,12702,12363,20,2,2,4,422,422,420,420
Stanislaus,2,2021-12-29,1901,1903,750,1153,13652,13669,5369,8300,92,11,11,18,1450,1450,1439,1439
Sutter,2,2021-12-29,284,284,141,143,2343,2346,1161,1185,0,2,2,0,195,195,193,193
Tehama,2,2021-12-29,119,119,48,71,1110,1110,448,662,3,2,2,3,165,165,163,163
Trinity,2,2021-12-29,5,5,2,3,93,93,37,56,0,0,0,0,19,19,19,19
Tulare,2,2021-12-29,1170,1170,455,715,12840,12855,4989,7866,34,8,8,9,1320,1320,1312,1312
Tuolumne,2,2021-12-29,212,212,93,119,1735,1735,763,972,7,0,0,1,153,153,153,153
Ventura,2,2021-12-29,8786,8795,5248,3547,47661,47714,28389,19325,78,6,6,19,1219,1219,1213,1213
Yolo,2,2021-12-29,1246,1246,662,584,24339,24367,12924,11443,10,0,0,1,270,270,270,270
Yuba,2,2021-12-29,248,248,128,120,1713,1713,879,834,0,1,1,67,102,102,101,101
Alameda,3,2022-01-05,22979,23006,14207,8799,145022,145196,89583,55613,180,6,6,38,1562,1562,1556,1556
Amador,3,2022-01-05,299,299,149,150,2545,2548,1264,1284,5,0,0,2,71,71,71,71
Butte,3,2022-01-05,1520,1520,1010,510,8390,8399,5582,2817,44,0,0,4,362,362,362,362
Calaveras,3,2022-01-05,325,325,173,152,1908,1911,1024,887,1,2,2,2,95,95,93,93
Colusa,3,2022-01-05,57,57,33,24,520,520,302,218,5,0,0,0,21,21,21,21
Contra Costa,3,2022-01-05,15714,15732,7682,8050,80349,80445,39305,41140,98,9,9,25,1089,1089,1080,1080
Del Norte,3,2022-01-05,123,123,69,54,2211,2212,1231,981,0,0,0,0,42,42,42,42
El Dorado,3,2022-01-05,1649,1649,881,768,7128,7137,3811,3326,10,5,5,5,186,186,181,181
Fresno,3,2022-01-05,8501,8511,4296,4215,45513,45568,22904,22664,216,16,16,36,2456,2456,2440,2440
Glenn,3,2022-01-05,102,102,56,46,707,707,384,323,3,1,1,0,39,39,38,38
Humboldt,3,2022-01-05,1102,1102,612,490,6325,6334,3518,2816,16,2,2,2,123,123,121,121
Imperial,3,2022-01-05,2572,2575,1369,1206,11138,11151,5901,5250,39,18,18,25,847,847,829,829
Inyo,3,2022-01-05,330,330,190,140,959,959,553,406,4,1,1,0,51,51,50,50
Kern,3,2022-01-05,8384,8394,4875,3519,44585,44639,25885,18754,119,16,16,32,2058,2058,2042,2042
Kings,3,2022-01-05,1455,1455,776,679,9796,9808,5211,4597,20,3,3,3,391,391,388,388
Lake,3,2022-01-05,321,321,160,161,2185,2187,1090,1097,3,0,0,1,116,116,116,116
Lassen,3,2022-01-05,87,87,52,35,3092,3095,1846,1249,2,0,0,0,54,54,54,54
Los Angeles,3,2022-01-05,256128,256432,205853,50579,1397683,1399344,1123965,275379,2309,181,181,352,27704,27704,27523,27523
Madera,3,2022-01-05,1221,1221,615,606,8026,8036,4031,4005,19,4,4,7,338,338,334,334
Marin,3,2022-01-05,2641,2644,1344,1300,18114,18136,9203,8933,17,0,0,3,257,257,257,257
Mariposa,3,2022-01-05,155,155,76,79,829,829,405,424,0,1,1,0,22,22,21,21
Mendocino,3,2022-01-05,596,596,258,338,4356,4361,1892,2469,6,1,1,2,104,104,103,103
Merced,3,2022-01-05,2300,2303,1321,982,10644,10657,6087,4570,24,13,13,9,714,714,701,701
Modoc,3,2022-01-05,19,19,11,8,81,81,48,33,0,0,0,0,6,6,6,6
Mono,3,2022-01-05,221,221,86,135,628,628,248,380,3,1,1,0,5,5,4,4
Monterey,3,2022-01-05,3343,3346,1302,2044,25669,25701,9982,15719,46,5,5,11,651,651,646,646
Napa,3,2022-01-05,2283,2286,1376,910,13012,13027,7817,5210,10,2,2,2,109,109,107,107
Nevada,3,2022-01-05,808,808,408,400,3925,3929,1986,1943,9,2,2,4,113,113,111,111
Orange,3,2022-01-05,52291,52353,33133,19220,256108,256411,162401,94010,615,57,57,109,6092,6092,6035,6035
Placer,3,2022-01-05,3684,3688,1774,1914,17140,17160,8245,8915,129,15,15,22,520,520,505,505
Plumas,3,2022-01-05,95,95,50,45,630,630,330,300,3,0,0,0,12,12,12,12
Riverside,3,2022-01-05,39204,39250,22079,17171,154403,154586,86856,67730,649,60,60,123,5625,5625,5565,5565
Sacramento,3,2022-01-05,19951,19975,10919,9056,97389,97504,53092,44412,242,30,30,65,2552,2552,2522,2522
San Benito,3,2022-01-05,823,823,489,334,3618,3622,2152,1470,4,0,0,2,85,85,85,85
San Bernardino,3,2022-01-05,40046,40094,24670,15424,151978,152158,93538,58620,645,98,98,169,6725,6725,6627,6627
San Diego,3,2022-01-05,72592,72678,57654,15024,289313,289656,229688,59968,627,37,37,147,4557,4557,4520,4520
San Francisco,3,2022-01-05,13716,13732,5043,8689,98588,98706,36218,62488,108,7,7,22,701,701,694,694
San Joaquin,3,2022-01-05,9727,9739,5083,4656,46869,46925,24460,22465,97,16,16,26,2003,2003,1987,1987
San Luis Obispo,3,2022-01-05,3176,3179,1865,1314,17546,17566,10260,7306,23,6,6,6,378,378,372,372
San Mateo,3,2022-01-05,12612,12627,7978,4649,94205,94318,59624,34694,59,6,6,7,599,599,593,593
Santa Barbara,3,2022-01-05,6876,6885,3832,3053,35631,35675,19859,15816,55,4,4,8,581,581,577,577
Santa Clara,3,2022-01-05,28471,28505,22329,6176,202680,202921,159070,43851,240,12,12,65,2002,2002,1990,1990
Santa Cruz,3,2022-01-05,3312,3315,1981,1334,28690,28726,17214,11512,15,4,4,2,235,235,231,231
Shasta,3,2022-01-05,789,789,431,358,6830,6837,3746,3091,34,4,4,14,458,458,454,454
Siskiyou,3,2022-01-05,98,98,59,39,761,761,463,298,1,1,1,1,64,64,63,63
Solano,3,2022-01-05,5026,5032,2836,2196,28941,28975,16276,12699,64,3,3,9,397,397,394,394
Sonoma,3,2022-01-05,6509,6516,3721,2795,38074,38119,21680,16439,36,9,9,3,431,431,422,422
Stanislaus,3,2022-01-05,4440,4444,2013,2431,21638,21664,9805,11859,139,10,10,14,1460,1460,1450,1450
Sutter,3,2022-01-05,753,753,420,333,3739,3743,2088,1655,0,3,3,0,198,198,195,195
Tehama,3,2022-01-05,332,332,154,178,1845,1847,861,986,7,1,1,3,166,166,165,165
Trinity,3,2022-01-05,21,21,10,11,178,178,82,96,0,0,0,0,19,19,19,19
Tulare,3,2022-01-05,3072,3075,1383,1692,18276,18297,8192,10105,54,6,6,9,1326,1326,1320,1320
Tuolumne,3,2022-01-05,552,552,278,274,3190,3193,1610,1583,10,3,3,1,156,156,153,153
Ventura,3,2022-01-05,14702,14719,9592,5127,70343,70427,45947,24480,153,11,11,29,1230,1230,1219,1219
Yolo,3,2022-01-05,3034,3037,1794,1243,37155,37198,21997,15201,9,3,3,3,273,273,270,270
Yuba,3,2022-01-05,668,668,385,283,2926,2929,1684,1245,15,1,1,6,103,103,102,102
Alameda,4,2022-01-12,29044,29079,19414,9665,190123,190355,127227,63128,325,17,17,46,1579,1579,1562,1562
Amador,4,2022-01-12,449,449,250,199,3552,3555,1990,1565,6,1,1,2,72,72,71,71
Butte,4,2022-01-12,2130,2130,1522,608,10474,10487,7492,2995,59,3,3,5,365,365,362,362
Calaveras,4,2022-01-12,614,614,363,251,2670,2674,1583,1091,0,0,0,2,95,95,95,95
Colusa,4,2022-01-12,133,133,84,49,783,783,496,287,2,0,0,0,21,21,21,21
Contra Costa,4,2022-01-12,18813,18837,10255,8582,100311,100434,54753,45681,178,16,16,27,1105,1105,1089,1089
Del Norte,4,2022-01-12,182,182,112,70,5235,5242,3224,2018,3,0,0,0,42,42,42,42
El Dorado,4,2022-01-12,2344,2345,1385,960,9471,9483,5599,3884,13,3,3,1,189,189,186,186
Fresno,4,2022-01-12,15079,15098,8494,6604,64659,64738,36346,28392,313,13,13,60,2469,2469,2456,2456
Glenn,4,2022-01-12,282,282,169,113,1048,1048,628,420,2,0,0,0,39,39,39,39
Humboldt,4,2022-01-12,1405,1405,857,548,8994,9006,5506,3500,15,4,4,5,127,127,123,123
Imperial,4,2022-01-12,3726,3731,2187,1544,14201,14220,8333,5887,63,7,7,24,854,854,847,847
Inyo,4,2022-01-12,409,409,258,151,1357,1357,854,503,4,1,1,0,52,52,51,51
Kern,4,2022-01-12,12867,12882,8186,4696,59956,60030,38138,21892,201,29,29,38,2087,2087,2058,2058
Kings,4,2022-01-12,2974,2977,1763,1214,14880,14898,8815,6083,37,2,2,2,393,393,391,391
Lake,4,2022-01-12,523,523,291,232,2765,2769,1540,1229,1,3,3,2,119,119,116,116
Lassen,4,2022-01-12,241,241,158,83,3706,3711,2420,1291,0,0,0,0,54,54,54,54
Los Angeles,4,2022-01-12,296028,296389,247385,49004,1906911,1909241,1595571,313670,3589,332,332,586,28036,28036,27704,27704
Madera,4,2022-01-12,2137,2139,1198,941,10860,10874,6082,4792,28,2,2,6,340,340,338,338
Marin,4,2022-01-12,2711,2713,1534,1179,19867,19891,11236,8655,25,3,3,3,260,260,257,257
Mariposa,4,2022-01-12,183,183,100,83,1187,1187,648,539,0,0,0,0,22,22,22,22
Mendocino,4,2022-01-12,937,937,459,478,5569,5576,2735,2841,9,2,2,2,106,106,104,104
Merced,4,2022-01-12,4026,4031,2526,1505,14877,14896,9321,5575,34,10,10,10,724,724,714,714
Modoc,4,2022-01-12,9,9,6,3,108,108,69,39,0,0,0,0,6,6,6,6
Mono,4,2022-01-12,235,235,105,130,806,806,360,446,0,0,0,0,5,5,5,5
Monterey,4,2022-01-12,5410,5416,2416,3000,31348,31387,13922,17465,53,3,3,15,654,654,651,651
Napa,4,2022-01-12,2455,2457,1609,848,14484,14503,9507,4996,21,0,0,4,109,109,109,109
Nevada,4,2022-01-12,1312,1312,738,574,5565,5571,3143,2428,12,2,2,3,115,115,113,113
Orange,4,2022-01-12,54428,54495,37256,17239,304925,305298,209022,96276,904,105,105,168,6197,6197,6092,6092
Placer,4,2022-01-12,5167,5174,2780,2394,22446,22474,12095,10379,177,8,8,34,528,528,520,520
Plumas,4,2022-01-12,166,166,96,70,832,832,482,350,6,0,0,0,12,12,12,12
Riverside,4,2022-01-12,47237,47295,29241,18054,185713,185939,114963,70976,831,87,87,145,5712,5712,5625,5625
Sacramento,4,2022-01-12,26013,26046,15621,10425,118831,118976,71440,47536,403,47,47,80,2599,2599,2552,2552
San Benito,4,2022-01-12,994,994,645,349,4542,4548,2950,1598,6,1,1,3,86,86,85,85
San Bernardino,4,2022-01-12,48937,48996,32687,16309,190212,190445,127137,63308,884,124,124,196,6849,6849,6725,6725
San Diego,4,2022-01-12,75052,75144,62209,12935,309300,309680,256421,53259,958,75,75,177,4632,4632,4557,4557
San Francisco,4,2022-01-12,13396,13412,5632,7780,109794,109928,46253,63675,182,13,13,37,714,714,701,701
San Joaquin,4,2022-01-12,14753,14771,8530,6241,65720,65800,38003,27797,173,16,16,44,2019,2019,2003,2003
San Luis Obispo,4,2022-01-12,4310,4315,2755,1560,22652,22679,14506,8173,37,4,4,8,382,382,378,378
San Mateo,4,2022-01-12,14898,14917,10207,4710,113632,113771,77912,35859,107,7,7,15,606,606,599,599
Santa Barbara,4,2022-01-12,8113,8124,4971,3153,46804,46862,28669,18193,84,11,11,14,592,592,581,581
Santa Clara,4,2022-01-12,34175,34217,28040,6177,266538,266865,218767,48098,378,24,24,65,2026,2026,2002,2002
Santa Cruz,4,2022-01-12,4319,4326,2805,1521,42211,42261,27403,14858,32,2,2,2,237,237,235,235
Shasta,4,2022-01-12,1189,1189,719,470,9202,9213,5577,3636,49,7,7,11,465,465,458,458
Siskiyou,4,2022-01-12,135,135,90,45,1068,1068,709,359,1,1,1,2,65,65,64,64
Solano,4,2022-01-12,6748,6755,4175,2580,37095,37141,22953,14188,110,6,6,14,403,403,397,397
Sonoma,4,2022-01-12,8520,8532,5327,3205,48151,48210,30127,18083,83,7,7,10,438,438,431,431
Stanislaus,4,2022-01-12,7383,7393,3775,3618,30388,30425,15539,14886,172,12,12,30,1472,1472,1460,1460
Sutter,4,2022-01-12,1380,1380,847,533,5197,5202,3195,2007,0,4,4,0,202,202,198,198
Tehama,4,2022-01-12,600,600,314,286,2625,2629,1373,1256,17,2,2,1,168,168,166,166
Trinity,4,2022-01-12,44,44,23,21,271,271,140,131,0,0,0,0,19,19,19,19
Tulare,4,2022-01-12,6507,6516,3317,3199,26545,26577,13478,13099,68,13,13,12,1339,1339,1326,1326
Tuolumne,4,2022-01-12,841,841,472,369,4324,4329,2430,1899,9,4,4,4,160,160,156,156
Ventura,4,2022-01-12,16110,16129,11309,4820,84563,84667,59439,25228,258,28,28,34,1258,1258,1230,1230
Yolo,4,2022-01-12,3623,3628,2329,1299,46699,46755,30039,16716,13,5,5,3,278,278,273,273
Yuba,4,2022-01-12,1131,1131,713,418,4248,4253,2676,1577,34,0,0,6,103,103,103,103
Alameda,5,2022-01-19,23409,23439,16872,6567,169432,169646,122269,47377,372,37,37,72,1616,1616,1579,1579
Amador,5,2022-01-19,542,542,335,207,3817,3821,2366,1455,14,1,1,3,73,73,72,72
Butte,5,2022-01-19,2092,2092,1595,497,9484,9496,7245,2251,66,7,7,7,372,372,365,365
Calaveras,5,2022-01-19,557,557,361,196,2435,2437,1579,858,4,2,2,2,97,97,95,95
Colusa,5,2022-01-19,174,174,119,55,834,834,574,260,4,0,0,0,21,21,21,21
Contra Costa,5,2022-01-19,15053,15073,9112,5961,84831,84939,51410,33529,279,24,24,49,1129,1129,1105,1105
Del Norte,5,2022-01-19,265,265,179,86,3806,3810,2576,1234,2,0,0,0,42,42,42,42
El Dorado,5,2022-01-19,1723,1723,1118,605,7676,7685,4989,2696,13,3,3,6,192,192,189,189
Fresno,5,2022-01-19,18090,18113,11259,6854,69081,69168,42949,26219,433,33,33,69,2502,2502,2469,2469
Glenn,5,2022-01-19,273,273,178,95,1045,1045,684,361,1,2,2,0,41,41,39,39
Humboldt,5,2022-01-19,1051,1051,701,350,7825,7836,5227,2609,15,3,3,4,130,130,127,127
Imperial,5,2022-01-19,3463,3468,2236,1232,13078,13095,8432,4663,73,14,14,30,868,868,854,854
Inyo,5,2022-01-19,237,237,161,76,811,811,552,259,2,1,1,0,53,53,52,52
Kern,5,2022-01-19,11404,11419,7871,3548,52028,52095,35956,16139,259,37,37,55,2124,2124,2087,2087
Kings,5,2022-01-19,3994,3998,2599,1399,16990,17012,11039,5973,39,4,4,2,397,397,393,393
Lake,5,2022-01-19,678,678,418,260,3614,3619,2228,1391,5,1,1,2,120,120,119,119
Lassen,5,2022-01-19,372,372,264,108,3868,3872,2735,1137,0,0,0,0,54,54,54,54
Los Angeles,5,2022-01-19,202859,203115,176025,27090,1620986,1623029,1407502,215527,4091,546,546,723,28582,28582,28036,28036
Madera,5,2022-01-19,2704,2707,1678,1029,11786,11801,7324,4477,39,6,6,13,346,346,340,340
Marin,5,2022-01-19,2283,2285,1423,862,17964,17987,11230,6757,37,5,5,7,265,265,260,260
Mariposa,5,2022-01-19,152,152,92,60,1066,1066,643,423,0,0,0,0,22,22,22,22
Mendocino,5,2022-01-19,979,979,540,439,5018,5025,2773,2252,27,3,3,3,109,109,106,106
Merced,5,2022-01-19,3588,3593,2444,1149,13189,13207,8988,4219,50,17,17,13,741,741,724,724
Modoc,5,2022-01-19,17,17,12,5,106,106,74,32,0,1,1,0,7,7,6,6
Mono,5,2022-01-19,133,133,66,67,643,643,322,321,0,0,0,0,5,5,5,5
Monterey,5,2022-01-19,5794,5801,2929,2872,30505,30543,15491,15052,88,9,9,15,663,663,654,654
Napa,5,2022-01-19,1797,1797,1274,523,11765,11780,8363,3417,24,3,3,6,112,112,109,109
Nevada,5,2022-01-19,1172,1172,727,445,5135,5140,3197,1943,22,0,0,6,115,115,115,115
Orange,5,2022-01-19,36200,36246,26629,9617,240642,240945,177281,63664,984,116,116,199,6313,6313,6197,6197
Placer,5,2022-01-19,4099,4105,2458,1647,19148,19172,11492,7680,163,10,10,42,538,538,528,528
Plumas,5,2022-01-19,207,207,132,75,836,836,532,304,5,0,0,0,12,12,12,12
Riverside,5,2022-01-19,38023,38071,25648,12423,165283,165493,111638,53855,922,114,114,154,5826,5826,5712,5712
Sacramento,5,2022-01-19,19898,19922,13107,6815,99305,99430,65492,33938,519,56,56,96,2655,2655,2599,2599
San Benito,5,2022-01-19,852,852,600,252,3992,3997,2811,1186,4,2,2,4,88,88,86,86
San Bernardino,5,2022-01-19,33944,33986,24442,9544,159218,159419,114758,44661,1025,146,146,226,6995,6995,6849,6849
San Diego,5,2022-01-19,58465,58540,50398,8142,257708,258034,222108,35926,1089,104,104,214,4736,4736,4632,4632
San Francisco,5,2022-01-19,10350,10362,4992,5370,92359,92476,44671,47805,233,12,12,39,726,726,714,714
San Joaquin,5,2022-01-19,12337,12353,7860,4493,59460,59535,37907,21628,233,27,27,61,2046,2046,2019,2019
San Luis Obispo,5,2022-01-19,3853,3858,2678,1180,21298,21324,14812,6512,43,13,13,11,395,395,382,382
San Mateo,5,2022-01-19,11006,11020,8089,2931,94142,94260,69333,24927,100,10,10,31,616,616,606,606
Santa Barbara,5,2022-01-19,6823,6832,4574,2258,42027,42080,28176,13904,136,12,12,14,604,604,592,592
Santa Clara,5,2022-01-19,25794,25827,22032,3795,224928,225213,192272,32941,456,37,37,91,2063,2063,2026,2026
Santa Cruz,5,2022-01-19,4251,4256,2992,1264,41162,41214,28883,12331,35,3,3,4,240,240,237,237
Shasta,5,2022-01-19,1449,1449,958,491,9582,9593,6350,3243,58,9,9,14,474,474,465,465
Siskiyou,5,2022-01-19,173,173,123,50,872,872,624,248,2,0,0,1,65,65,65,65
Solano,5,2022-01-19,5873,5879,3949,1930,33727,33770,22718,11052,138,9,9,22,412,412,403,403
Sonoma,5,2022-01-19,7443,7453,5072,2381,42307,42360,28836,13524,80,11,11,17,449,449,438,438
Stanislaus,5,2022-01-19,7130,7140,4074,3066,28896,28933,16535,12398,237,16,16,42,1488,1488,1472,1472
Sutter,5,2022-01-19,1208,1208,809,399,4883,4888,3280,1608,0,1,1,0,203,203,202,202
Tehama,5,2022-01-19,594,594,346,248,2489,2493,1454,1039,14,5,5,2,173,173,168,168
Trinity,5,2022-01-19,51,51,30,21,298,298,172,126,0,1,1,0,20,20,19,19
Tulare,5,2022-01-19,7892,7903,4491,3412,28490,28526,16212,12314,119,13,13,15,1352,1352,1339,1339
Tuolumne,5,2022-01-19,908,908,562,346,3786,3791,2348,1443,11,6,6,3,166,166,160,160
Ventura,5,2022-01-19,10973,10986,8251,2735,65632,65715,49421,16294,291,42,42,63,1300,1300,1258,1258
Yolo,5,2022-01-19,2572,2576,1796,780,39041,39091,27269,11822,19,3,3,7,281,281,278,278
Yuba,5,2022-01-19,996,996,683,313,3734,3739,2564,1175,51,3,3,8,106,106,103,103
Alameda,6,2022-01-26,16190,16211,12417,3794,156930,157135,120648,36487,377,39,39,72,1655,1655,1616,1616
Amador,6,2022-01-26,420,420,281,139,3584,3588,2400,1188,11,0,0,4,73,73,73,73
Butte,6,2022-01-26,1538,1538,1234,304,8593,8606,6922,1684,85,7,7,9,379,379,372,372
Calaveras,6,2022-01-26,442,442,308,134,2223,2226,1560,666,6,3,3,3,100,100,97,97
Colusa,6,2022-01-26,151,151,111,40,732,732,537,195,7,0,0,0,21,21,21,21
Contra Costa,6,2022-01-26,11110,11124,7347,3777,80209,80314,53242,27072,237,23,23,69,1152,1152,1129,1129
Del Norte,6,2022-01-26,356,356,258,98,3732,3737,2713,1024,5,0,0,2,42,42,42,42
El Dorado,6,2022-01-26,1103,1103,772,331,6674,6683,4697,1986,16,6,6,7,198,198,192,192
Fresno,6,2022-01-26,14588,14607,9860,4747,64335,64419,43586,20833,491,38,38,81,2540,2540,2502,2502
Glenn,6,2022-01-26,233,233,165,68,871,871,617,254,3,0,0,0,41,41,41,41
Humboldt,6,2022-01-26,748,748,537,211,6787,6795,4887,1908,23,1,1,5,131,131,130,130
Imperial,6,2022-01-26,3227,3232,2252,980,12863,12881,9001,3880,73,15,15,29,883,883,868,868
Inyo,6,2022-01-26,101,101,74,27,552,552,406,146,3,0,0,0,53,53,53,53
Kern,6,2022-01-26,8307,8318,6132,2186,47559,47622,35229,12393,277,47,47,47,2171,2171,2124,2124
Kings,6,2022-01-26,3333,3338,2336,1002,16417,16440,11536,4904,40,3,3,5,400,400,397,397
Lake,6,2022-01-26,672,672,451,221,3232,3237,2183,1054,11,4,4,5,124,124,120,120
Lassen,6,2022-01-26,357,357,269,88,3500,3506,2648,858,5,0,0,0,54,54,54,54
Los Angeles,6,2022-01-26,123576,123739,110345,13394,1480570,1482502,1324142,158360,3577,608,608,746,29190,29190,28582,28582
Madera,6,2022-01-26,2291,2292,1543,749,10636,10650,7200,3450,45,5,5,12,351,351,346,346
Marin,6,2022-01-26,1556,1556,1056,500,15889,15909,10819,5090,40,5,5,12,270,270,265,265
Mariposa,6,2022-01-26,120,120,79,41,869,869,575,294,0,0,0,0,22,22,22,22
Mendocino,6,2022-01-26,749,749,455,294,4140,4145,2530,1615,18,3,3,3,112,112,109,109
Merced,6,2022-01-26,2713,2718,1988,730,11879,11895,8711,3184,55,7,7,14,748,748,741,741
Modoc,6,2022-01-26,13,13,10,3,102,102,76,26,2,0,0,0,7,7,7,7
Mono,6,2022-01-26,73,73,41,32,364,364,206,158,0,0,0,0,5,5,5,5
Monterey,6,2022-01-26,4619,4625,2619,2006,29703,29742,16875,12867,95,7,7,19,670,670,663,663
Napa,6,2022-01-26,1372,1372,1036,336,10854,10869,8224,2645,22,4,4,5,116,116,112,112
Nevada,6,2022-01-26,869,869,588,281,4532,4538,3082,1456,27,4,4,4,119,119,115,115
Orange,6,2022-01-26,20216,20242,15756,4486,208268,208540,162839,45701,883,194,194,184,6507,6507,6313,6313
Placer,6,2022-01-26,3166,3172,2078,1094,17123,17145,11266,5879,208,12,12,49,550,550,538,538
Plumas,6,2022-01-26,186,186,128,58,811,811,558,253,5,0,0,0,12,12,12,12
Riverside,6,2022-01-26,25914,25947,18788,7159,142696,142882,103729,39153,867,113,113,172,5939,5939,5826,5826
Sacramento,6,2022-01-26,14636,14655,10409,4246,89764,89882,63979,25903,526,77,77,103,2732,2732,2655,2655
San Benito,6,2022-01-26,664,664,498,166,3700,3705,2785,920,6,0,0,3,88,88,88,88
San Bernardino,6,2022-01-26,21679,21707,16599,5108,135395,135573,103972,31601,951,182,182,232,7177,7177,6995,6995
San Diego,6,2022-01-26,39791,39842,35324,4518,223688,223979,198785,25194,1051,126,126,219,4862,4862,4736,4736
San Francisco,6,2022-01-26,6721,6729,3648,3081,82088,82195,44798,37397,253,22,22,43,748,748,726,726
San Joaquin,6,2022-01-26,8483,8494,5850,2644,51193,51259,35434,15825,244,30,30,74,2076,2076,2046,2046
San Luis Obispo,6,2022-01-26,2883,2887,2143,744,19327,19353,14400,4953,44,9,9,11,404,404,395,395
San Mateo,6,2022-01-26,6807,6816,5307,1509,87225,87339,68187,19152,139,19,19,31,635,635,616,616
Santa Barbara,6,2022-01-26,5422,5429,3909,1520,39719,39769,28686,11083,120,15,15,16,619,619,604,604
Santa Clara,6,2022-01-26,19324,19348,17047,2301,218118,218402,192663,25739,410,44,44,90,2107,2107,2063,2063
Santa Cruz,6,2022-01-26,5088,5095,3816,1279,51726,51794,38902,12892,41,3,3,3,243,243,240,240
Shasta,6,2022-01-26,1267,1267,901,366,9240,9252,6609,2643,77,6,6,11,480,480,474,474
Siskiyou,6,2022-01-26,121,121,92,29,695,695,529,166,8,3,3,2,68,68,65,65
Solano,6,2022-01-26,4476,4482,3243,1239,30754,30795,22339,8456,132,11,11,27,423,423,412,412
Sonoma,6,2022-01-26,5629,5636,4110,1526,38094,38142,27889,10253,92,6,6,17,455,455,449,449
Stanislaus,6,2022-01-26,5258,5265,3303,1962,25052,25086,15802,9284,291,24,24,50,1512,1512,1488,1488
Sutter,6,2022-01-26,863,863,621,242,4513,4518,3257,1261,0,2,2,0,205,205,203,203
Tehama,6,2022-01-26,491,491,313,178,2337,2341,1498,843,20,4,4,5,177,177,173,173
Trinity,6,2022-01-26,53,53,33,20,283,283,179,104,0,0,0,0,20,20,20,20
Tulare,6,2022-01-26,6383,6391,3991,2400,26458,26492,16593,9899,146,12,12,12,1364,1364,1352,1352
Tuolumne,6,2022-01-26,947,947,640,307,3620,3625,2453,1172,17,3,3,3,169,169,166,166
Ventura,6,2022-01-26,7459,7469,5920,1549,61587,61668,49013,12655,282,30,30,55,1330,1330,1300,1300
Yolo,6,2022-01-26,1923,1923,1435,488,38992,39044,29177,9867,19,10,10,5,291,291,281,281
Yuba,6,2022-01-26,744,744,545,199,3392,3397,2496,901,55,2,2,7,108,108,106,106
Alameda,7,2022-02-02,9084,9096,7348,1748,129330,129502,104833,24669,326,56,56,76,1711,1711,1655,1655
Amador,7,2022-02-02,318,318,229,89,3312,3317,2397,920,13,3,3,4,76,76,73,73
Butte,7,2022-02-02,1025,1025,861,164,7313,7323,6156,1167,77,7,7,7,386,386,379,379
Calaveras,7,2022-02-02,229,229,172,57,1743,1744,1310,434,2,6,6,2,106,106,100,100
Colusa,7,2022-02-02,89,89,69,20,650,650,506,144,8,0,0,0,21,21,21,21
Contra Costa,7,2022-02-02,5788,5796,4141,1655,63059,63144,45242,17902,212,44,44,57,1196,1196,1152,1152
Del Norte,7,2022-02-02,267,267,205,62,4237,4243,3269,974,2,2,2,1,44,44,42,42
El Dorado,7,2022-02-02,602,602,451,151,5606,5612,4222,1390,16,0,0,5,198,198,198,198
Fresno,7,2022-02-02,9039,9051,6577,2474,50289,50356,36681,13675,505,40,40,102,2580,2580,2540,2540
Glenn,7,2022-02-02,171,171,129,42,705,705,534,171,2,0,0,0,41,41,41,41
Humboldt,7,2022-02-02,552,552,423,129,5595,5602,4296,1306,19,3,3,2,134,134,131,131
Imperial,7,2022-02-02,1626,1626,1213,413,10069,10083,7529,2554,70,18,18,24,901,901,883,883
Inyo,7,2022-02-02,54,54,42,12,457,457,357,100,6,3,3,0,56,56,53,53
Kern,7,2022-02-02,4764,4770,3737,1033,39307,39360,30895,8465,193,42,42,41,2213,2213,2171,2171
Kings,7,2022-02-02,1964,1965,1472,493,12446,12463,9352,3111,55,8,8,7,408,408,400,400
Lake,7,2022-02-02,419,419,303,116,2988,2993,2167,826,9,2,2,3,126,126,124,124
Lassen,7,2022-02-02,245,245,194,51,3263,3269,2602,667,6,2,2,0,56,56,54,54
Los Angeles,7,2022-02-02,58480,58559,53515,5044,1236213,1237866,1132746,105120,2728,683,683,670,29873,29873,29190,29190
Madera,7,2022-02-02,1416,1416,1028,388,8634,8646,6294,2352,46,7,7,7,358,358,351,351
Marin,7,2022-02-02,900,900,657,243,13003,13021,9534,3487,28,5,5,7,275,275,270,270
Mariposa,7,2022-02-02,81,81,58,23,767,767,546,221,0,2,2,0,24,24,22,22
Mendocino,7,2022-02-02,367,367,245,122,3118,3123,2087,1036,12,2,2,6,114,114,112,112
Merced,7,2022-02-02,1662,1662,1291,371,9317,9330,7256,2074,51,14,14,14,762,762,748,748
Modoc,7,2022-02-02,17,17,13,4,89,89,70,19,1,0,0,0,7,7,7,7
Mono,7,2022-02-02,41,41,26,15,302,302,188,114,0,0,0,0,5,5,5,5
Monterey,7,2022-02-02,2995,3000,1878,1122,24811,24845,15595,9250,83,11,11,12,681,681,670,670
Napa,7,2022-02-02,883,883,705,178,8723,8734,6984,1750,20,8,8,3,124,124,116,116
Nevada,7,2022-02-02,464,464,338,126,3491,3496,2553,943,30,1,1,6,120,120,119,119
Orange,7,2022-02-02,9592,9605,7867,1738,166844,167066,137181,29885,671,144,144,147,6651,6651,6507,6507
Placer,7,2022-02-02,1872,1872,1326,546,14051,14069,9997,4072,149,26,26,45,576,576,550,550
Plumas,7,2022-02-02,109,109,80,29,631,631,464,167,0,1,1,0,13,13,12,12
Riverside,7,2022-02-02,12310,12326,9504,2822,109834,109981,84991,24990,701,113,113,154,6052,6052,5939,5939
Sacramento,7,2022-02-02,8205,8216,6231,1985,71160,71255,54175,17080,483,85,85,100,2817,2817,2732,2732
San Benito,7,2022-02-02,397,397,316,81,3014,3019,2401,618,4,2,2,3,90,90,88,88
San Bernardino,7,2022-02-02,10719,10733,8662,2071,105944,106086,85755,20331,684,178,178,195,7355,7355,7177,7177
San Diego,7,2022-02-02,19692,19718,17935,1783,167590,167814,152783,15031,899,103,103,206,4965,4965,4862,4862
San Francisco,7,2022-02-02,3196,3201,1934,1267,63247,63331,38339,24992,196,21,21,50,769,769,748,748
San Joaquin,7,2022-02-02,4652,4657,3446,1211,39738,39791,29545,10246,205,41,41,79,2117,2117,2076,2076
San Luis Obispo,7,2022-02-02,1628,1629,1283,346,14182,14201,11202,2999,38,15,15,9,419,419,404,404
San Mateo,7,2022-02-02,3491,3496,2864,632,70088,70182,57589,12593,128,9,9,18,644,644,635,635
Santa Barbara,7,2022-02-02,3107,3112,2391,721,34279,34324,26416,7908,106,19,19,20,638,638,619,619
Santa Clara,7,2022-02-02,11419,11435,10346,1089,192976,193234,174972,18262,420,45,45,88,2152,2152,2107,2107
Santa Cruz,7,2022-02-02,2644,2648,2101,547,45129,45189,35863,9326,29,5,5,7,248,248,243,243
Shasta,7,2022-02-02,805,805,612,193,7704,7715,5879,1836,70,17,17,11,497,497,480,480
Siskiyou,7,2022-02-02,117,117,94,23,736,736,591,145,9,3,3,0,71,71,68,68
Solano,7,2022-02-02,3539,3544,2729,815,27859,27896,21531,6365,115,5,5,27,428,428,423,423
Sonoma,7,2022-02-02,2779,2783,2159,624,29654,29692,23100,6592,72,10,10,16,465,465,455,455
Stanislaus,7,2022-02-02,3198,3203,2194,1009,20953,20981,14400,6581,266,42,42,42,1554,1554,1512,1512
Sutter,7,2022-02-02,548,548,420,128,3673,3678,2831,847,0,5,5,0,210,210,205,205
Tehama,7,2022-02-02,365,365,254,111,1975,1978,1375,603,20,2,2,5,179,179,177,177
Trinity,7,2022-02-02,36,36,25,11,182,182,126,56,0,0,0,0,20,20,20,20
Tulare,7,2022-02-02,3873,3878,2638,1240,20892,20919,14269,6650,146,25,25,21,1389,1389,1364,1364
Tuolumne,7,2022-02-02,544,544,394,150,2947,2951,2145,806,19,1,1,2,170,170,169,169
Ventura,7,2022-02-02,3765,3771,3134,637,47513,47576,39608,7968,240,38,38,48,1368,1368,1330,1330
Yolo,7,2022-02-02,1116,1116,882,234,34891,34939,27634,7305,15,5,5,6,296,296,291,291
Yuba,7,2022-02-02,457,457,356,101,2717,2722,2125,597,72,4,4,11,112,112,108,108
Alameda,8,2022-02-09,4895,4902,4138,764,110569,110723,93565,17158,242,47,47,63,1758,1758,1711,1711
Amador,8,2022-02-09,142,142,109,33,2576,2580,1983,597,14,2,2,4,78,78,76,76
Butte,8,2022-02-09,629,629,547,82,6045,6052,5276,776,76,9,9,10,395,395,386,386
Calaveras,8,2022-02-09,148,148,117,31,1394,1394,1109,285,3,0,0,2,106,106,106,106
Colusa,8,2022-02-09,68,68,56,12,538,538,441,97,0,0,0,0,21,21,21,21
Contra Costa,8,2022-02-09,3349,3354,2559,795,50330,50400,38525,11875,166,28,28,38,1224,1224,1196,1196
Del Norte,8,2022-02-09,269,269,217,52,3844,3851,3127,724,8,0,0,2,44,44,44,44
El Dorado,8,2022-02-09,375,375,298,77,4887,4892,3897,995,18,3,3,2,201,201,198,198
Fresno,8,2022-02-09,5222,5228,4045,1183,40459,40516,31403,9113,447,54,54,90,2634,2634,2580,2580
Glenn,8,2022-02-09,86,86,69,17,557,557,445,112,4,1,1,0,42,42,41,41
Humboldt,8,2022-02-09,433,433,350,83,4681,4686,3793,893,20,1,1,4,135,135,134,134
Imperial,8,2022-02-09,911,911,720,191,7527,7539,5966,1573,48,13,13,25,914,914,901,901
Inyo,8,2022-02-09,27,27,22,5,438,438,359,79,1,0,0,0,56,56,56,56
Kern,8,2022-02-09,2854,2858,2351,507,32242,32286,26606,5680,170,33,33,44,2246,2246,2213,2213
Kings,8,2022-02-09,1077,1077,855,222,9350,9364,7447,1917,52,15,15,4,423,423,408,408
Lake,8,2022-02-09,298,298,229,69,2613,2618,2021,597,12,1,1,4,127,127,126,126
Lassen,8,2022-02-09,118,118,98,20,3078,3083,2569,514,5,1,1,0,57,57,56,56
Los Angeles,8,2022-02-09,30819,30861,28758,2103,1127835,1129400,1053310,76090,1972,585,585,492,30458,30458,29873,29873
Madera,8,2022-02-09,857,857,661,196,7423,7433,5747,1686,26,2,2,12,360,360,358,358
Marin,8,2022-02-09,547,547,425,122,10623,10638,8275,2363,31,7,7,7,282,282,275,275
Mariposa,8,2022-02-09,40,40,30,10,520,520,395,125,0,0,0,0,24,24,24,24
Mendocino,8,2022-02-09,289,289,208,81,2706,2710,1954,756,13,2,2,5,116,116,114,114
Merced,8,2022-02-09,953,953,779,174,7707,7718,6317,1401,45,15,15,10,777,777,762,762
Modoc,8,2022-02-09,23,23,19,4,258,258,213,45,4,0,0,0,7,7,7,7
Mono,8,2022-02-09,27,27,18,9,239,239,162,77,0,0,0,0,5,5,5,5
Monterey,8,2022-02-09,1808,1810,1233,577,20892,20920,14305,6615,68,12,12,15,693,693,681,681
Napa,8,2022-02-09,634,634,529,105,7358,7367,6164,1203,20,5,5,2,129,129,124,124
Nevada,8,2022-02-09,280,280,217,63,3022,3027,2351,676,25,2,2,2,122,122,120,120
Orange,8,2022-02-09,5371,5378,4590,788,148259,148466,126970,21496,463,119,119,118,6770,6770,6651,6651
Placer,8,2022-02-09,1027,1027,777,250,11445,11461,8706,2755,134,13,13,29,589,589,576,576
Plumas,8,2022-02-09,73,73,57,16,493,493,385,108,1,0,0,0,13,13,13,13
Riverside,8,2022-02-09,6698,6708,5449,1259,87694,87814,71452,16362,483,97,97,118,6149,6149,6052,6052
Sacramento,8,2022-02-09,5078,5085,4071,1014,59817,59900,48083,11817,359,65,65,88,2882,2882,2817,2817
San Benito,8,2022-02-09,248,248,207,41,2454,2457,2046,411,5,0,0,4,90,90,90,90
San Bernardino,8,2022-02-09,5623,5630,4748,882,84047,84164,71070,13094,487,133,133,147,7488,7488,7355,7355
San Diego,8,2022-02-09,11520,11536,10709,827,142817,143015,132817,10198,709,112,112,159,5077,5077,4965,4965
San Francisco,8,2022-02-09,2188,2190,1452,738,52454,52526,34842,17684,169,28,28,38,797,797,769,769
San Joaquin,8,2022-02-09,2805,2810,2206,604,34912,34960,27516,7444,167,35,35,62,2152,2152,2117,2117
San Luis Obispo,8,2022-02-09,1055,1055,872,183,11371,11388,9419,1969,27,11,11,8,430,430,419,419
San Mateo,8,2022-02-09,1989,1990,1697,293,59782,59866,51184,8682,69,19,19,14,663,663,644,644
Santa Barbara,8,2022-02-09,1687,1687,1362,325,26278,26316,21283,5033,76,14,14,20,652,652,638,638
Santa Clara,8,2022-02-09,6570,6580,6082,498,167344,167577,155006,12571,331,31,31,64,2183,2183,2152,2152
Santa Cruz,8,2022-02-09,1593,1593,1324,269,36983,37034,30810,6224,39,3,3,4,251,251,248,248
Shasta,8,2022-02-09,598,598,480,118,6603,6611,5320,1291,61,14,14,11,511,511,497,497
Siskiyou,8,2022-02-09,82,82,69,13,614,614,515,99,5,2,2,2,73,73,71,71
Solano,8,2022-02-09,1743,1743,1414,329,22314,22344,18169,4175,79,4,4,23,432,432,428,428
Sonoma,8,2022-02-09,1740,1740,1420,320,25492,25529,20883,4646,49,10,10,15,475,475,465,465
Stanislaus,8,2022-02-09,2063,2066,1518,548,17607,17632,12997,4635,226,32,32,46,1586,1586,1554,1554
Sutter,8,2022-02-09,284,284,229,55,3089,3094,2507,587,0,6,6,0,216,216,210,210
Tehama,8,2022-02-09,230,230,171,59,1491,1492,1113,379,11,5,5,5,184,184,179,179
Trinity,8,2022-02-09,19,19,14,5,132,132,98,34,0,0,0,0,20,20,20,20
Tulare,8,2022-02-09,2226,2230,1633,597,16477,16501,12113,4388,126,27,27,22,1416,1416,1389,1389
Tuolumne,8,2022-02-09,281,281,217,64,2420,2423,1875,548,9,2,2,3,172,172,170,170
Ventura,8,2022-02-09,2209,2212,1909,303,40482,40537,35060,5477,193,48,48,49,1416,1416,1368,1368
Yolo,8,2022-02-09,745,745,617,128,29917,29958,24845,5113,9,12,12,2,308,308,296,296
Yuba,8,2022-02-09,301,301,247,54,2329,2332,1914,418,28,2,2,14,114,114,112,112
Alameda,9,2022-02-16,2832,2837,2480,357,97006,97150,85038,12112,193,30,30,42,1788,1788,1758,1758
Amador,9,2022-02-16,98,98,79,19,2257,2261,1831,430,6,3,3,3,81,81,78,78
Butte,9,2022-02-16,398,398,356,42,4992,4998,4482,516,63,14,14,8,409,409,395,395
Calaveras,9,2022-02-16,62,62,51,11,1053,1053,877,176,2,3,3,2,109,109,106,106
Colusa,9,2022-02-16,27,27,23,4,391,391,333,58,6,0,0,0,21,21,21,21
Contra Costa,9,2022-02-16,2019,2022,1628,394,43277,43340,34965,8375,109,16,16,36,1240,1240,1224,1224
Del Norte,9,2022-02-16,194,194,163,31,3257,3262,2763,499,6,0,0,2,44,44,44,44
El Dorado,9,2022-02-16,208,208,173,35,4167,4172,3479,693,13,3,3,3,204,204,201,201
Fresno,9,2022-02-16,3102,3107,2528,579,32659,32708,26680,6028,352,26,26,62,2660,2660,2634,2634
Glenn,9,2022-02-16,47,47,39,8,471,471,394,77,3,0,0,0,42,42,42,42
Humboldt,9,2022-02-16,282,282,238,44,4027,4032,3407,625,24,1,1,4,136,136,135,135
Imperial,9,2022-02-16,479,479,397,82,5572,5579,4629,950,43,9,9,16,923,923,914,914
Inyo,9,2022-02-16,21,21,18,3,360,360,307,53,1,0,0,0,56,56,56,56
Kern,9,2022-02-16,1768,1770,1515,255,26598,26637,22844,3793,128,30,30,39,2276,2276,2246,2246
Kings,9,2022-02-16,628,628,522,106,7156,7166,5971,1195,37,4,4,5,427,427,423,423
Lake,9,2022-02-16,249,249,202,47,2196,2199,1788,411,9,3,3,3,130,130,127,127
Lassen,9,2022-02-16,151,151,130,21,2593,2597,2244,353,1,2,2,0,59,59,57,57
Los Angeles,9,2022-02-16,17645,17671,16716,955,1018638,1020131,965762,54369,1355,414,414,358,30872,30872,30458,30458
Madera,9,2022-02-16,518,518,421,97,6453,6462,5261,1201,28,2,2,10,362,362,360,360
Marin,9,2022-02-16,321,321,262,59,10250,10266,8398,1868,19,4,4,7,286,286,282,282
Mariposa,9,2022-02-16,26,26,21,5,407,407,327,80,0,0,0,0,24,24,24,24
Mendocino,9,2022-02-16,161,161,123,38,2234,2237,1718,519,13,2,2,4,118,118,116,116
Merced,9,2022-02-16,670,670,570,100,6384,6392,5449,943,37,10,10,9,787,787,777,777
Modoc,9,2022-02-16,15,15,13,2,80,80,69,11,0,0,0,0,7,7,7,7
Mono,9,2022-02-16,9,9,7,2,153,153,112,41,0,0,0,0,5,5,5,5
Monterey,9,2022-02-16,1064,1064,780,284,15924,15947,11730,4217,51,10,10,13,703,703,693,693
Napa,9,2022-02-16,351,351,305,46,6096,6105,5299,806,8,2,2,4,131,131,129,129
Nevada,9,2022-02-16,152,152,124,28,2426,2430,1987,443,17,2,2,4,124,124,122,122
Orange,9,2022-02-16,3509,3515,3101,414,130541,130732,115560,15172,323,97,97,76,6867,6867,6770,6770
Placer,9,2022-02-16,492,492,393,99,9636,9651,7748,1903,104,12,12,19,601,601,589,589
Plumas,9,2022-02-16,27,27,22,5,407,407,334,73,1,0,0,0,13,13,13,13
Riverside,9,2022-02-16,3860,3867,3277,590,70690,70794,60100,10694,340,76,76,92,6225,6225,6149,6149
Sacramento,9,2022-02-16,2888,2893,2424,469,51710,51786,43481,8305,319,50,50,55,2932,2932,2882,2882
San Benito,9,2022-02-16,138,138,119,19,2093,2097,1813,284,2,1,1,3,91,91,90,90
San Bernardino,9,2022-02-16,2969,2974,2597,377,69270,69372,60675,8697,322,108,108,109,7596,7596,7488,7488
San Diego,9,2022-02-16,6732,6742,6359,383,121210,121387,114551,6836,560,81,81,122,5158,5158,5077,5077
San Francisco,9,2022-02-16,1320,1320,944,376,46598,46666,33465,13201,129,19,19,33,816,816,797,797
San Joaquin,9,2022-02-16,1681,1681,1386,295,29136,29179,24104,5075,124,35,35,45,2187,2187,2152,2152
San Luis Obispo,9,2022-02-16,668,668,574,94,9637,9652,8301,1351,22,12,12,5,442,442,430,430
San Mateo,9,2022-02-16,1141,1141,1006,135,53110,53187,46983,6204,55,11,11,12,674,674,663,663
Santa Barbara,9,2022-02-16,982,982,829,153,23181,23216,19632,3584,57,12,12,13,664,664,652,652
Santa Clara,9,2022-02-16,3808,3814,3585,229,148986,149204,140344,8860,273,29,29,58,2212,2212,2183,2183
Santa Cruz,9,2022-02-16,875,875,756,119,30552,30596,26440,4156,17,2,2,6,253,253,251,251
Shasta,9,2022-02-16,407,407,342,65,5630,5638,4743,895,67,9,9,16,520,520,511,511
Siskiyou,9,2022-02-16,65,65,56,9,525,525,456,69,6,1,1,4,74,74,73,73
Solano,9,2022-02-16,1021,1021,865,156,17856,17882,15164,2718,64,3,3,20,435,435,432,432
Sonoma,9,2022-02-16,929,929,790,139,20752,20781,17724,3057,48,3,3,7,478,478,475,475
Stanislaus,9,2022-02-16,1166,1166,910,256,14533,14554,11396,3158,184,34,34,43,1620,1620,1586,1586
Sutter,9,2022-02-16,214,214,181,33,2673,2677,2263,414,0,1,1,0,217,217,216,216
Tehama,9,2022-02-16,151,151,119,32,1357,1357,1072,285,15,3,3,5,187,187,184,184
Trinity,9,2022-02-16,21,21,16,5,196,196,154,42,0,0,0,0,20,20,20,20
Tulare,9,2022-02-16,1189,1189,926,263,14399,14421,11234,3187,98,19,19,15,1435,1435,1416,1416
Tuolumne,9,2022-02-16,167,167,136,31,2239,2243,1828,415,13,5,5,2,177,177,172,172
Ventura,9,2022-02-16,1309,1309,1165,144,33611,33660,30002,3658,137,20,20,28,1436,1436,1416,1416
Yolo,9,2022-02-16,398,398,342,56,25935,25974,22378,3596,8,4,4,5,312,312,308,308
Yuba,9,2022-02-16,186,186,159,27,1922,1925,1644,281,21,0,0,11,114,114,114,114
Alameda,10,2022-02-23,1676,1676,1507,169,72058,72169,64938,7231,121,26,26,28,1814,1814,1788,1788
Amador,10,2022-02-23,61,61,51,10,1913,1916,1620,296,7,3,3,2,84,84,81,81
Butte,10,2022-02-23,230,230,211,19,4469,4475,4107,368,51,9,9,5,418,418,409,409
Calaveras,10,2022-02-23,38,38,33,5,943,943,817,126,1,5,5,0,114,114,109,109
Colusa,10,2022-02-23,17,17,15,2,376,376,331,45,7,0,0,0,21,21,21,21
Contra Costa,10,2022-02-23,1144,1144,962,182,32799,32849,27681,5168,64,18,18,22,1258,1258,1240,1240
Del Norte,10,2022-02-23,104,104,91,13,2792,2796,2453,343,8,1,1,3,45,45,44,44
El Dorado,10,2022-02-23,141,141,122,19,3410,3415,2954,461,6,0,0,6,204,204,204,204
Fresno,10,2022-02-23,1686,1687,1432,255,26467,26508,22543,3965,250,27,27,67,2687,2687,2660,2660
Glenn,10,2022-02-23,20,20,17,3,401,401,348,53,1,0,0,0,42,42,42,42
Humboldt,10,2022-02-23,174,174,152,22,3038,3043,2661,382,18,2,2,1,138,138,136,136
Imperial,10,2022-02-23,349,349,300,49,4891,4898,4224,674,34,8,8,8,931,931,923,923
Inyo,10,2022-02-23,13,13,11,2,311,311,274,37,0,0,0,0,56,56,56,56
Kern,10,2022-02-23,1035,1035,915,120,23495,23531,20830,2701,99,17,17,26,2293,2293,2276,2276
Kings,10,2022-02-23,383,383,331,52,6590,6600,5707,893,31,8,8,4,435,435,427,427
Lake,10,2022-02-23,148,148,125,23,1884,1887,1598,289,5,4,4,1,134,134,130,130
Lassen,10,2022-02-23,99,99,88,11,2175,2178,1940,238,1,1,1,0,60,60,59,59
Los Angeles,10,2022-02-23,10282,10297,9859,438,903517,904894,866984,37910,909,285,285,241,31157,31157,30872,30872
Madera,10,2022-02-23,258,258,218,40,4548,4555,3864,691,31,4,4,7,366,366,362,362
Marin,10,2022-02-23,168,168,143,25,8051,8063,6862,1201,13,4,4,3,290,290,286,286
Mariposa,10,2022-02-23,26,26,22,4,364,364,306,58,0,1,1,0,25,25,24,24
Mendocino,10,2022-02-23,109,109,88,21,1901,1903,1539,364,9,2,2,2,120,120,118,118
Merced,10,2022-02-23,372,372,327,45,5110,5117,4509,608,24,10,10,4,797,797,787,787
Modoc,10,2022-02-23,6,6,5,1,55,55,49,6,1,0,0,0,7,7,7,7
Mono,10,2022-02-23,6,6,5,1,162,162,126,36,0,1,1,0,6,6,5,5
Monterey,10,2022-02-23,629,629,489,140,13555,13576,10614,2962,34,6,6,6,709,709,703,703
Napa,10,2022-02-23,189,189,169,20,4949,4956,4431,525,5,4,4,2,135,135,131,131
Nevada,10,2022-02-23,84,84,71,13,2016,2020,1720,300,14,1,1,6,125,125,124,124
Orange,10,2022-02-23,2134,2137,1936,201,110693,110862,100568,10294,236,69,69,63,6936,6936,6867,6867
Placer,10,2022-02-23,285,285,239,46,8340,8353,7008,1345,94,8,8,13,609,609,601,601
Plumas,10,2022-02-23,24,24,20,4,339,339,289,50,1,0,0,0,13,13,13,13
Riverside,10,2022-02-23,2023,2026,1777,249,62106,62201,54640,7561,253,42,42,58,6267,6267,6225,6225
Sacramento,10,2022-02-23,1569,1569,1362,207,42589,42654,37132,5522,221,34,34,44,2966,2966,2932,2932
San Benito,10,2022-02-23,86,86,76,10,1716,1718,1530,188,0,0,0,2,91,91,91,91
San Bernardino,10,2022-02-23,1567,1567,1408,159,58952,59041,53104,5937,224,79,79,71,7675,7675,7596,7596
San Diego,10,2022-02-23,3839,3846,3674,172,96802,96949,92646,4303,436,48,48,96,5206,5206,5158,5158
San Francisco,10,2022-02-23,930,930,711,219,39079,39138,29903,9235,92,14,14,25,830,830,816,816
San Joaquin,10,2022-02-23,856,856,734,122,24359,24396,20962,3434,75,24,24,29,2211,2211,2187,2187
San Luis Obispo,10,2022-02-23,411,411,364,47,7578,7589,6735,854,14,14,14,2,456,456,442,442
San Mateo,10,2022-02-23,579,579,524,55,38273,38330,34736,3594,45,10,10,7,684,684,674,674
Santa Barbara,10,2022-02-23,464,464,406,58,19715,19745,17294,2451,36,3,3,11,667,667,664,664
Santa Clara,10,2022-02-23,2067,2070,1972,98,97372,97521,92879,4642,213,27,27,56,2239,2239,2212,2212
Santa Cruz,10,2022-02-23,501,501,447,54,24295,24332,21672,2660,18,2,2,5,255,255,253,253
Shasta,10,2022-02-23,193,193,168,25,4786,4793,4178,615,44,10,10,11,530,530,520,520
Siskiyou,10,2022-02-23,42,42,38,4,440,440,393,47,6,4,4,1,78,78,74,74
Solano,10,2022-02-23,552,552,484,68,14412,14434,12664,1770,46,5,5,15,440,440,435,435
Sonoma,10,2022-02-23,547,547,481,66,15261,15283,13472,1811,33,2,2,6,480,480,478,478
Stanislaus,10,2022-02-23,604,604,496,108,12322,12340,10158,2182,152,23,23,27,1643,1643,1620,1620
Sutter,10,2022-02-23,105,105,92,13,2147,2149,1882,267,0,2,2,0,219,219,217,217
Tehama,10,2022-02-23,77,77,64,13,1173,1173,972,201,8,9,9,3,196,196,187,187
Trinity,10,2022-02-23,7,7,6,1,162,162,133,29,0,0,0,0,20,20,20,20
Tulare,10,2022-02-23,619,619,506,113,11277,11294,9268,2026,71,21,21,12,1456,1456,1435,1435
Tuolumne,10,2022-02-23,88,88,75,13,1499,1499,1273,226,7,5,5,3,182,182,177,177
Ventura,10,2022-02-23,760,760,693,67,27760,27801,25398,2403,90,24,24,20,1460,1460,1436,1436
Yolo,10,2022-02-23,254,254,226,28,21829,21863,19441,2422,7,2,2,5,314,314,312,312
Yuba,10,2022-02-23,105,105,93,12,1707,1708,1508,200,18,1,1,6,115,115,114,114
Alameda,11,2022-03-02,1319,1319,1213,106,76002,76122,70075,6047,124,12,12,27,1826,1826,1814,1814
Amador,11,2022-03-02,94,94,83,11,1835,1837,1606,231,6,1,1,1,85,85,84,84
Butte,11,2022-03-02,156,156,146,10,3913,3919,3663,256,37,4,4,2,422,422,418,418
Calaveras,11,2022-03-02,29,29,26,3,1185,1185,1056,129,1,4,4,0,118,118,114,114
Colusa,11,2022-03-02,9,9,8,1,374,374,338,36,6,0,0,0,21,21,21,21
Contra Costa,11,2022-03-02,768,768,669,99,32635,32686,28542,4144,51,16,16,13,1274,1274,1258,1258
Del Norte,11,2022-03-02,65,65,58,7,1878,1880,1691,189,3,2,2,1,47,47,45,45
El Dorado,11,2022-03-02,98,98,87,11,3460,3465,3089,376,2,2,2,5,206,206,204,204
Fresno,11,2022-03-02,1107,1107,973,134,24064,24103,21196,2907,186,26,26,38,2713,2713,2687,2687
Glenn,11,2022-03-02,18,18,16,2,421,421,376,45,1,0,0,0,42,42,42,42
Humboldt,11,2022-03-02,126,126,113,13,2896,2901,2611,290,10,1,1,2,139,139,138,138
Imperial,11,2022-03-02,216,216,192,24,4457,4462,3969,493,14,5,5,11,936,936,931,931
Inyo,11,2022-03-02,9,9,8,1,382,382,345,37,0,0,0,0,56,56,56,56
Kern,11,2022-03-02,643,643,583,60,22562,22597,20524,2073,76,13,13,17,2306,2306,2293,2293
Kings,11,2022-03-02,180,180,160,20,5393,5402,4816,586,17,3,3,2,438,438,435,435
Lake,11,2022-03-02,100,100,87,13,1841,1844,1617,227,0,1,1,1,135,135,134,134
Lassen,11,2022-03-02,93,93,85,8,1945,1948,1778,170,0,2,2,0,62,62,60,60
Los Angeles,11,2022-03-02,7130,7142,6904,238,946555,948039,916598,31441,715,203,203,137,31360,31360,31157,31157
Madera,11,2022-03-02,165,165,145,20,4204,4210,3697,513,17,0,0,4,366,366,366,366
Marin,11,2022-03-02,162,162,143,19,7788,7800,6875,925,14,2,2,2,292,292,290,290
Mariposa,11,2022-03-02,22,22,19,3,331,331,288,43,0,1,1,0,26,26,25,25
Mendocino,11,2022-03-02,62,62,52,10,1785,1787,1510,277,10,1,1,3,121,121,120,120
Merced,11,2022-03-02,240,240,217,23,4777,4784,4332,452,21,6,6,6,803,803,797,797
Modoc,11,2022-03-02,2,2,2,0,52,52,47,5,0,0,0,0,7,7,7,7
Mono,11,2022-03-02,5,5,4,1,155,155,126,29,0,0,0,0,6,6,6,6
Monterey,11,2022-03-02,300,300,246,54,12097,12117,9949,2168,20,8,8,5,717,717,709,709
Napa,11,2022-03-02,184,184,168,16,5254,5260,4815,445,7,2,2,3,137,137,135,135
Nevada,11,2022-03-02,57,57,50,7,1887,1890,1664,226,11,0,0,0,125,125,125,125
Orange,11,2022-03-02,1516,1516,1402,114,115706,115886,107273,8613,172,39,39,34,6975,6975,6936,6936
Placer,11,2022-03-02,217,217,188,29,7889,7902,6876,1026,60,4,4,17,613,613,609,609
Plumas,11,2022-03-02,14,14,12,2,342,342,301,41,0,0,0,0,13,13,13,13
Riverside,11,2022-03-02,1419,1419,1279,140,58105,58197,52532,5665,163,41,41,31,6308,6308,6267,6267
Sacramento,11,2022-03-02,987,987,883,104,41562,41627,37299,4328,152,22,22,33,2988,2988,2966,2966
San Benito,11,2022-03-02,40,40,36,4,1637,1640,1498,142,0,0,0,2,91,91,91,91
San Bernardino,11,2022-03-02,1048,1048,964,84,56958,57047,52476,4571,127,46,46,44,7721,7721,7675,7675
San Diego,11,2022-03-02,2710,2715,2620,95,97927,98081,94666,3415,320,36,36,71,5242,5242,5206,5206
San Francisco,11,2022-03-02,785,785,633,152,39102,39162,31608,7554,70,11,11,16,841,841,830,830
San Joaquin,11,2022-03-02,551,551,488,63,22706,22741,20159,2582,60,7,7,14,2218,2218,2211,2211
San Luis Obispo,11,2022-03-02,299,299,272,27,7685,7698,7004,694,7,4,4,0,460,460,456,456
San Mateo,11,2022-03-02,588,588,544,44,41477,41543,38479,3064,44,1,1,6,685,685,684,684
Santa Barbara,11,2022-03-02,311,311,279,32,19222,19253,17334,1919,39,4,4,7,671,671,667,667
Santa Clara,11,2022-03-02,1639,1639,1578,61,109436,109608,105598,4010,194,13,13,41,2252,2252,2239,2239
Santa Cruz,11,2022-03-02,388,388,354,34,25937,25977,23713,2264,17,1,1,4,256,256,255,255
Shasta,11,2022-03-02,151,151,135,16,4800,4807,4314,493,36,13,13,8,543,543,530,530
Siskiyou,11,2022-03-02,18,18,16,2,438,438,401,37,3,1,1,1,79,79,78,78
Solano,11,2022-03-02,437,437,394,43,15259,15284,13784,1500,48,2,2,19,442,442,440,440
Sonoma,11,2022-03-02,413,413,374,39,15841,15866,14362,1504,24,6,6,7,486,486,480,480
Stanislaus,11,2022-03-02,400,400,342,58,11857,11875,10168,1707,111,12,12,15,1655,1655,1643,1643
Sutter,11,2022-03-02,93,93,84,9,2183,2187,1968,219,0,2,2,0,221,221,219,219
Tehama,11,2022-03-02,56,56,48,8,1189,1190,1025,165,8,1,1,2,197,197,196,196
Trinity,11,2022-03-02,5,5,4,1,102,102,87,15,0,0,0,0,20,20,20,20
Tulare,11,2022-03-02,393,393,335,58,10598,10616,9066,1550,54,7,7,7,1463,1463,1456,1456
Tuolumne,11,2022-03-02,55,55,48,7,1374,1374,1207,167,8,3,3,1,185,185,182,182
Ventura,11,2022-03-02,478,478,445,33,27847,27890,25974,1916,58,6,6,10,1466,1466,1460,1460
Yolo,11,2022-03-02,188,188,171,17,23990,24027,21889,2138,8,3,3,4,317,317,314,314
Yuba,11,2022-03-02,69,69,63,6,1680,1682,1524,158,12,1,1,6,116,116,115,115
Alameda,12,2022-03-09,1053,1053,987,66,70549,70664,66212,4452,83,13,13,15,1839,1839,1826,1826
Amador,12,2022-03-09,38,38,34,4,1410,1411,1271,140,4,1,1,1,86,86,85,85
Butte,12,2022-03-09,84,84,80,4,3790,3795,3599,196,25,3,3,4,425,425,422,422
Calaveras,12,2022-03-09,27,27,25,2,1083,1083,990,93,1,1,1,0,119,119,118,118
Colusa,12,2022-03-09,10,10,9,1,324,324,299,25,3,0,0,0,21,21,21,21
Contra Costa,12,2022-03-09,600,600,539,61,29938,29988,26936,3052,36,5,5,13,1279,1279,1274,1274
Del Norte,12,2022-03-09,51,51,47,4,1666,1669,1534,135,3,1,1,3,48,48,47,47
El Dorado,12,2022-03-09,63,63,57,6,3095,3100,2832,268,3,3,3,3,209,209,206,206
Fresno,12,2022-03-09,705,705,636,69,22010,22045,19922,2123,143,17,17,26,2730,2730,2713,2713
Glenn,12,2022-03-09,17,17,16,1,375,375,343,32,1,0,0,0,42,42,42,42
Humboldt,12,2022-03-09,71,71,65,6,3003,3008,2767,241,4,3,3,2,142,142,139,139
Imperial,12,2022-03-09,115,115,105,10,4839,4846,4420,426,11,3,3,10,939,939,936,936
Inyo,12,2022-03-09,11,11,10,1,243,243,224,19,1,0,0,0,56,56,56,56
Kern,12,2022-03-09,392,392,363,29,20386,20420,18933,1487,63,12,12,11,2318,2318,2306,2306
Kings,12,2022-03-09,211,211,193,18,4791,4799,4384,415,17,4,4,1,442,442,438,438
Lake,12,2022-03-09,63,63,57,6,1728,1731,1560,171,0,2,2,0,137,137,135,135
Lassen,12,2022-03-09,36,36,33,3,1636,1637,1523,114,1,0,0,0,62,62,62,62
Los Angeles,12,2022-03-09,4931,4939,4810,129,861453,862850,840479,22371,520,155,155,113,31515,31515,31360,31360
Madera,12,2022-03-09,107,107,96,11,3868,3873,3495,378,14,1,1,3,367,367,366,366
Marin,12,2022-03-09,178,178,161,17,7063,7075,6399,676,10,2,2,1,294,294,292,292
Mariposa,12,2022-03-09,10,10,9,1,260,260,233,27,0,1,1,0,27,27,26,26
Mendocino,12,2022-03-09,56,56,49,7,1575,1576,1378,198,3,0,0,0,121,121,121,121
Merced,12,2022-03-09,157,157,145,12,4246,4252,3931,321,17,6,6,4,809,809,803,803
Modoc,12,2022-03-09,1,1,1,0,56,56,52,4,1,0,0,0,7,7,7,7
Mono,12,2022-03-09,2,2,2,0,128,128,109,19,0,0,0,0,6,6,6,6
Monterey,12,2022-03-09,206,206,176,30,10769,10786,9220,1566,16,5,5,2,722,722,717,717
Napa,12,2022-03-09,196,196,183,13,4647,4653,4340,313,5,1,1,3,138,138,137,137
Nevada,12,2022-03-09,54,54,49,5,1624,1625,1470,155,4,1,1,0,126,126,125,125
Orange,12,2022-03-09,1098,1098,1033,65,104759,104930,98766,6164,131,27,27,29,7002,7002,6975,6975
Placer,12,2022-03-09,159,159,142,17,7510,7523,6737,786,62,4,4,10,617,617,613,613
Plumas,12,2022-03-09,7,7,6,1,272,272,246,26,0,0,0,0,13,13,13,13
Riverside,12,2022-03-09,858,858,791,67,52381,52466,48407,4059,122,21,21,22,6329,6329,6308,6308
Sacramento,12,2022-03-09,694,694,636,58,38424,38486,35292,3194,127,18,18,23,3006,3006,2988,2988
San Benito,12,2022-03-09,39,39,36,3,1514,1516,1412,104,0,2,2,2,93,93,91,91
San Bernardino,12,2022-03-09,675,675,632,43,53101,53187,49818,3369,98,39,39,35,7760,7760,7721,7721
San Diego,12,2022-03-09,2213,2218,2157,61,98697,98858,96163,2695,209,26,26,52,5268,5268,5242,5242
San Francisco,12,2022-03-09,636,636,536,100,36084,36142,30458,5684,53,7,7,10,848,848,841,841
San Joaquin,12,2022-03-09,370,370,336,34,20547,20581,18720,1861,26,10,10,15,2228,2228,2218,2218
San Luis Obispo,12,2022-03-09,220,220,204,16,7183,7194,6679,515,6,7,7,0,467,467,460,460
San Mateo,12,2022-03-09,515,515,484,31,38352,38414,36158,2256,30,2,2,3,687,687,685,685
Santa Barbara,12,2022-03-09,193,193,178,15,17555,17583,16191,1392,14,6,6,7,677,677,671,671
Santa Clara,12,2022-03-09,1315,1315,1277,38,107450,107624,104499,3125,137,14,14,33,2266,2266,2252,2252
Santa Cruz,12,2022-03-09,301,301,280,21,23713,23750,22104,1646,9,1,1,6,257,257,256,256
Shasta,12,2022-03-09,118,118,108,10,5099,5107,4689,418,18,4,4,3,547,547,543,543
Siskiyou,12,2022-03-09,20,20,19,1,384,384,358,26,0,2,2,1,81,81,79,79
Solano,12,2022-03-09,307,307,283,24,13335,13357,12316,1041,44,2,2,11,444,444,442,442
Sonoma,12,2022-03-09,273,273,252,21,14659,14683,13576,1107,23,0,0,7,486,486,486,486
Stanislaus,12,2022-03-09,243,243,215,28,10394,10410,9208,1202,84,9,9,13,1664,1664,1655,1655
Sutter,12,2022-03-09,71,71,65,6,1928,1932,1779,153,0,1,1,0,222,222,221,221
Tehama,12,2022-03-09,31,31,28,3,1055,1055,937,118,0,2,2,1,199,199,197,197
Trinity,12,2022-03-09,5,5,4,1,118,118,104,14,0,0,0,0,20,20,20,20
Tulare,12,2022-03-09,247,247,218,29,10097,10114,8925,1189,35,11,11,4,1474,1474,1463,1463
Tuolumne,12,2022-03-09,42,42,38,4,1287,1287,1163,124,2,0,0,1,185,185,185,185
Ventura,12,2022-03-09,377,377,356,21,26467,26510,25070,1440,42,4,4,10,1470,1470,1466,1466
Yolo,12,2022-03-09,148,148,138,10,22016,22052,20498,1554,3,0,0,1,317,317,317,317
Yuba,12,2022-03-09,48,48,44,4,1493,1494,1382,112,17,0,0,2,116,116,116,116
Alameda,13,2022-03-16,732,732,695,37,68208,68321,64928,3393,58,10,10,5,1849,1849,1839,1839
Amador,13,2022-03-16,23,23,21,2,1364,1364,1255,109,3,0,0,0,86,86,86,86
Butte,13,2022-03-16,82,82,79,3,3273,3278,3144,134,18,1,1,0,426,426,425,425
Calaveras,13,2022-03-16,12,12,11,1,756,756,703,53,0,0,0,1,119,119,119,119
Colusa,13,2022-03-16,2,2,2,0,249,249,234,15,2,0,0,0,21,21,21,21
Contra Costa,13,2022-03-16,538,538,494,44,28750,28797,26466,2331,16,6,6,11,1285,1285,1279,1279
Del Norte,13,2022-03-16,31,31,29,2,1286,1287,1205,82,0,1,1,2,49,49,48,48
El Dorado,13,2022-03-16,38,38,35,3,2871,2876,2679,197,3,1,1,0,210,210,209,209
Fresno,13,2022-03-16,446,446,411,35,20758,20794,19197,1597,114,8,8,19,2738,2738,2730,2730
Glenn,13,2022-03-16,11,11,10,1,349,349,326,23,1,0,0,0,42,42,42,42
Humboldt,13,2022-03-16,44,44,41,3,2419,2424,2270,154,4,1,1,2,143,143,142,142
Imperial,13,2022-03-16,58,58,54,4,4086,4092,3805,287,6,1,1,4,940,940,939,939
Inyo,13,2022-03-16,1,1,1,0,160,160,150,10,0,0,0,0,56,56,56,56
Kern,13,2022-03-16,237,237,223,14,20080,20114,18953,1161,39,10,10,8,2328,2328,2318,2318
Kings,13,2022-03-16,122,122,113,9,4549,4556,4242,314,10,1,1,2,443,443,442,442
Lake,13,2022-03-16,33,33,30,3,1491,1494,1376,118,2,1,1,1,138,138,137,137
Lassen,13,2022-03-16,5,5,5,0,1552,1553,1468,85,0,0,0,0,62,62,62,62
Los Angeles,13,2022-03-16,3897,3904,3825,79,840971,842366,825259,17107,410,102,102,85,31617,31617,31515,31515
Madera,13,2022-03-16,47,47,43,4,3465,3470,3201,269,10,0,0,1,367,367,367,367
Marin,13,2022-03-16,147,147,136,11,6640,6651,6150,501,6,0,0,0,294,294,294,294
Mariposa,13,2022-03-16,9,9,8,1,248,248,228,20,0,0,0,0,27,27,27,27
Mendocino,13,2022-03-16,33,33,30,3,1373,1374,1236,138,4,2,2,2,123,123,121,121
Merced,13,2022-03-16,108,108,102,6,4018,4023,3782,241,18,3,3,5,812,812,809,809
Modoc,13,2022-03-16,3,3,3,0,55,55,52,3,0,0,0,0,7,7,7,7
Mono,13,2022-03-16,2,2,2,0,118,118,104,14,1,0,0,0,6,6,6,6
Monterey,13,2022-03-16,146,146,129,17,10143,10160,8976,1184,15,2,2,0,724,724,722,722
Napa,13,2022-03-16,87,87,82,5,3788,3794,3592,202,5,1,1,3,139,139,138,138
Nevada,13,2022-03-16,36,36,33,3,1560,1561,1442,119,1,0,0,0,126,126,126,126
Orange,13,2022-03-16,780,780,744,36,100325,100491,95835,4656,110,26,26,27,7028,7028,7002,7002
Placer,13,2022-03-16,125,125,114,11,6956,6969,6386,583,41,1,1,3,618,618,617,617
Plumas,13,2022-03-16,5,5,5,0,291,291,269,22,0,0,0,0,13,13,13,13
Riverside,13,2022-03-16,719,719,675,44,53771,53860,50563,3297,87,12,12,13,6341,6341,6329,6329
Sacramento,13,2022-03-16,532,532,497,35,33621,33677,31455,2222,117,14,14,18,3020,3020,3006,3006
San Benito,13,2022-03-16,23,23,22,1,1384,1385,1310,75,0,0,0,1,93,93,93,93
San Bernardino,13,2022-03-16,521,521,495,26,50962,51047,48497,2550,69,23,23,34,7783,7783,7760,7760
San Diego,13,2022-03-16,1704,1706,1669,37,90859,91008,89058,1950,171,14,14,41,5282,5282,5268,5268
San Francisco,13,2022-03-16,603,603,527,76,34016,34073,29755,4318,31,5,5,10,853,853,848,848
San Joaquin,13,2022-03-16,253,253,235,18,17191,17220,15973,1247,19,5,5,8,2233,2233,2228,2228
San Luis Obispo,13,2022-03-16,126,126,119,7,6683,6695,6316,379,6,6,6,2,473,473,467,467
San Mateo,13,2022-03-16,408,408,389,19,34809,34867,33250,1617,30,0,0,2,687,687,687,687
Santa Barbara,13,2022-03-16,187,187,175,12,16753,16780,15726,1054,16,4,4,1,681,681,677,677
Santa Clara,13,2022-03-16,975,975,953,22,95191,95349,93185,2164,101,6,6,31,2272,2272,2266,2266
Santa Cruz,13,2022-03-16,243,243,230,13,21863,21899,20697,1202,11,2,2,3,259,259,257,257
Shasta,13,2022-03-16,79,79,74,5,4536,4543,4247,296,17,8,8,1,555,555,547,547
Siskiyou,13,2022-03-16,9,9,9,0,373,373,353,20,1,2,2,0,83,83,81,81
Solano,13,2022-03-16,220,220,206,14,12109,12129,11380,749,27,1,1,5,445,445,444,444
Sonoma,13,2022-03-16,213,213,200,13,13331,13354,12560,794,9,2,2,3,488,488,486,486
Stanislaus,13,2022-03-16,186,186,169,17,8795,8809,7992,817,76,11,11,13,1675,1675,1664,1664
Sutter,13,2022-03-16,32,32,30,2,1578,1580,1480,100,0,1,1,0,223,223,222,222
Tehama,13,2022-03-16,13,13,12,1,998,998,909,89,2,2,2,0,201,201,199,199
Trinity,13,2022-03-16,1,1,1,0,98,98,89,9,0,0,0,0,20,20,20,20
Tulare,13,2022-03-16,145,145,131,14,8864,8880,8043,837,31,2,2,6,1476,1476,1474,1474
Tuolumne,13,2022-03-16,16,16,15,1,1247,1247,1151,96,3,0,0,1,185,185,185,185
Ventura,13,2022-03-16,308,308,295,13,24309,24350,23310,1040,36,7,7,5,1477,1477,1470,1470
Yolo,13,2022-03-16,101,101,95,6,21798,21834,20619,1215,1,2,2,1,319,319,317,317
Yuba,13,2022-03-16,43,43,40,3,1328,1328,1249,79,5,0,0,4,116,116,116,116
Alameda,14,2022-03-23,814,814,782,32,61837,61943,59509,2434,51,3,3,6,1852,1852,1849,1849
Amador,14,2022-03-23,25,25,23,2,1416,1416,1326,90,2,0,0,0,86,86,86,86
Butte,14,2022-03-23,73,73,71,2,3118,3123,3023,100,18,0,0,2,426,426,426,426
Calaveras,14,2022-03-23,8,8,8,0,595,595,562,33,0,0,0,0,119,119,119,119
Colusa,14,2022-03-23,3,3,3,0,222,222,211,11,0,0,0,0,21,21,21,21
Contra Costa,14,2022-03-23,433,433,405,28,25558,25603,23956,1647,35,5,5,4,1290,1290,1285,1285
Del Norte,14,2022-03-23,17,17,16,1,1173,1173,1114,59,0,0,0,0,49,49,49,49
El Dorado,14,2022-03-23,54,54,51,3,2805,2810,2657,153,1,2,2,0,212,212,210,210
Fresno,14,2022-03-23,327,327,307,20,19045,19077,17916,1161,96,10,10,13,2748,2748,2738,2738
Glenn,14,2022-03-23,7,7,7,0,364,364,345,19,0,0,0,0,42,42,42,42
Humboldt,14,2022-03-23,31,31,29,2,2580,2585,2456,129,4,1,1,2,144,144,143,143
Imperial,14,2022-03-23,62,62,59,3,3953,3959,3739,220,4,3,3,3,943,943,940,940
Inyo,14,2022-03-23,2,2,2,0,165,165,157,8,0,0,0,0,56,56,56,56
Kern,14,2022-03-23,197,197,188,9,19026,19059,18192,867,33,6,6,7,2334,2334,2328,2328
Kings,14,2022-03-23,68,68,64,4,4376,4383,4144,239,5,3,3,1,446,446,443,443
Lake,14,2022-03-23,15,15,14,1,1317,1317,1235,82,0,0,0,0,138,138,138,138
Lassen,14,2022-03-23,9,9,9,0,1411,1413,1352,61,0,0,0,0,62,62,62,62
Los Angeles,14,2022-03-23,4343,4350,4281,69,794613,795971,783304,12667,299,71,71,52,31688,31688,31617,31617
Madera,14,2022-03-23,33,33,31,2,3338,3343,3137,206,7,1,1,1,368,368,367,367
Marin,14,2022-03-23,151,151,142,9,5857,5867,5516,351,6,1,1,0,295,295,294,294
Mariposa,14,2022-03-23,7,7,7,0,192,192,179,13,0,0,0,0,27,27,27,27
Mendocino,14,2022-03-23,31,31,29,2,1460,1462,1344,118,4,0,0,1,123,123,123,123
Merced,14,2022-03-23,73,73,70,3,3554,3559,3390,169,13,3,3,2,815,815,812,812
Modoc,14,2022-03-23,3,3,3,0,55,55,53,2,0,0,0,0,7,7,7,7
Mono,14,2022-03-23,3,3,3,0,132,132,119,13,0,0,0,0,6,6,6,6
Monterey,14,2022-03-23,173,173,157,16,9559,9575,8679,896,22,0,0,2,724,724,724,724
Napa,14,2022-03-23,50,50,48,2,3294,3300,3162,138,5,1,1,2,140,140,139,139
Nevada,14,2022-03-23,26,26,24,2,1512,1514,1423,91,0,0,0,0,126,126,126,126
Orange,14,2022-03-23,773,773,745,28,92212,92369,88995,3374,103,14,14,24,7042,7042,7028,7028
Placer,14,2022-03-23,107,107,100,7,6331,6343,5922,421,35,3,3,7,621,621,618,618
Plumas,14,2022-03-23,2,2,2,0,254,254,239,15,0,0,0,0,13,13,13,13
Riverside,14,2022-03-23,539,539,513,26,47545,47627,45303,2324,64,9,9,11,6350,6350,6341,6341
Sacramento,14,2022-03-23,452,452,429,23,32816,32873,31162,1711,84,7,7,13,3027,3027,3020,3020
San Benito,14,2022-03-23,16,16,15,1,1307,1308,1252,56,0,1,1,0,94,94,93,93
San Bernardino,14,2022-03-23,481,481,462,19,45100,45177,43383,1794,54,20,20,26,7803,7803,7783,7783
San Diego,14,2022-03-23,1250,1250,1229,21,78716,78850,77522,1328,124,12,12,36,5294,5294,5282,5282
San Francisco,14,2022-03-23,755,755,679,76,32876,32932,29585,3347,30,3,3,5,856,856,853,853
San Joaquin,14,2022-03-23,194,194,183,11,16416,16444,15514,930,21,8,8,6,2241,2241,2233,2233
San Luis Obispo,14,2022-03-23,102,102,97,5,5833,5843,5581,262,4,4,4,0,477,477,473,473
San Mateo,14,2022-03-23,475,475,458,17,34834,34892,33620,1272,27,2,2,3,689,689,687,687
Santa Barbara,14,2022-03-23,130,130,123,7,11117,11136,10571,565,16,6,6,3,687,687,681,681
Santa Clara,14,2022-03-23,1170,1170,1149,21,90451,90605,88990,1615,99,7,7,21,2279,2279,2272,2272
Santa Cruz,14,2022-03-23,148,148,142,6,19127,19159,18328,831,5,0,0,2,259,259,259,259
Shasta,14,2022-03-23,40,40,38,2,3979,3985,3780,205,7,5,5,2,560,560,555,555
Siskiyou,14,2022-03-23,6,6,6,0,326,326,312,14,1,0,0,0,83,83,83,83
Solano,14,2022-03-23,153,153,146,7,11239,11258,10709,549,23,1,1,7,446,446,445,445
Sonoma,14,2022-03-23,220,220,209,11,9336,9352,8903,449,10,1,1,1,489,489,488,488
Stanislaus,14,2022-03-23,139,139,129,10,8441,8456,7833,623,45,10,10,8,1685,1685,1675,1675
Sutter,14,2022-03-23,29,29,28,1,1533,1535,1459,76,0,1,1,0,224,224,223,223
Tehama,14,2022-03-23,11,11,10,1,890,890,827,63,1,0,0,1,201,201,201,201
Trinity,14,2022-03-23,0,0,0,0,104,104,96,8,0,0,0,0,20,20,20,20
Tulare,14,2022-03-23,96,96,89,7,7957,7971,7374,597,21,4,4,4,1480,1480,1476,1476
Tuolumne,14,2022-03-23,14,14,13,1,1075,1075,1010,65,2,0,0,0,185,185,185,185
Ventura,14,2022-03-23,310,310,300,10,22039,22077,21334,743,26,4,4,5,1481,1481,1477,1477
Yolo,14,2022-03-23,113,113,108,5,19764,19798,18920,878,1,0,0,1,319,319,319,319
Yuba,14,2022-03-23,28,28,27,1,1350,1350,1287,63,6,1,1,1,117,117,116,116
Alameda,15,2022-03-30,861,861,834,27,58868,58973,57159,1814,47,5,5,3,1857,1857,1852,1852
Amador,15,2022-03-30,5,5,5,0,1287,1288,1224,64,3,0,0,0,86,86,86,86
Butte,15,2022-03-30,63,63,61,2,2814,2819,2748,71,8,0,0,2,426,426,426,426
Calaveras,15,2022-03-30,13,13,12,1,593,593,567,26,0,0,0,0,119,119,119,119
Colusa,15,2022-03-30,3,3,3,0,210,210,202,8,0,0,0,0,21,21,21,21
Contra Costa,15,2022-03-30,561,561,532,29,24341,24384,23145,1239,21,0,0,4,1290,1290,1290,1290
Del Norte,15,2022-03-30,11,11,11,0,1137,1138,1093,45,1,0,0,0,49,49,49,49
El Dorado,15,2022-03-30,54,54,52,2,2724,2729,2612,117,0,0,0,0,212,212,212,212
Fresno,15,2022-03-30,233,233,222,11,17788,17818,16962,856,82,7,7,12,2755,2755,2748,2748
Glenn,15,2022-03-30,5,5,5,0,317,317,304,13,0,0,0,0,42,42,42,42
Humboldt,15,2022-03-30,18,18,17,1,2599,2604,2501,103,2,0,0,3,144,144,144,144
Imperial,15,2022-03-30,61,61,58,3,3547,3552,3397,155,3,1,1,3,944,944,943,943
Inyo,15,2022-03-30,6,6,6,0,190,190,183,7,0,0,0,0,56,56,56,56
Kern,15,2022-03-30,147,147,142,5,18074,18107,17459,648,20,2,2,8,2336,2336,2334,2334
Kings,15,2022-03-30,51,51,49,2,4391,4397,4208,189,4,0,0,0,446,446,446,446
Lake,15,2022-03-30,12,12,11,1,1020,1020,970,50,0,0,0,0,138,138,138,138
Lassen,15,2022-03-30,4,4,4,0,1284,1286,1242,44,0,0,0,0,62,62,62,62
Los Angeles,15,2022-03-30,4648,4656,4598,58,738748,740046,730842,9204,261,50,50,47,31738,31738,31688,31688
Madera,15,2022-03-30,27,27,26,1,3421,3426,3259,167,2,0,0,1,368,368,368,368
Marin,15,2022-03-30,154,154,147,7,6217,6229,5935,294,2,0,0,0,295,295,295,295
Mariposa,15,2022-03-30,3,3,3,0,187,187,177,10,0,1,1,0,28,28,27,27
Mendocino,15,2022-03-30,24,24,22,2,1316,1317,1233,84,0,1,1,0,124,124,123,123
Merced,15,2022-03-30,62,62,60,2,3363,3368,3243,125,6,1,1,3,816,816,815,815
Modoc,15,2022-03-30,4,4,4,0,40,40,39,1,0,0,0,0,7,7,7,7
Mono,15,2022-03-30,1,1,1,0,148,148,137,11,0,0,0,0,6,6,6,6
Monterey,15,2022-03-30,128,128,118,10,8206,8221,7605,616,16,3,3,0,727,727,724,724
Napa,15,2022-03-30,62,62,60,2,3351,3357,3247,110,3,2,2,1,142,142,140,140
Nevada,15,2022-03-30,25,25,24,1,1409,1411,1344,67,1,2,2,0,128,128,126,126
Orange,15,2022-03-30,795,795,772,23,90660,90819,88218,2601,73,11,11,16,7053,7053,7042,7042
Placer,15,2022-03-30,113,113,107,6,6328,6340,6009,331,32,3,3,5,624,624,621,621
Plumas,15,2022-03-30,5,5,5,0,229,229,218,11,0,0,0,0,13,13,13,13
Riverside,15,2022-03-30,564,564,542,22,42029,42103,40488,1615,45,9,9,10,6359,6359,6350,6350
Sacramento,15,2022-03-30,423,423,406,17,32572,32628,31295,1333,63,5,5,14,3032,3032,3027,3027
San Benito,15,2022-03-30,9,9,9,0,1331,1332,1287,45,0,0,0,0,94,94,94,94
San Bernardino,15,2022-03-30,552,552,535,17,42335,42409,41096,1313,39,16,16,19,7819,7819,7803,7803
San Diego,15,2022-03-30,1388,1388,1370,18,68836,68957,68049,908,101,8,8,32,5302,5302,5294,5294
San Francisco,15,2022-03-30,859,859,790,69,30897,30950,28432,2518,23,4,4,4,860,860,856,856
San Joaquin,15,2022-03-30,203,203,194,9,16647,16677,15929,748,17,2,2,6,2243,2243,2241,2241
San Luis Obispo,15,2022-03-30,104,104,100,4,5964,5975,5765,210,6,0,0,0,477,477,477,477
San Mateo,15,2022-03-30,555,555,539,16,30947,31001,30109,892,17,2,2,8,691,691,689,689
Santa Barbara,15,2022-03-30,154,154,148,6,13211,13235,12726,509,12,1,1,4,688,688,687,687
Santa Clara,15,2022-03-30,1299,1299,1281,18,94719,94885,93563,1322,88,10,10,19,2289,2289,2279,2279
Santa Cruz,15,2022-03-30,143,143,138,5,20519,20555,19860,695,5,0,0,2,259,259,259,259
Shasta,15,2022-03-30,29,29,28,1,3582,3588,3442,146,4,2,2,5,562,562,560,560
Siskiyou,15,2022-03-30,8,8,8,0,295,295,285,10,0,0,0,0,83,83,83,83
Solano,15,2022-03-30,168,168,162,6,10931,10950,10530,420,16,1,1,6,447,447,446,446
Sonoma,15,2022-03-30,267,267,257,10,10029,10046,9675,371,12,1,1,0,490,490,489,489
Stanislaus,15,2022-03-30,97,97,91,6,8044,8058,7589,469,29,2,2,3,1687,1687,1685,1685
Sutter,15,2022-03-30,29,29,28,1,1355,1355,1302,53,0,0,0,0,224,224,224,224
Tehama,15,2022-03-30,9,9,8,1,762,762,719,43,0,2,2,0,203,203,201,201
Trinity,15,2022-03-30,0,0,0,0,71,71,67,4,0,0,0,0,20,20,20,20
Tulare,15,2022-03-30,65,65,61,4,7965,7979,7506,473,16,5,5,0,1485,1485,1480,1480
Tuolumne,15,2022-03-30,9,9,9,0,1033,1033,983,50,0,0,0,0,185,185,185,185
Ventura,15,2022-03-30,309,309,301,8,21252,21291,20729,562,19,5,5,3,1486,1486,1481,1481
Yolo,15,2022-03-30,99,99,96,3,23922,23964,23150,814,2,2,2,1,321,321,319,319
Yuba,15,2022-03-30,25,25,24,1,1093,1093,1053,40,5,1,1,2,118,118,117,117
Alameda,16,2022-04-06,1225,1225,1196,29,50837,50928,49690,1238,47,3,3,7,1860,1860,1857,1857
Amador,16,2022-04-06,4,4,4,0,1052,1052,1011,41,1,0,0,0,86,86,86,86
Butte,16,2022-04-06,35,35,34,1,2369,2374,2327,47,9,2,2,0,428,428,426,426
Calaveras,16,2022-04-06,11,11,11,0,635,635,614,21,0,0,0,0,119,119,119,119
Colusa,16,2022-04-06,5,5,5,0,193,193,187,6,0,0,0,0,21,21,21,21
Contra Costa,16,2022-04-06,569,569,546,23,21048,21086,20232,854,15,2,2,5,1292,1292,1290,1290
Del Norte,16,2022-04-06,8,8,8,0,988,988,957,31,0,0,0,1,49,49,49,49
El Dorado,16,2022-04-06,53,53,51,2,2595,2600,2512,88,0,1,1,1,213,213,212,212
Fresno,16,2022-04-06,186,186,179,7,16568,16598,15972,626,52,1,1,12,2756,2756,2755,2755
Glenn,16,2022-04-06,3,3,3,0,268,268,259,9,0,0,0,0,42,42,42,42
Humboldt,16,2022-04-06,32,32,31,1,2291,2296,2225,71,7,0,0,2,144,144,144,144
Imperial,16,2022-04-06,21,21,20,1,3390,3395,3278,117,2,0,0,2,944,944,944,944
Inyo,16,2022-04-06,7,7,7,0,179,179,174,5,0,0,0,0,56,56,56,56
Kern,16,2022-04-06,137,137,133,4,16633,16662,16195,467,13,2,2,5,2338,2338,2336,2336
Kings,16,2022-04-06,36,36,35,1,4022,4028,3893,135,4,0,0,1,446,446,446,446
Lake,16,2022-04-06,16,16,15,1,865,865,831,34,0,0,0,0,138,138,138,138
Lassen,16,2022-04-06,4,4,4,0,1260,1262,1229,33,0,0,0,0,62,62,62,62
Los Angeles,16,2022-04-06,5936,5946,5888,58,757316,758685,751304,7381,235,50,50,38,31788,31788,31738,31738
Madera,16,2022-04-06,26,26,25,1,3046,3051,2934,117,3,0,0,1,368,368,368,368
Marin,16,2022-04-06,194,194,187,7,5876,5888,5667,221,4,0,0,0,295,295,295,295
Mariposa,16,2022-04-06,7,7,7,0,238,238,228,10,0,0,0,0,28,28,28,28
Mendocino,16,2022-04-06,31,31,29,2,1161,1162,1104,58,0,0,0,0,124,124,124,124
Merced,16,2022-04-06,57,57,55,2,3238,3243,3148,95,4,2,2,0,818,818,816,816
Modoc,16,2022-04-06,1,1,1,0,49,49,48,1,0,0,0,0,7,7,7,7
Mono,16,2022-04-06,2,2,2,0,117,117,110,7,0,0,0,0,6,6,6,6
Monterey,16,2022-04-06,121,121,114,7,7302,7315,6884,431,11,2,2,0,729,729,727,727
Napa,16,2022-04-06,88,88,86,2,3018,3023,2945,78,2,0,0,1,142,142,142,142
Nevada,16,2022-04-06,32,32,31,1,1468,1470,1415,55,2,0,0,0,128,128,128,128
Orange,16,2022-04-06,1056,1056,1032,24,66369,66489,64970,1519,62,15,15,16,7068,7068,7053,7053
Placer,16,2022-04-06,127,127,122,5,6375,6388,6123,265,18,2,2,4,626,626,624,624
Plumas,16,2022-04-06,2,2,2,0,256,256,246,10,0,0,0,0,13,13,13,13
Riverside,16,2022-04-06,700,700,679,21,38474,38544,37388,1156,38,5,5,8,6364,6364,6359,6359
Sacramento,16,2022-04-06,466,466,451,15,31655,31713,30690,1023,58,10,10,9,3042,3042,3032,3032
San Benito,16,2022-04-06,21,21,20,1,1166,1166,1135,31,0,0,0,0,94,94,94,94
San Bernardino,16,2022-04-06,705,705,688,17,41168,41243,40242,1001,40,11,11,8,7830,7830,7819,7819
San Diego,16,2022-04-06,1697,1700,1683,17,69402,69527,68818,709,94,8,8,28,5310,5310,5302,5302
San Francisco,16,2022-04-06,1109,1109,1038,71,28923,28974,27117,1857,20,7,7,4,867,867,860,860
San Joaquin,16,2022-04-06,228,228,220,8,15233,15260,14722,538,8,2,2,6,2245,2245,2243,2243
San Luis Obispo,16,2022-04-06,98,98,95,3,5116,5126,4985,141,2,2,2,1,479,479,477,477
San Mateo,16,2022-04-06,759,759,742,17,30386,30442,29760,682,12,3,3,2,694,694,691,691
Santa Barbara,16,2022-04-06,217,217,210,7,14951,14978,14518,460,7,2,2,1,690,690,688,688
Santa Clara,16,2022-04-06,1552,1553,1536,17,81200,81346,80458,888,84,0,0,12,2289,2289,2289,2289
Santa Cruz,16,2022-04-06,271,271,264,7,12678,12700,12352,348,9,1,1,1,260,260,259,259
Shasta,16,2022-04-06,24,24,23,1,3348,3353,3246,107,1,0,0,4,562,562,562,562
Siskiyou,16,2022-04-06,3,3,3,0,310,310,302,8,0,0,0,0,83,83,83,83
Solano,16,2022-04-06,218,218,212,6,9684,9702,9410,292,17,0,0,4,447,447,447,447
Sonoma,16,2022-04-06,368,368,357,11,10491,10511,10203,308,4,0,0,0,490,490,490,490
Stanislaus,16,2022-04-06,117,117,112,5,7743,7758,7402,356,18,2,2,4,1689,1689,1687,1687
Sutter,16,2022-04-06,23,23,22,1,1317,1318,1278,40,0,1,1,0,225,225,224,224
Tehama,16,2022-04-06,8,8,8,0,789,789,754,35,0,0,0,0,203,203,203,203
Trinity,16,2022-04-06,1,1,1,0,83,83,79,4,0,0,0,0,20,20,20,20
Tulare,16,2022-04-06,52,52,50,2,7831,7846,7481,365,12,4,4,0,1489,1489,1485,1485
Tuolumne,16,2022-04-06,15,15,14,1,1065,1065,1025,40,0,1,1,0,186,186,185,185
Ventura,16,2022-04-06,302,302,296,6,18708,18742,18352,390,15,4,4,4,1490,1490,1486,1486
Yolo,16,2022-04-06,102,102,99,3,21637,21677,21077,600,0,0,0,0,321,321,321,321
Yuba,16,2022-04-06,11,11,11,0,1042,1042,1012,30,3,0,0,1,118,118,118,118
Alameda,17,2022-04-13,1582,1584,1554,30,52793,52892,51894,998,53,4,4,2,1864,1864,1860,1860
Amador,17,2022-04-13,8,8,8,0,1107,1107,1073,34,1,0,0,0,86,86,86,86
Butte,17,2022-04-13,47,47,46,1,2277,2282,2247,35,7,1,1,1,429,429,428,428
Calaveras,17,2022-04-13,17,17,17,0,633,633,616,17,0,0,0,0,119,119,119,119
Colusa,17,2022-04-13,5,5,5,0,199,199,194,5,0,0,0,0,21,21,21,21
Contra Costa,17,2022-04-13,840,840,814,26,23477,23522,22787,735,21,0,0,3,1292,1292,1292,1292
Del Norte,17,2022-04-13,11,11,11,0,1014,1014,989,25,0,0,0,0,49,49,49,49
El Dorado,17,2022-04-13,56,56,55,1,2474,2479,2413,66,0,0,0,0,213,213,213,213
Fresno,17,2022-04-13,191,191,185,6,14620,14647,14208,439,48,4,4,6,2760,2760,2756,2756
Glenn,17,2022-04-13,2,2,2,0,277,277,270,7,0,0,0,0,42,42,42,42
Humboldt,17,2022-04-13,55,55,54,1,2197,2202,2148,54,6,1,1,2,145,145,144,144
Imperial,17,2022-04-13,30,30,29,1,3524,3529,3434,95,4,1,1,1,945,945,944,944
Inyo,17,2022-04-13,3,3,3,0,171,171,167,4,0,0,0,0,56,56,56,56
Kern,17,2022-04-13,138,138,135,3,14695,14722,14394,328,15,2,2,7,2340,2340,2338,2338
Kings,17,2022-04-13,34,34,33,1,3780,3785,3684,101,2,0,0,0,446,446,446,446
Lake,17,2022-04-13,19,19,18,1,858,858,832,26,0,0,0,1,138,138,138,138
Lassen,17,2022-04-13,1,1,1,0,1300,1302,1275,27,1,0,0,0,62,62,62,62
Los Angeles,17,2022-04-13,7111,7124,7070,54,534803,535809,531634,4175,207,38,38,32,31826,31826,31788,31788
Madera,17,2022-04-13,26,26,25,1,2839,2844,2757,87,4,0,0,1,368,368,368,368
Marin,17,2022-04-13,233,233,226,7,5978,5990,5816,174,4,0,0,1,295,295,295,295
Mariposa,17,2022-04-13,7,7,7,0,242,242,234,8,0,0,0,0,28,28,28,28
Mendocino,17,2022-04-13,32,32,31,1,1139,1139,1094,45,0,0,0,1,124,124,124,124
Merced,17,2022-04-13,69,69,67,2,3168,3173,3100,73,7,2,2,1,820,820,818,818
Modoc,17,2022-04-13,0,0,0,0,38,38,37,1,0,0,0,0,7,7,7,7
Mono,17,2022-04-13,9,9,9,0,193,193,184,9,0,0,0,0,6,6,6,6
Monterey,17,2022-04-13,114,114,109,5,6698,6711,6398,313,9,1,1,0,730,730,729,729
Napa,17,2022-04-13,134,134,131,3,2752,2757,2701,56,4,0,0,0,142,142,142,142
Nevada,17,2022-04-13,40,40,39,1,1294,1295,1256,39,2,0,0,1,128,128,128,128
Orange,17,2022-04-13,1271,1271,1249,22,73464,73603,72327,1276,52,6,6,11,7074,7074,7068,7068
Placer,17,2022-04-13,135,135,131,4,5160,5170,5000,170,20,1,1,4,627,627,626,626
Plumas,17,2022-04-13,8,8,8,0,227,227,220,7,0,0,0,0,13,13,13,13
Riverside,17,2022-04-13,786,786,768,18,37639,37709,36823,886,41,5,5,9,6369,6369,6364,6364
Sacramento,17,2022-04-13,550,550,536,14,28461,28515,27790,725,51,8,8,4,3050,3050,3042,3042
San Benito,17,2022-04-13,12,12,12,0,1191,1192,1167,25,0,0,0,0,94,94,94,94
San Bernardino,17,2022-04-13,968,968,950,18,41756,41835,41037,798,33,6,6,5,7836,7836,7830,7830
San Diego,17,2022-04-13,1867,1871,1856,15,73029,73167,72579,588,88,4,4,21,5314,5314,5310,5310
San Francisco,17,2022-04-13,1219,1219,1157,62,29976,30032,28505,1527,22,2,2,5,869,869,867,867
San Joaquin,17,2022-04-13,221,221,215,6,15193,15221,14798,423,7,0,0,5,2245,2245,2245,2245
San Luis Obispo,17,2022-04-13,136,136,133,3,4916,4925,4819,106,2,0,0,0,479,479,479,479
San Mateo,17,2022-04-13,937,937,920,17,29282,29337,28821,516,9,3,3,3,697,697,694,694
Santa Barbara,17,2022-04-13,317,317,309,8,14836,14864,14505,359,4,1,1,0,691,691,690,690
Santa Clara,17,2022-04-13,1764,1767,1752,15,79047,79196,78521,675,83,7,7,14,2296,2296,2289,2289
Santa Cruz,17,2022-04-13,387,387,379,8,13565,13590,13313,277,3,0,0,1,260,260,260,260
Shasta,17,2022-04-13,20,20,19,1,2920,2925,2851,74,2,1,1,2,563,563,562,562
Siskiyou,17,2022-04-13,1,1,1,0,326,326,319,7,0,0,0,1,83,83,83,83
Solano,17,2022-04-13,218,218,213,5,9488,9506,9281,225,13,0,0,1,447,447,447,447
Sonoma,17,2022-04-13,425,425,415,10,11263,11284,11025,259,13,1,1,1,491,491,490,490
Stanislaus,17,2022-04-13,143,143,138,5,7801,7816,7534,282,14,1,1,4,1690,1690,1689,1689
Sutter,17,2022-04-13,19,19,19,0,1173,1173,1145,28,0,0,0,0,225,225,225,225
Tehama,17,2022-04-13,8,8,8,0,735,735,709,26,0,0,0,0,203,203,203,203
Trinity,17,2022-04-13,0,0,0,0,82,82,79,3,0,0,0,0,20,20,20,20
Tulare,17,2022-04-13,61,61,59,2,7134,7148,6884,264,12,2,2,0,1491,1491,1489,1489
Tuolumne,17,2022-04-13,19,19,18,1,1027,1028,997,31,0,0,0,0,186,186,186,186
Ventura,17,2022-04-13,334,334,329,5,16954,16986,16709,277,13,1,1,1,1491,1491,1490,1490
Yolo,17,2022-04-13,179,179,175,4,19066,19102,18694,408,1,0,0,0,321,321,321,321
Yuba,17,2022-04-13,18,18,18,0,1007,1007,984,23,1,0,0,0,118,118,118,118
Alameda,18,2022-04-20,1988,1992,1963,29,54039,54146,53343,803,42,4,4,5,1868,1868,1864,1864
Amador,18,2022-04-20,15,15,15,0,1258,1260,1230,30,0,0,0,1,86,86,86,86
Butte,18,2022-04-20,34,34,34,0,2354,2359,2331,28,7,1,1,1,430,430,429,429
Calaveras,18,2022-04-20,16,16,16,0,609,609,596,13,0,1,1,0,120,120,119,119
Colusa,18,2022-04-20,2,2,2,0,160,160,157,3,0,0,0,0,21,21,21,21
Contra Costa,18,2022-04-20,1205,1205,1175,30,25007,25056,24438,618,27,2,2,4,1294,1294,1292,1292
Del Norte,18,2022-04-20,17,17,17,0,1028,1028,1008,20,0,0,0,0,49,49,49,49
El Dorado,18,2022-04-20,76,76,74,2,2562,2567,2514,53,1,0,0,0,213,213,213,213
Fresno,18,2022-04-20,288,288,281,7,15268,15298,14943,355,39,4,4,4,2764,2764,2760,2760
Glenn,18,2022-04-20,4,4,4,0,270,270,265,5,0,0,0,0,42,42,42,42
Humboldt,18,2022-04-20,149,149,146,3,2319,2324,2280,44,4,1,1,2,146,146,145,145
Imperial,18,2022-04-20,59,59,58,1,3303,3309,3239,70,3,0,0,1,945,945,945,945
Inyo,18,2022-04-20,5,5,5,0,177,177,174,3,0,0,0,0,56,56,56,56
Kern,18,2022-04-20,185,185,182,3,15822,15854,15582,272,10,1,1,6,2341,2341,2340,2340
Kings,18,2022-04-20,51,51,50,1,4167,4175,4089,86,1,1,1,0,447,447,446,446
Lake,18,2022-04-20,19,19,19,0,766,766,748,18,3,1,1,0,139,139,138,138
Lassen,18,2022-04-20,1,1,1,0,1409,1411,1388,23,0,0,0,0,62,62,62,62
Los Angeles,18,2022-04-20,9460,9479,9423,56,656298,657611,653833,3778,202,36,36,22,31862,31862,31826,31826
Madera,18,2022-04-20,26,26,25,1,2739,2744,2679,65,4,0,0,1,368,368,368,368
Marin,18,2022-04-20,325,325,318,7,5849,5861,5726,135,8,0,0,0,295,295,295,295
Mariposa,18,2022-04-20,19,19,19,0,251,251,245,6,0,0,0,0,28,28,28,28
Mendocino,18,2022-04-20,66,66,64,2,1310,1312,1271,41,2,1,1,0,125,125,124,124
Merced,18,2022-04-20,73,73,72,1,2986,2991,2937,54,4,2,2,0,822,822,820,820
Modoc,18,2022-04-20,2,2,2,0,37,37,36,1,0,0,0,0,7,7,7,7
Mono,18,2022-04-20,9,9,9,0,105,105,101,4,0,0,0,0,6,6,6,6
Monterey,18,2022-04-20,206,206,199,7,6813,6827,6579,248,3,1,1,0,731,731,730,730
Napa,18,2022-04-20,182,182,179,3,3103,3108,3059,49,0,0,0,0,142,142,142,142
Nevada,18,2022-04-20,50,50,49,1,1354,1356,1325,31,1,0,0,0,128,128,128,128
Orange,18,2022-04-20,1550,1553,1532,21,80075,80234,79132,1102,48,7,7,15,7081,7081,7074,7074
Placer,18,2022-04-20,181,181,176,5,5324,5334,5199,135,20,0,0,3,627,627,627,627
Plumas,18,2022-04-20,3,3,3,0,230,230,225,5,0,0,0,0,13,13,13,13
Riverside,18,2022-04-20,1050,1050,1031,19,37949,38024,37326,698,46,6,6,6,6375,6375,6369,6369
Sacramento,18,2022-04-20,826,826,810,16,29787,29846,29256,590,49,8,8,8,3058,3058,3050,3050
San Benito,18,2022-04-20,30,30,30,0,1155,1157,1138,19,0,0,0,0,94,94,94,94
San Bernardino,18,2022-04-20,1164,1164,1147,17,40186,40265,39668,597,27,7,7,10,7843,7843,7836,7836
San Diego,18,2022-04-20,2331,2336,2322,14,67594,67729,67307,422,80,8,8,10,5322,5322,5314,5314
San Francisco,18,2022-04-20,1644,1647,1582,65,31096,31159,29910,1249,22,0,0,5,869,869,869,869
San Joaquin,18,2022-04-20,291,291,285,6,15132,15162,14833,329,12,1,1,3,2246,2246,2245,2245
San Luis Obispo,18,2022-04-20,188,188,185,3,4849,4859,4777,82,4,2,2,0,481,481,479,479
San Mateo,18,2022-04-20,1232,1232,1215,17,31525,31588,31154,434,11,0,0,1,697,697,697,697
Santa Barbara,18,2022-04-20,329,329,323,6,14792,14821,14540,281,9,0,0,0,691,691,691,691
Santa Clara,18,2022-04-20,2458,2464,2448,16,67223,67357,66910,447,72,2,2,14,2298,2298,2296,2296
Santa Cruz,18,2022-04-20,422,422,415,7,13270,13297,13088,209,2,1,1,1,261,261,260,260
Shasta,18,2022-04-20,46,46,45,1,2965,2970,2912,58,4,1,1,2,564,564,563,563
Siskiyou,18,2022-04-20,10,10,10,0,343,343,338,5,0,0,0,0,83,83,83,83
Solano,18,2022-04-20,334,334,328,6,9558,9578,9401,177,6,1,1,2,448,448,447,447
Sonoma,18,2022-04-20,577,577,567,10,11317,11339,11136,203,15,1,1,3,492,492,491,491
Stanislaus,18,2022-04-20,164,164,159,5,7536,7551,7336,215,24,0,0,3,1690,1690,1690,1690
Sutter,18,2022-04-20,20,20,20,0,1224,1225,1202,23,0,0,0,0,225,225,225,225
Tehama,18,2022-04-20,9,9,9,0,642,642,624,18,2,0,0,0,203,203,203,203
Trinity,18,2022-04-20,2,2,2,0,78,78,76,2,0,0,0,0,20,20,20,20
Tulare,18,2022-04-20,83,83,81,2,6764,6778,6582,196,11,0,0,0,1491,1491,1491,1491
Tuolumne,18,2022-04-20,29,29,28,1,1089,1089,1064,25,0,1,1,0,187,187,186,186
Ventura,18,2022-04-20,444,444,438,6,17145,17179,16962,217,11,4,4,0,1495,1495,1491,1491
Yolo,18,2022-04-20,243,243,239,4,18229,18266,17961,305,1,1,1,0,322,322,321,321
Yuba,18,2022-04-20,36,36,35,1,1063,1063,1044,19,0,0,0,0,118,118,118,118
Alameda,19,2022-04-27,2811,2817,2785,32,66190,66329,65565,764,39,6,6,5,1874,1874,1868,1868
Amador,19,2022-04-27,27,27,26,1,1312,1314,1289,25,0,0,0,0,86,86,86,86
Butte,19,2022-04-27,87,87,86,1,2549,2554,2530,24,3,1,1,1,431,431,430,430
Calaveras,19,2022-04-27,34,34,33,1,708,708,697,11,1,0,0,0,120,120,120,120
Colusa,19,2022-04-27,2,2,2,0,225,225,222,3,0,0,0,0,21,21,21,21
Contra Costa,19,2022-04-27,1556,1559,1529,30,28078,28136,27593,543,28,3,3,4,1297,1297,1294,1294
Del Norte,19,2022-04-27,32,32,32,0,1143,1144,1127,17,0,0,0,1,49,49,49,49
El Dorado,19,2022-04-27,114,114,112,2,2669,2674,2630,44,0,0,0,1,213,213,213,213
Fresno,19,2022-04-27,405,405,398,7,16449,16484,16184,300,34,2,2,4,2766,2766,2764,2764
Glenn,19,2022-04-27,3,3,3,0,276,276,272,4,0,0,0,0,42,42,42,42
Humboldt,19,2022-04-27,175,175,172,3,2848,2853,2810,43,3,0,0,2,146,146,146,146
Imperial,19,2022-04-27,85,85,84,1,3595,3603,3544,59,3,0,0,1,945,945,945,945
Inyo,19,2022-04-27,4,4,4,0,194,194,191,3,0,0,0,0,56,56,56,56
Kern,19,2022-04-27,259,259,256,3,17938,17975,17732,243,11,2,2,4,2343,2343,2341,2341
Kings,19,2022-04-27,50,50,49,1,4599,4609,4534,75,3,0,0,1,447,447,447,447
Lake,19,2022-04-27,23,23,23,0,979,979,961,18,0,0,0,0,139,139,139,139
Lassen,19,2022-04-27,7,7,7,0,1565,1567,1547,20,0,0,0,0,62,62,62,62
Los Angeles,19,2022-04-27,12548,12574,12516,58,914249,916157,911934,4223,219,26,26,30,31888,31888,31862,31862
Madera,19,2022-04-27,54,54,53,1,3013,3018,2962,56,2,0,0,0,368,368,368,368
Marin,19,2022-04-27,332,332,326,6,6437,6450,6334,116,4,0,0,0,295,295,295,295
Mariposa,19,2022-04-27,7,7,7,0,225,225,221,4,0,0,0,0,28,28,28,28
Mendocino,19,2022-04-27,44,44,43,1,1230,1232,1202,30,0,1,1,0,126,126,125,125
Merced,19,2022-04-27,105,105,104,1,3161,3166,3122,44,4,0,0,0,822,822,822,822
Modoc,19,2022-04-27,0,0,0,0,39,39,38,1,0,0,0,0,7,7,7,7
Mono,19,2022-04-27,3,3,3,0,86,86,83,3,0,0,0,0,6,6,6,6
Monterey,19,2022-04-27,321,321,312,9,8309,8326,8087,239,8,1,1,0,732,732,731,731
Napa,19,2022-04-27,212,212,209,3,3444,3449,3406,43,5,0,0,0,142,142,142,142
Nevada,19,2022-04-27,51,51,50,1,1476,1479,1452,27,2,0,0,0,128,128,128,128
Orange,19,2022-04-27,2217,2222,2198,24,88124,88309,87359,950,58,6,6,12,7087,7087,7081,7081
Placer,19,2022-04-27,239,239,234,5,6051,6064,5943,121,22,0,0,4,627,627,627,627
Plumas,19,2022-04-27,4,4,4,0,253,253,248,5,1,0,0,0,13,13,13,13
Riverside,19,2022-04-27,1481,1484,1463,21,41351,41437,40842,595,38,3,3,7,6378,6378,6375,6375
Sacramento,19,2022-04-27,1087,1088,1071,17,31707,31773,31280,493,44,5,5,9,3063,3063,3058,3058
San Benito,19,2022-04-27,34,34,34,0,1105,1106,1092,14,0,0,0,0,94,94,94,94
San Bernardino,19,2022-04-27,1305,1305,1290,15,43137,43227,42724,503,30,11,11,6,7854,7854,7843,7843
San Diego,19,2022-04-27,3426,3433,3416,17,74078,74233,73870,363,92,2,2,11,5324,5324,5322,5322
San Francisco,19,2022-04-27,2102,2106,2040,66,33571,33640,32584,1056,29,1,1,4,870,870,869,869
San Joaquin,19,2022-04-27,428,428,421,7,14785,14818,14566,252,12,1,1,3,2247,2247,2246,2246
San Luis Obispo,19,2022-04-27,222,222,219,3,5113,5125,5057,68,4,0,0,0,481,481,481,481
San Mateo,19,2022-04-27,1589,1592,1575,17,34649,34721,34349,372,12,2,2,4,699,699,697,697
Santa Barbara,19,2022-04-27,369,369,364,5,15478,15509,15280,229,10,2,2,3,693,693,691,691
Santa Clara,19,2022-04-27,3471,3478,3460,18,86001,86181,85739,442,68,4,4,11,2302,2302,2298,2298
Santa Cruz,19,2022-04-27,555,555,548,7,21149,21193,20923,270,7,0,0,0,261,261,261,261
Shasta,19,2022-04-27,55,55,54,1,3400,3406,3354,52,2,0,0,1,564,564,564,564
Siskiyou,19,2022-04-27,7,7,7,0,309,309,305,4,0,0,0,0,83,83,83,83
Solano,19,2022-04-27,543,543,535,8,11103,11127,10966,161,14,0,0,3,448,448,448,448
Sonoma,19,2022-04-27,699,699,689,10,12237,12263,12091,172,13,0,0,1,492,492,492,492
Stanislaus,19,2022-04-27,264,264,258,6,8088,8104,7924,180,20,3,3,1,1693,1693,1690,1690
Sutter,19,2022-04-27,50,50,49,1,1351,1353,1333,20,0,2,2,0,227,227,225,225
Tehama,19,2022-04-27,21,21,21,0,711,711,696,15,1,0,0,0,203,203,203,203
Trinity,19,2022-04-27,1,1,1,0,64,64,63,1,0,0,0,0,20,20,20,20
Tulare,19,2022-04-27,113,113,110,3,7066,7081,6921,160,9,2,2,0,1493,1493,1491,1491
Tuolumne,19,2022-04-27,62,62,61,1,1151,1151,1130,21,2,0,0,0,187,187,187,187
Ventura,19,2022-04-27,639,639,633,6,19658,19700,19505,195,15,2,2,2,1497,1497,1495,1495
Yolo,19,2022-04-27,291,291,287,4,19401,19443,19189,254,1,0,0,1,322,322,322,322
Yuba,19,2022-04-27,27,27,27,0,1073,1073,1058,15,1,0,0,1,118,118,118,118
Alameda,20,2022-05-04,3578,3586,3554,32,67394,67542,66931,611,45,1,1,7,1875,1875,1874,1874
Amador,20,2022-05-04,19,19,19,0,1405,1408,1387,21,1,0,0,0,86,86,86,86
Butte,20,2022-05-04,97,97,96,1,2338,2343,2326,17,3,2,2,0,433,433,431,431
Calaveras,20,2022-05-04,24,24,24,0,673,673,664,9,1,0,0,0,120,120,120,120
Colusa,20,2022-05-04,3,3,3,0,194,194,192,2,0,0,0,0,21,21,21,21
Contra Costa,20,2022-05-04,2119,2125,2093,32,29171,29235,28793,442,33,3,3,7,1300,1300,1297,1297
Del Norte,20,2022-05-04,38,38,38,0,1237,1239,1224,15,0,0,0,0,49,49,49,49
El Dorado,20,2022-05-04,140,140,138,2,2767,2772,2737,35,1,1,1,0,214,214,213,213
Fresno,20,2022-05-04,547,547,539,8,17457,17495,17245,250,31,4,4,1,2770,2770,2766,2766
Glenn,20,2022-05-04,7,7,7,0,242,242,239,3,0,0,0,0,42,42,42,42
Humboldt,20,2022-05-04,282,282,279,3,3250,3255,3217,38,6,0,0,2,146,146,146,146
Imperial,20,2022-05-04,117,117,115,2,3648,3655,3608,47,1,0,0,1,945,945,945,945
Inyo,20,2022-05-04,5,5,5,0,194,194,192,2,0,0,0,0,56,56,56,56
Kern,20,2022-05-04,363,363,359,4,18118,18157,17965,192,14,1,1,3,2344,2344,2343,2343
Kings,20,2022-05-04,72,72,71,1,4921,4932,4869,63,3,0,0,0,447,447,447,447
Lake,20,2022-05-04,27,27,27,0,1019,1020,1005,15,1,0,0,0,139,139,139,139
Lassen,20,2022-05-04,3,3,3,0,1657,1660,1643,17,0,0,0,0,62,62,62,62
Los Angeles,20,2022-05-04,16201,16237,16179,58,911946,913941,910648,3293,207,21,21,37,31909,31909,31888,31888
Madera,20,2022-05-04,102,102,101,1,3487,3494,3443,51,4,0,0,0,368,368,368,368
Marin,20,2022-05-04,545,545,537,8,6937,6952,6855,97,10,0,0,0,295,295,295,295
Mariposa,20,2022-05-04,20,20,20,0,223,223,220,3,0,0,0,0,28,28,28,28
Mendocino,20,2022-05-04,79,79,78,1,1263,1264,1240,24,1,1,1,1,127,127,126,126
Merced,20,2022-05-04,148,148,146,2,3240,3246,3210,36,3,4,4,0,826,826,822,822
Modoc,20,2022-05-04,2,2,2,0,36,37,36,1,0,0,0,0,7,7,7,7
Mono,20,2022-05-04,10,10,10,0,115,115,112,3,0,0,0,0,6,6,6,6
Monterey,20,2022-05-04,392,392,383,9,8854,8873,8674,199,9,1,1,0,733,733,732,732
Napa,20,2022-05-04,231,231,229,2,3404,3410,3377,33,0,0,0,0,142,142,142,142
Nevada,20,2022-05-04,94,94,93,1,1576,1579,1557,22,1,0,0,0,128,128,128,128
Orange,20,2022-05-04,2877,2884,2860,24,89762,89957,89203,754,72,7,7,18,7094,7094,7087,7087
Placer,20,2022-05-04,387,387,381,6,6569,6582,6479,103,15,0,0,5,627,627,627,627
Plumas,20,2022-05-04,11,11,11,0,251,251,247,4,0,0,0,0,13,13,13,13
Riverside,20,2022-05-04,2225,2231,2206,25,43764,43860,43368,492,32,3,3,6,6381,6381,6378,6378
Sacramento,20,2022-05-04,1600,1603,1584,19,34441,34517,34098,419,54,5,5,11,3068,3068,3063,3063
San Benito,20,2022-05-04,64,64,63,1,1405,1409,1395,14,0,0,0,0,94,94,94,94
San Bernardino,20,2022-05-04,1608,1611,1596,15,44114,44211,43810,401,41,6,6,10,7860,7860,7854,7854
San Diego,20,2022-05-04,4498,4508,4491,17,79438,79612,79311,301,91,4,4,13,5328,5328,5324,5324
San Francisco,20,2022-05-04,2561,2567,2504,63,36386,36467,35567,900,37,4,4,12,874,874,870,870
San Joaquin,20,2022-05-04,599,599,591,8,15180,15213,15010,203,11,0,0,2,2247,2247,2247,2247
San Luis Obispo,20,2022-05-04,271,271,268,3,5212,5225,5171,54,1,2,2,0,483,483,481,481
San Mateo,20,2022-05-04,1923,1927,1911,16,36270,36348,36043,305,20,2,2,4,701,701,699,699
Santa Barbara,20,2022-05-04,507,507,501,6,15228,15261,15084,177,8,0,0,2,693,693,693,693
Santa Clara,20,2022-05-04,4852,4862,4842,20,99950,100169,99765,404,63,4,4,16,2306,2306,2302,2302
Santa Cruz,20,2022-05-04,654,654,648,6,22597,22645,22419,226,3,1,1,0,262,262,261,261
Shasta,20,2022-05-04,81,81,80,1,3461,3468,3426,42,6,0,0,1,564,564,564,564
Siskiyou,20,2022-05-04,11,11,11,0,319,319,316,3,0,0,0,1,83,83,83,83
Solano,20,2022-05-04,733,733,725,8,12105,12133,11995,138,18,0,0,0,448,448,448,448
Sonoma,20,2022-05-04,1033,1033,1022,11,13146,13174,13030,144,18,1,1,3,493,493,492,492
Stanislaus,20,2022-05-04,316,316,310,6,8309,8326,8181,145,22,0,0,2,1693,1693,1693,1693
Sutter,20,2022-05-04,46,46,45,1,1462,1464,1447,17,0,0,0,0,227,227,227,227
Tehama,20,2022-05-04,17,17,17,0,679,679,668,11,1,0,0,0,203,203,203,203
Trinity,20,2022-05-04,2,2,2,0,81,81,80,1,0,0,0,0,20,20,20,20
Tulare,20,2022-05-04,162,162,159,3,7419,7435,7303,132,10,3,3,0,1496,1496,1493,1493
Tuolumne,20,2022-05-04,83,83,82,1,1310,1313,1294,19,3,0,0,0,187,187,187,187
Ventura,20,2022-05-04,856,856,849,7,20177,20221,20065,156,12,1,1,3,1498,1498,1497,1497
Yolo,20,2022-05-04,379,379,375,4,18629,18670,18479,191,0,1,1,0,323,323,322,322
Yuba,20,2022-05-04,51,51,50,1,1130,1131,1119,12,3,0,0,0,118,118,118,118
Alameda,21,2022-05-11,4454,4464,4432,32,73002,73171,72653,518,59,9,9,5,1884,1884,1875,1875
Amador,21,2022-05-11,29,29,29,0,1529,1533,1515,18,0,0,0,0,86,86,86,86
Butte,21,2022-05-11,127,127,126,1,2448,2453,2439,14,4,0,0,0,433,433,433,433
Calaveras,21,2022-05-11,35,35,35,0,741,741,734,7,0,0,0,1,120,120,120,120
Colusa,21,2022-05-11,4,4,4,0,210,210,208,2,0,0,0,0,21,21,21,21
Contra Costa,21,2022-05-11,2701,2708,2676,32,32099,32171,31790,381,43,3,3,7,1303,1303,1300,1300
Del Norte,21,2022-05-11,99,99,98,1,1550,1553,1539,14,0,0,0,1,49,49,49,49
El Dorado,21,2022-05-11,203,203,201,2,3064,3070,3039,31,2,0,0,0,214,214,214,214
Fresno,21,2022-05-11,837,837,828,9,18359,18402,18197,205,39,1,1,4,2771,2771,2770,2770
Glenn,21,2022-05-11,10,10,10,0,238,238,236,2,0,0,0,0,42,42,42,42
Humboldt,21,2022-05-11,275,275,272,3,3142,3148,3119,29,8,0,0,2,146,146,146,146
Imperial,21,2022-05-11,163,163,161,2,3987,3995,3955,40,1,0,0,1,945,945,945,945
Inyo,21,2022-05-11,28,28,28,0,220,220,218,2,0,0,0,0,56,56,56,56
Kern,21,2022-05-11,503,503,499,4,18960,19004,18847,157,16,2,2,2,2346,2346,2344,2344
Kings,21,2022-05-11,124,124,123,1,5074,5086,5036,50,0,0,0,0,447,447,447,447
Lake,21,2022-05-11,35,35,35,0,1028,1029,1017,12,0,0,0,0,139,139,139,139
Lassen,21,2022-05-11,12,12,12,0,1679,1683,1670,13,0,0,0,0,62,62,62,62
Los Angeles,21,2022-05-11,19028,19072,19018,54,930714,932848,930227,2621,242,36,36,25,31945,31945,31909,31909
Madera,21,2022-05-11,149,149,147,2,3754,3763,3720,43,3,0,0,0,368,368,368,368
Marin,21,2022-05-11,704,704,696,8,8089,8108,8019,89,12,0,0,0,295,295,295,295
Mariposa,21,2022-05-11,24,24,24,0,337,337,333,4,0,0,0,0,28,28,28,28
Mendocino,21,2022-05-11,82,82,81,1,1249,1251,1232,19,1,0,0,0,127,127,127,127
Merced,21,2022-05-11,226,226,224,2,3706,3714,3682,32,2,1,1,0,827,827,826,826
Modoc,21,2022-05-11,0,0,0,0,45,46,45,1,0,0,0,0,7,7,7,7
Mono,21,2022-05-11,11,11,11,0,115,115,113,2,0,0,0,0,6,6,6,6
Monterey,21,2022-05-11,467,467,459,8,9351,9372,9207,165,9,0,0,0,733,733,733,733
Napa,21,2022-05-11,246,246,244,2,3240,3245,3220,25,1,0,0,0,142,142,142,142
Nevada,21,2022-05-11,120,120,119,1,1625,1629,1611,18,6,0,0,0,128,128,128,128
Orange,21,2022-05-11,3815,3825,3800,25,91875,92086,91483,603,73,6,6,14,7100,7100,7094,7094
Placer,21,2022-05-11,560,560,553,7,7028,7044,6958,86,29,0,0,2,627,627,627,627
Plumas,21,2022-05-11,26,26,26,0,263,263,260,3,0,0,0,0,13,13,13,13
Riverside,21,2022-05-11,2556,2563,2540,23,45565,45668,45267,401,55,4,4,5,6385,6385,6381,6381
Sacramento,21,2022-05-11,2551,2557,2533,24,37388,37474,37118,356,65,4,4,14,3072,3072,3068,3068
San Benito,21,2022-05-11,84,84,83,1,1469,1473,1462,11,0,0,0,1,94,94,94,94
San Bernardino,21,2022-05-11,2065,2070,2055,15,46850,46959,46625,334,41,5,5,4,7865,7865,7860,7860
San Diego,21,2022-05-11,5512,5524,5508,16,89177,89383,89118,265,90,2,2,20,5330,5330,5328,5328
San Francisco,21,2022-05-11,3234,3241,3178,63,39073,39162,38405,757,58,6,6,6,880,880,874,874
San Joaquin,21,2022-05-11,917,917,908,9,16982,17020,16843,177,16,0,0,0,2247,2247,2247,2247
San Luis Obispo,21,2022-05-11,318,318,315,3,5441,5455,5411,44,2,0,0,1,483,483,483,483
San Mateo,21,2022-05-11,2434,2441,2425,16,37231,37317,37072,245,27,2,2,1,703,703,701,701
Santa Barbara,21,2022-05-11,694,694,688,6,15699,15735,15593,142,12,0,0,2,693,693,693,693
Santa Clara,21,2022-05-11,6033,6046,6027,19,107241,107486,107148,338,99,4,4,23,2310,2310,2306,2306
Santa Cruz,21,2022-05-11,778,778,772,6,24216,24271,24082,189,2,0,0,0,262,262,262,262
Shasta,21,2022-05-11,101,101,100,1,3412,3420,3388,32,8,0,0,0,564,564,564,564
Siskiyou,21,2022-05-11,19,19,19,0,318,318,316,2,0,0,0,0,83,83,83,83
Solano,21,2022-05-11,929,929,921,8,12804,12834,12721,113,18,0,0,2,448,448,448,448
Sonoma,21,2022-05-11,1315,1318,1307,11,14739,14774,14647,127,22,1,1,1,494,494,493,493
Stanislaus,21,2022-05-11,523,523,516,7,9255,9277,9151,126,22,1,1,3,1694,1694,1693,1693
Sutter,21,2022-05-11,81,81,80,1,1613,1617,1602,15,0,0,0,0,227,227,227,227
Tehama,21,2022-05-11,24,24,24,0,727,727,717,10,1,0,0,0,203,203,203,203
Trinity,21,2022-05-11,2,2,2,0,75,75,74,1,0,0,0,0,20,20,20,20
Tulare,21,2022-05-11,221,221,218,3,7764,7783,7675,108,9,1,1,3,1497,1497,1496,1496
Tuolumne,21,2022-05-11,72,72,71,1,1424,1426,1410,16,1,2,2,0,189,189,187,187
Ventura,21,2022-05-11,1254,1257,1249,8,22153,22203,22069,134,14,0,0,2,1498,1498,1498,1498
Yolo,21,2022-05-11,558,558,554,4,20800,20848,20682,166,4,0,0,0,323,323,323,323
Yuba,21,2022-05-11,91,91,90,1,1225,1227,1217,10,5,0,0,0,118,118,118,118
Alameda,22,2022-05-18,5266,5279,5250,29,75961,76144,75723,421,73,6,6,3,1890,1890,1884,1884
Amador,22,2022-05-18,63,63,62,1,1653,1657,1642,15,0,0,0,0,86,86,86,86
Butte,22,2022-05-18,264,264,263,1,2877,2883,2870,13,4,2,2,0,435,435,433,433
Calaveras,22,2022-05-18,46,46,46,0,760,760,754,6,0,1,1,1,121,121,120,120
Colusa,22,2022-05-18,7,7,7,0,230,230,228,2,0,0,0,0,21,21,21,21
Contra Costa,22,2022-05-18,3807,3817,3782,35,34210,34293,33976,317,53,8,8,10,1311,1311,1303,1303
Del Norte,22,2022-05-18,138,138,137,1,1740,1744,1731,13,0,1,1,0,50,50,49,49
El Dorado,22,2022-05-18,307,307,305,2,3112,3119,3095,24,5,1,1,0,215,215,214,214
Fresno,22,2022-05-18,1327,1330,1318,12,20310,20360,20183,177,47,2,2,5,2773,2773,2771,2771
Glenn,22,2022-05-18,17,17,17,0,266,266,264,2,0,0,0,0,42,42,42,42
Humboldt,22,2022-05-18,270,270,268,2,2958,2964,2943,21,10,1,1,3,147,147,146,146
Imperial,22,2022-05-18,246,246,244,2,4442,4455,4420,35,3,0,0,3,945,945,945,945
Inyo,22,2022-05-18,20,20,20,0,243,243,241,2,2,0,0,0,56,56,56,56
Kern,22,2022-05-18,790,790,785,5,20209,20258,20127,131,17,2,2,3,2348,2348,2346,2346
Kings,22,2022-05-18,253,253,251,2,5551,5566,5523,43,0,0,0,0,447,447,447,447
Lake,22,2022-05-18,83,83,82,1,1252,1256,1245,11,1,0,0,0,139,139,139,139
Lassen,22,2022-05-18,23,23,23,0,1729,1734,1723,11,1,0,0,0,62,62,62,62
Los Angeles,22,2022-05-18,23820,23878,23826,52,937354,939620,937560,2060,326,34,34,53,31979,31979,31945,31945
Madera,22,2022-05-18,191,191,189,2,3604,3615,3583,32,3,0,0,1,368,368,368,368
Marin,22,2022-05-18,880,880,872,8,8525,8546,8473,73,14,0,0,1,295,295,295,295
Mariposa,22,2022-05-18,24,24,24,0,344,344,341,3,0,0,0,0,28,28,28,28
Mendocino,22,2022-05-18,127,127,126,1,1520,1524,1506,18,4,1,1,0,128,128,127,127
Merced,22,2022-05-18,366,366,364,2,4032,4043,4016,27,5,1,1,0,828,828,827,827
Modoc,22,2022-05-18,4,4,4,0,41,42,41,1,0,0,0,0,7,7,7,7
Mono,22,2022-05-18,12,12,12,0,132,132,130,2,0,0,0,0,6,6,6,6
Monterey,22,2022-05-18,578,578,570,8,9603,9626,9493,133,8,2,2,1,735,735,733,733
Napa,22,2022-05-18,310,310,308,2,3870,3880,3857,23,2,0,0,0,142,142,142,142
Nevada,22,2022-05-18,146,146,145,1,1875,1880,1864,16,1,0,0,1,128,128,128,128
Orange,22,2022-05-18,4926,4938,4913,25,95132,95362,94874,488,102,10,10,12,7110,7110,7100,7100
Placer,22,2022-05-18,835,835,827,8,7938,7957,7881,76,40,2,2,2,629,629,627,627
Plumas,22,2022-05-18,47,47,47,0,264,264,262,2,0,0,0,0,13,13,13,13
Riverside,22,2022-05-18,3803,3813,3787,26,48831,48949,48613,336,68,1,1,7,6386,6386,6385,6385
Sacramento,22,2022-05-18,3486,3496,3470,26,41146,41245,40939,306,100,8,8,8,3080,3080,3072,3072
San Benito,22,2022-05-18,130,130,129,1,1537,1542,1533,9,1,0,0,0,94,94,94,94
San Bernardino,22,2022-05-18,2743,2750,2735,15,49284,49404,49130,274,38,6,6,8,7871,7871,7865,7865
San Diego,22,2022-05-18,7737,7756,7738,18,98765,99004,98775,229,110,4,4,24,5334,5334,5330,5330
San Francisco,22,2022-05-18,3576,3585,3531,54,39653,39749,39148,601,68,4,4,8,884,884,880,880
San Joaquin,22,2022-05-18,1376,1379,1368,11,19771,19819,19657,162,18,2,2,3,2249,2249,2247,2247
San Luis Obispo,22,2022-05-18,492,492,489,3,6387,6403,6363,40,5,0,0,0,483,483,483,483
San Mateo,22,2022-05-18,2987,2994,2979,15,41027,41126,40915,211,39,1,1,1,704,704,703,703
Santa Barbara,22,2022-05-18,1008,1009,1002,7,17363,17405,17282,123,18,0,0,4,693,693,693,693
Santa Clara,22,2022-05-18,7515,7532,7513,19,111184,111453,111179,274,102,9,9,24,2319,2319,2310,2310
Santa Cruz,22,2022-05-18,697,697,693,4,15724,15762,15662,100,4,0,0,0,262,262,262,262
Shasta,22,2022-05-18,166,166,165,1,3766,3775,3747,28,7,1,1,1,565,565,564,564
Siskiyou,22,2022-05-18,18,18,18,0,355,355,353,2,0,0,0,0,83,83,83,83
Solano,22,2022-05-18,1466,1470,1460,10,14582,14618,14517,101,32,0,0,2,448,448,448,448
Sonoma,22,2022-05-18,1609,1613,1602,11,15677,15716,15611,105,25,1,1,4,495,495,494,494
Stanislaus,22,2022-05-18,845,845,836,9,10240,10265,10155,110,33,3,3,4,1697,1697,1694,1694
Sutter,22,2022-05-18,111,111,110,1,1793,1798,1785,13,0,0,0,0,227,227,227,227
Tehama,22,2022-05-18,52,52,51,1,860,860,851,9,0,1,1,1,204,204,203,203
Trinity,22,2022-05-18,7,7,7,0,79,79,78,1,0,0,0,0,20,20,20,20
Tulare,22,2022-05-18,472,472,467,5,8726,8748,8653,95,20,0,0,0,1497,1497,1497,1497
Tuolumne,22,2022-05-18,167,167,166,1,1545,1549,1535,14,1,0,0,1,189,189,189,189
Ventura,22,2022-05-18,1770,1774,1766,8,23897,23955,23842,113,26,2,2,3,1500,1500,1498,1498
Yolo,22,2022-05-18,748,748,743,5,22815,22870,22727,143,0,0,0,1,323,323,323,323
Yuba,22,2022-05-18,140,140,139,1,1440,1443,1433,10,3,0,0,0,118,118,118,118
Alameda,23,2022-05-25,5604,5617,5593,24,76844,77041,76709,332,84,5,5,4,1895,1895,1890,1890
Amador,23,2022-05-25,100,100,99,1,1441,1446,1436,10,0,1,1,1,87,87,86,86
Butte,23,2022-05-25,266,266,265,1,2798,2804,2794,10,7,1,1,1,436,436,435,435
Calaveras,23,2022-05-25,53,53,53,0,728,728,724,4,0,1,1,0,122,122,121,121
Colusa,23,2022-05-25,8,8,8,0,218,218,217,1,0,0,0,0,21,21,21,21
Contra Costa,23,2022-05-25,3937,3947,3918,29,34614,34702,34451,251,68,10,10,8,1321,1321,1311,1311
Del Norte,23,2022-05-25,47,47,47,0,1223,1226,1219,7,1,0,0,1,50,50,50,50
El Dorado,23,2022-05-25,398,398,396,2,3510,3519,3498,21,5,3,3,1,218,218,215,215
Fresno,23,2022-05-25,1775,1780,1768,12,22328,22385,22233,152,57,3,3,9,2776,2776,2773,2773
Glenn,23,2022-05-25,25,25,25,0,285,285,283,2,0,0,0,0,42,42,42,42
Humboldt,23,2022-05-25,219,219,218,1,2893,2899,2883,16,9,1,1,3,148,148,147,147
Imperial,23,2022-05-25,331,331,329,2,4851,4864,4834,30,5,0,0,1,945,945,945,945
Inyo,23,2022-05-25,32,32,32,0,202,202,201,1,0,0,0,0,56,56,56,56
Kern,23,2022-05-25,1107,1110,1104,6,21341,21395,21287,108,20,0,0,7,2348,2348,2348,2348
Kings,23,2022-05-25,271,271,269,2,5531,5546,5512,34,1,0,0,0,447,447,447,447
Lake,23,2022-05-25,110,110,109,1,1147,1150,1142,8,1,0,0,1,139,139,139,139
Lassen,23,2022-05-25,52,52,52,0,1807,1812,1803,9,1,0,0,0,62,62,62,62
Los Angeles,23,2022-05-25,29555,29631,29580,51,949423,951848,950221,1627,374,37,37,55,32016,32016,31979,31979
Madera,23,2022-05-25,236,236,234,2,3802,3813,3787,26,3,0,0,2,368,368,368,368
Marin,23,2022-05-25,750,750,745,5,8585,8608,8550,58,9,0,0,0,295,295,295,295
Mariposa,23,2022-05-25,35,35,35,0,334,334,332,2,0,0,0,0,28,28,28,28
Mendocino,23,2022-05-25,144,144,143,1,1549,1554,1540,14,2,1,1,0,129,129,128,128
Merced,23,2022-05-25,412,412,410,2,4173,4185,4163,22,6,0,0,0,828,828,828,828
Modoc,23,2022-05-25,4,4,4,0,45,46,45,1,0,0,0,0,7,7,7,7
Mono,23,2022-05-25,10,10,10,0,148,148,146,2,0,0,0,0,6,6,6,6
Monterey,23,2022-05-25,659,659,652,7,9198,9222,9122,100,10,0,0,1,735,735,735,735
Napa,23,2022-05-25,337,337,335,2,4031,4042,4023,19,5,0,0,1,142,142,142,142
Nevada,23,2022-05-25,179,179,178,1,1910,1914,1901,13,1,0,0,0,128,128,128,128
Orange,23,2022-05-25,5851,5866,5843,23,95576,95819,95437,382,109,9,9,17,7119,7119,7110,7110
Placer,23,2022-05-25,851,851,845,6,7556,7576,7519,57,52,2,2,4,631,631,629,629
Plumas,23,2022-05-25,39,39,39,0,263,263,261,2,1,0,0,0,13,13,13,13
Riverside,23,2022-05-25,4441,4453,4429,24,52747,52883,52599,284,79,7,7,11,6393,6393,6386,6386
Sacramento,23,2022-05-25,4014,4024,4001,23,40233,40335,40101,234,118,7,7,16,3087,3087,3080,3080
San Benito,23,2022-05-25,182,182,181,1,1615,1620,1612,8,0,0,0,0,94,94,94,94
San Bernardino,23,2022-05-25,3640,3650,3634,16,50166,50295,50077,218,49,5,5,9,7876,7876,7871,7871
San Diego,23,2022-05-25,9159,9182,9165,17,103159,103424,103237,187,147,7,7,22,5341,5341,5334,5334
San Francisco,23,2022-05-25,3425,3433,3392,41,40221,40323,39843,480,80,9,9,12,893,893,884,884
San Joaquin,23,2022-05-25,1548,1553,1543,10,20748,20801,20668,133,22,2,2,4,2251,2251,2249,2249
San Luis Obispo,23,2022-05-25,768,768,764,4,7232,7251,7215,36,11,3,3,0,486,486,483,483
San Mateo,23,2022-05-25,3185,3192,3179,13,39942,40044,39884,160,35,1,1,1,705,705,704,704
Santa Barbara,23,2022-05-25,1120,1122,1116,6,17751,17796,17697,99,19,1,1,2,694,694,693,693
Santa Clara,23,2022-05-25,7963,7984,7969,15,109033,109311,109101,210,135,7,7,24,2326,2326,2319,2319
Santa Cruz,23,2022-05-25,531,531,528,3,7937,7958,7920,38,11,1,1,0,263,263,262,262
Shasta,23,2022-05-25,174,174,173,1,3669,3677,3656,21,6,1,1,3,566,566,565,565
Siskiyou,23,2022-05-25,48,48,48,0,393,393,391,2,3,0,0,0,83,83,83,83
Solano,23,2022-05-25,1460,1464,1456,8,14579,14615,14536,79,33,1,1,6,449,449,448,448
Sonoma,23,2022-05-25,1379,1383,1376,7,16533,16575,16488,87,42,1,1,2,496,496,495,495
Stanislaus,23,2022-05-25,851,851,844,7,10549,10577,10489,88,38,0,0,4,1697,1697,1697,1697
Sutter,23,2022-05-25,167,167,166,1,1990,1995,1984,11,0,1,1,0,228,228,227,227
Tehama,23,2022-05-25,50,50,50,0,832,833,826,7,2,0,0,0,204,204,204,204
Trinity,23,2022-05-25,5,5,5,0,100,100,99,1,0,0,0,0,20,20,20,20
Tulare,23,2022-05-25,623,623,618,5,9303,9326,9247,79,23,0,0,2,1497,1497,1497,1497
Tuolumne,23,2022-05-25,128,128,127,1,1501,1505,1495,10,0,1,1,0,190,190,189,189
Ventura,23,2022-05-25,1907,1912,1905,7,23493,23553,23466,87,34,1,1,2,1501,1501,1500,1500
Yolo,23,2022-05-25,700,700,697,3,21636,21692,21586,106,3,0,0,0,323,323,323,323
Yuba,23,2022-05-25,156,156,155,1,1401,1405,1398,7,8,0,0,1,118,118,118,118
Alameda,24,2022-06-01,5555,5569,5550,19,62555,62726,62515,211,92,2,2,14,1897,1897,1895,1895
Amador,24,2022-06-01,82,82,82,0,1205,1207,1200,7,1,0,0,0,87,87,87,87
Butte,24,2022-06-01,321,321,320,1,3058,3066,3058,8,24,0,0,2,436,436,436,436
Calaveras,24,2022-06-01,60,60,60,0,664,664,661,3,0,0,0,0,122,122,122,122
Colusa,24,2022-06-01,17,17,17,0,203,203,202,1,1,0,0,0,21,21,21,21
Contra Costa,24,2022-06-01,3515,3524,3504,20,31616,31703,31524,179,68,3,3,10,1324,1324,1321,1321
Del Norte,24,2022-06-01,53,53,53,0,1059,1060,1055,5,0,1,1,0,51,51,50,50
El Dorado,24,2022-06-01,321,321,319,2,3033,3041,3027,14,9,0,0,2,218,218,218,218
Fresno,24,2022-06-01,1867,1871,1861,10,20088,20142,20035,107,84,4,4,7,2780,2780,2776,2776
Glenn,24,2022-06-01,34,34,34,0,306,306,305,1,3,0,0,0,42,42,42,42
Humboldt,24,2022-06-01,208,208,207,1,2538,2544,2533,11,11,1,1,3,149,149,148,148
Imperial,24,2022-06-01,381,381,379,2,4416,4428,4407,21,3,1,1,0,946,946,945,945
Inyo,24,2022-06-01,18,18,18,0,172,172,171,1,1,0,0,0,56,56,56,56
Kern,24,2022-06-01,1186,1189,1184,5,19482,19535,19458,77,25,0,0,4,2348,2348,2348,2348
Kings,24,2022-06-01,323,323,321,2,4882,4896,4873,23,4,0,0,1,447,447,447,447
Lake,24,2022-06-01,101,101,100,1,1010,1013,1007,6,2,0,0,0,139,139,139,139
Lassen,24,2022-06-01,56,56,56,0,1876,1882,1875,7,1,0,0,0,62,62,62,62
Los Angeles,24,2022-06-01,28720,28797,28759,38,838891,841184,840067,1117,465,43,43,59,32059,32059,32016,32016
Madera,24,2022-06-01,277,277,276,1,3506,3516,3497,19,5,0,0,0,368,368,368,368
Marin,24,2022-06-01,661,661,658,3,7281,7299,7261,38,9,4,4,2,299,299,295,295
Mariposa,24,2022-06-01,59,59,59,0,332,332,330,2,0,0,0,0,28,28,28,28
Mendocino,24,2022-06-01,173,173,172,1,1349,1353,1343,10,5,0,0,0,129,129,129,129
Merced,24,2022-06-01,414,414,412,2,3723,3735,3720,15,0,0,0,0,828,828,828,828
Modoc,24,2022-06-01,7,7,7,0,37,38,37,1,0,0,0,0,7,7,7,7
Mono,24,2022-06-01,10,10,10,0,94,94,93,1,0,0,0,0,6,6,6,6
Monterey,24,2022-06-01,684,685,679,6,8351,8373,8303,70,16,2,2,0,737,737,735,735
Napa,24,2022-06-01,378,378,377,1,3231,3239,3227,12,8,0,0,3,142,142,142,142
Nevada,24,2022-06-01,198,198,197,1,1791,1795,1785,10,4,2,2,0,130,130,128,128
Orange,24,2022-06-01,6240,6256,6237,19,73098,73297,73065,232,121,10,10,18,7129,7129,7119,7119
Placer,24,2022-06-01,801,801,796,5,6501,6519,6481,38,61,0,0,11,631,631,631,631
Plumas,24,2022-06-01,36,36,36,0,233,233,232,1,1,0,0,0,13,13,13,13
Riverside,24,2022-06-01,4339,4352,4334,18,47003,47131,46934,197,97,4,4,11,6397,6397,6393,6393
Sacramento,24,2022-06-01,4213,4225,4206,19,36020,36118,35955,163,141,9,9,18,3096,3096,3087,3087
San Benito,24,2022-06-01,200,200,199,1,1509,1512,1506,6,0,0,0,2,94,94,94,94
San Bernardino,24,2022-06-01,3971,3982,3969,13,46241,46367,46210,157,63,4,4,11,7880,7880,7876,7876
San Diego,24,2022-06-01,9199,9223,9210,13,89336,89582,89456,126,172,8,8,27,5349,5349,5341,5341
San Francisco,24,2022-06-01,3307,3316,3285,31,34811,34906,34582,324,76,8,8,15,901,901,893,893
San Joaquin,24,2022-06-01,1627,1631,1623,8,17711,17761,17673,88,33,1,1,11,2252,2252,2251,2251
San Luis Obispo,24,2022-06-01,705,706,703,3,6150,6166,6142,24,14,1,1,0,487,487,486,486
San Mateo,24,2022-06-01,2856,2865,2856,9,32987,33078,32975,103,33,3,3,2,708,708,705,705
Santa Barbara,24,2022-06-01,1113,1115,1110,5,14434,14474,14411,63,21,1,1,4,695,695,694,694
Santa Clara,24,2022-06-01,7443,7463,7452,11,86614,86850,86721,129,171,8,8,17,2334,2334,2326,2326
Santa Cruz,24,2022-06-01,605,605,603,2,6689,6708,6683,25,10,0,0,1,263,263,263,263
Shasta,24,2022-06-01,157,157,156,1,3562,3572,3556,16,5,3,3,2,569,569,566,566
Siskiyou,24,2022-06-01,45,45,45,0,377,377,376,1,2,0,0,0,83,83,83,83
Solano,24,2022-06-01,1345,1349,1343,6,12334,12368,12316,52,30,0,0,5,449,449,449,449
Sonoma,24,2022-06-01,1338,1342,1337,5,12262,12297,12246,51,34,2,2,5,498,498,496,496
Stanislaus,24,2022-06-01,917,919,913,6,9146,9171,9111,60,52,3,3,1,1700,1700,1697,1697
Sutter,24,2022-06-01,164,164,163,1,1786,1791,1783,8,0,0,0,0,228,228,228,228
Tehama,24,2022-06-01,66,66,66,0,825,826,821,5,3,0,0,0,204,204,204,204
Trinity,24,2022-06-01,6,6,6,0,81,81,80,1,0,0,0,0,20,20,20,20
Tulare,24,2022-06-01,654,654,650,4,8091,8112,8059,53,20,0,0,1,1497,1497,1497,1497
Tuolumne,24,2022-06-01,122,122,121,1,1488,1492,1484,8,4,0,0,0,190,190,190,190
Ventura,24,2022-06-01,1733,1737,1732,5,21491,21550,21488,62,41,2,2,1,1503,1503,1501,1501
Yolo,24,2022-06-01,740,741,738,3,18708,18759,18688,71,6,0,0,0,323,323,323,323
Yuba,24,2022-06-01,147,147,146,1,1350,1354,1349,5,5,0,0,2,118,118,118,118
Alameda,25,2022-06-08,5682,5699,5684,15,63802,63989,63820,169,97,6,6,10,1903,1903,1897,1897
Amador,25,2022-06-08,144,144,143,1,1680,1685,1678,7,0,0,0,0,87,87,87,87
Butte,25,2022-06-08,457,457,456,1,3607,3618,3610,8,22,1,1,2,437,437,436,436
Calaveras,25,2022-06-08,72,72,72,0,637,637,635,2,0,2,2,0,124,124,122,122
Colusa,25,2022-06-08,16,16,16,0,304,304,303,1,10,0,0,0,21,21,21,21
Contra Costa,25,2022-06-08,3852,3864,3847,17,31626,31718,31578,140,97,10,10,12,1334,1334,1324,1324
Del Norte,25,2022-06-08,52,52,52,0,916,918,915,3,2,0,0,0,51,51,51,51
El Dorado,25,2022-06-08,386,386,385,1,3465,3476,3463,13,8,1,1,4,219,219,218,218
Fresno,25,2022-06-08,2361,2368,2358,10,21468,21531,21441,90,99,3,3,6,2783,2783,2780,2780
Glenn,25,2022-06-08,43,43,43,0,326,326,325,1,5,0,0,0,42,42,42,42
Humboldt,25,2022-06-08,251,251,250,1,2636,2642,2633,9,12,0,0,3,149,149,149,149
Imperial,25,2022-06-08,452,452,450,2,4517,4531,4514,17,6,0,0,0,946,946,946,946
Inyo,25,2022-06-08,14,14,14,0,199,199,198,1,1,0,0,0,56,56,56,56
Kern,25,2022-06-08,1622,1627,1622,5,21337,21402,21336,66,29,2,2,6,2350,2350,2348,2348
Kings,25,2022-06-08,368,368,367,1,5000,5015,4996,19,11,1,1,1,448,448,447,447
Lake,25,2022-06-08,133,133,132,1,1122,1126,1121,5,4,0,0,3,139,139,139,139
Lassen,25,2022-06-08,61,61,61,0,2095,2101,2095,6,2,0,0,0,62,62,62,62
Los Angeles,25,2022-06-08,32691,32786,32752,34,896596,899228,898286,942,527,40,40,68,32099,32099,32059,32059
Madera,25,2022-06-08,371,371,369,2,4152,4164,4147,17,4,0,0,2,368,368,368,368
Marin,25,2022-06-08,681,681,678,3,7116,7136,7107,29,13,2,2,1,301,301,299,299
Mariposa,25,2022-06-08,46,46,46,0,408,408,406,2,0,0,0,0,28,28,28,28
Mendocino,25,2022-06-08,188,188,187,1,1718,1723,1713,10,6,1,1,2,130,130,129,129
Merced,25,2022-06-08,564,564,562,2,4157,4170,4157,13,16,0,0,0,828,828,828,828
Modoc,25,2022-06-08,8,8,8,0,32,33,32,1,1,0,0,0,7,7,7,7
Mono,25,2022-06-08,13,13,13,0,95,95,94,1,0,0,0,0,6,6,6,6
Monterey,25,2022-06-08,922,922,916,6,9027,9054,8994,60,18,3,3,1,740,740,737,737
Napa,25,2022-06-08,526,526,525,1,4028,4040,4029,11,11,1,1,1,143,143,142,142
Nevada,25,2022-06-08,209,209,208,1,2132,2138,2129,9,5,0,0,0,130,130,130,130
Orange,25,2022-06-08,7111,7132,7115,17,69379,69582,69412,170,168,12,12,18,7141,7141,7129,7129
Placer,25,2022-06-08,836,836,832,4,7228,7248,7215,33,60,0,0,6,631,631,631,631
Plumas,25,2022-06-08,42,42,42,0,298,298,297,1,0,0,0,0,13,13,13,13
Riverside,25,2022-06-08,5088,5104,5087,17,50387,50536,50370,166,95,4,4,7,6401,6401,6397,6397
Sacramento,25,2022-06-08,4630,4643,4627,16,39130,39246,39108,138,153,14,14,24,3110,3110,3096,3096
San Benito,25,2022-06-08,245,245,244,1,1854,1859,1854,5,3,0,0,0,94,94,94,94
San Bernardino,25,2022-06-08,4833,4846,4833,13,50716,50865,50731,134,82,5,5,18,7885,7885,7880,7880
San Diego,25,2022-06-08,10016,10046,10035,11,90061,90326,90226,100,208,8,8,24,5357,5357,5349,5349
San Francisco,25,2022-06-08,3256,3266,3242,24,34341,34442,34191,251,78,4,4,8,905,905,901,901
San Joaquin,25,2022-06-08,2062,2067,2059,8,20639,20700,20619,81,45,5,5,7,2257,2257,2252,2252
San Luis Obispo,25,2022-06-08,754,754,752,2,6429,6447,6427,20,16,1,1,1,488,488,487,487
San Mateo,25,2022-06-08,2859,2867,2860,7,31894,31988,31910,78,39,2,2,2,710,710,708,708
Santa Barbara,25,2022-06-08,1089,1092,1088,4,12420,12456,12414,42,19,1,1,5,696,696,695,695
Santa Clara,25,2022-06-08,7833,7856,7847,9,91089,91355,91248,107,160,6,6,25,2340,2340,2334,2334
Santa Cruz,25,2022-06-08,894,895,892,3,9873,9901,9873,28,21,1,1,2,264,264,263,263
Shasta,25,2022-06-08,209,209,208,1,3652,3664,3651,13,12,1,1,2,570,570,569,569
Siskiyou,25,2022-06-08,43,43,43,0,376,376,375,1,2,0,0,0,83,83,83,83
Solano,25,2022-06-08,1665,1670,1665,5,14044,14086,14040,46,28,2,2,5,451,451,449,449
Sonoma,25,2022-06-08,1527,1532,1527,5,12882,12920,12879,41,31,2,2,5,500,500,498,498
Stanislaus,25,2022-06-08,1151,1155,1149,6,9818,9847,9797,50,62,0,0,7,1700,1700,1700,1700
Sutter,25,2022-06-08,197,197,196,1,1851,1856,1850,6,0,0,0,0,228,228,228,228
Tehama,25,2022-06-08,86,86,86,0,1039,1041,1036,5,2,0,0,0,204,204,204,204
Trinity,25,2022-06-08,8,8,8,0,105,105,104,1,0,0,0,0,20,20,20,20
Tulare,25,2022-06-08,831,832,828,4,10172,10202,10149,53,19,0,0,0,1497,1497,1497,1497
Tuolumne,25,2022-06-08,115,115,115,0,1471,1475,1469,6,3,0,0,2,190,190,190,190
Ventura,25,2022-06-08,1952,1959,1955,4,22496,22562,22511,51,41,3,3,3,1506,1506,1503,1503
Yolo,25,2022-06-08,741,741,739,2,18754,18810,18754,56,2,1,1,1,324,324,323,323
Yuba,25,2022-06-08,198,198,197,1,1518,1523,1518,5,9,0,0,1,118,118,118,118
Alameda,26,2022-06-15,4893,4908,4898,10,53506,53676,53566,110,103,5,5,16,1908,1908,1903,1903
Amador,26,2022-06-15,92,92,92,0,1301,1306,1302,4,2,0,0,0,87,87,87,87
Butte,26,2022-06-15,384,384,383,1,3411,3421,3415,6,27,5,5,0,442,442,437,437
Calaveras,26,2022-06-15,79,79,79,0,626,626,624,2,0,0,0,1,124,124,124,124
Colusa,26,2022-06-15,13,13,13,0,256,256,255,1,14,0,0,0,21,21,21,21
Contra Costa,26,2022-06-15,3305,3317,3306,11,26749,26834,26742,92,83,7,7,12,1341,1341,1334,1334
Del Norte,26,2022-06-15,83,83,83,0,647,647,645,2,4,0,0,1,51,51,51,51
El Dorado,26,2022-06-15,321,321,320,1,3208,3219,3210,9,7,2,2,0,221,221,219,219
Fresno,26,2022-06-15,2387,2394,2386,8,20748,20813,20746,67,110,3,3,17,2786,2786,2783,2783
Glenn,26,2022-06-15,31,31,31,0,324,324,323,1,4,0,0,0,42,42,42,42
Humboldt,26,2022-06-15,289,289,288,1,2319,2324,2318,6,12,0,0,5,149,149,149,149
Imperial,26,2022-06-15,487,487,486,1,4511,4525,4512,13,7,1,1,0,947,947,946,946
Inyo,26,2022-06-15,17,17,17,0,177,178,177,1,0,0,0,0,56,56,56,56
Kern,26,2022-06-15,1551,1556,1552,4,21155,21221,21170,51,35,1,1,9,2351,2351,2350,2350
Kings,26,2022-06-15,376,376,375,1,5228,5244,5229,15,5,1,1,0,449,449,448,448
Lake,26,2022-06-15,144,144,144,0,1209,1213,1209,4,1,0,0,2,139,139,139,139
Lassen,26,2022-06-15,72,72,72,0,1757,1763,1759,4,1,0,0,0,62,62,62,62
Los Angeles,26,2022-06-15,28110,28200,28177,23,485741,487269,486865,404,540,51,51,65,32150,32150,32099,32099
Madera,26,2022-06-15,360,360,359,1,4400,4415,4401,14,8,0,0,1,368,368,368,368
Marin,26,2022-06-15,692,692,690,2,6693,6714,6692,22,16,1,1,1,302,302,301,301
Mariposa,26,2022-06-15,53,53,53,0,339,339,338,1,0,0,0,0,28,28,28,28
Mendocino,26,2022-06-15,152,152,151,1,1490,1495,1488,7,4,0,0,1,130,130,130,130
Merced,26,2022-06-15,509,509,508,1,4063,4077,4067,10,12,1,1,2,829,829,828,828
Modoc,26,2022-06-15,6,6,6,0,35,36,35,1,0,1,1,0,8,8,7,7
Mono,26,2022-06-15,16,16,16,0,99,99,98,1,0,1,1,0,7,7,6,6
Monterey,26,2022-06-15,837,838,834,4,8672,8700,8655,45,25,2,2,1,742,742,740,740
Napa,26,2022-06-15,415,415,414,1,3712,3724,3716,8,4,1,1,1,144,144,143,143
Nevada,26,2022-06-15,193,193,192,1,1704,1709,1704,5,11,0,0,0,130,130,130,130
Orange,26,2022-06-15,7113,7135,7121,14,63909,64110,63988,122,156,12,12,21,7153,7153,7141,7141
Placer,26,2022-06-15,742,742,739,3,6399,6418,6395,23,74,2,2,5,633,633,631,631
Plumas,26,2022-06-15,32,32,32,0,245,245,244,1,0,0,0,0,13,13,13,13
Riverside,26,2022-06-15,4895,4911,4898,13,46376,46522,46403,119,98,3,3,11,6404,6404,6401,6401
Sacramento,26,2022-06-15,3977,3989,3978,11,35921,36035,35936,99,197,13,13,24,3123,3123,3110,3110
San Benito,26,2022-06-15,171,171,171,0,1683,1688,1684,4,0,0,0,1,94,94,94,94
San Bernardino,26,2022-06-15,4614,4628,4618,10,47192,47341,47243,98,106,7,7,20,7892,7892,7885,7885
San Diego,26,2022-06-15,9678,9710,9702,8,82238,82498,82427,71,192,7,7,20,5364,5364,5357,5357
San Francisco,26,2022-06-15,3020,3030,3013,17,30292,30388,30216,172,77,10,10,18,915,915,905,905
San Joaquin,26,2022-06-15,1723,1728,1723,5,18738,18797,18740,57,30,4,4,4,2261,2261,2257,2257
San Luis Obispo,26,2022-06-15,660,660,658,2,6162,6182,6167,15,28,5,5,0,493,493,488,488
San Mateo,26,2022-06-15,2550,2557,2552,5,27292,27378,27326,52,50,2,2,1,712,712,710,710
Santa Barbara,26,2022-06-15,873,874,872,2,8459,8487,8465,22,22,1,1,3,697,697,696,696
Santa Clara,26,2022-06-15,6691,6711,6705,6,66744,66956,66895,61,181,13,13,19,2353,2353,2340,2340
Santa Cruz,26,2022-06-15,851,852,850,2,9519,9550,9529,21,19,1,1,2,265,265,264,264
Shasta,26,2022-06-15,211,211,210,1,3312,3322,3313,9,7,2,2,1,572,572,570,570
Siskiyou,26,2022-06-15,47,47,47,0,381,381,380,1,0,1,1,0,84,84,83,83
Solano,26,2022-06-15,1551,1557,1553,4,12146,12186,12155,31,38,0,0,3,451,451,451,451
Sonoma,26,2022-06-15,1338,1343,1340,3,11248,11284,11256,28,35,1,1,3,501,501,500,500
Stanislaus,26,2022-06-15,1116,1121,1117,4,9389,9419,9381,38,60,4,4,9,1704,1704,1700,1700
Sutter,26,2022-06-15,201,201,200,1,1878,1884,1879,5,0,0,0,0,228,228,228,228
Tehama,26,2022-06-15,96,96,96,0,953,957,953,4,4,0,0,1,204,204,204,204
Trinity,26,2022-06-15,11,11,11,0,99,100,99,1,0,0,0,0,20,20,20,20
Tulare,26,2022-06-15,844,845,842,3,9252,9281,9244,37,27,4,4,2,1501,1501,1497,1497
Tuolumne,26,2022-06-15,159,159,158,1,1407,1412,1407,5,1,0,0,0,190,190,190,190
Ventura,26,2022-06-15,1846,1853,1850,3,19463,19526,19492,34,50,2,2,3,1508,1508,1506,1506
Yolo,26,2022-06-15,739,739,737,2,12201,12240,12212,28,3,0,0,1,324,324,324,324
Yuba,26,2022-06-15,164,164,164,0,1452,1457,1453,4,8,0,0,3,118,118,118,118
Alameda,27,2022-06-22,5122,5141,5133,8,47230,47397,47321,76,113,11,11,14,1919,1919,1908,1908
Amador,27,2022-06-22,98,98,98,0,1278,1282,1279,3,2,0,0,2,87,87,87,87
Butte,27,2022-06-22,422,422,421,1,3556,3570,3565,5,25,2,2,1,444,444,442,442
Calaveras,27,2022-06-22,69,69,69,0,623,623,622,1,0,1,1,0,125,125,124,124
Colusa,27,2022-06-22,18,18,18,0,184,185,184,1,7,1,1,0,22,22,21,21
Contra Costa,27,2022-06-22,3383,3395,3386,9,25439,25530,25461,69,80,11,11,9,1352,1352,1341,1341
Del Norte,27,2022-06-22,105,105,105,0,632,633,632,1,5,1,1,1,52,52,51,51
El Dorado,27,2022-06-22,393,393,392,1,3167,3179,3172,7,7,1,1,2,222,222,221,221
Fresno,27,2022-06-22,2553,2563,2557,6,19733,19803,19753,50,109,3,3,16,2789,2789,2786,2786
Glenn,27,2022-06-22,39,39,39,0,307,307,306,1,3,0,0,0,42,42,42,42
Humboldt,27,2022-06-22,269,269,268,1,2202,2211,2206,5,7,0,0,3,149,149,149,149
Imperial,27,2022-06-22,657,657,655,2,3836,3850,3841,9,6,0,0,0,947,947,947,947
Inyo,27,2022-06-22,18,18,18,0,187,188,187,1,0,0,0,0,56,56,56,56
Kern,27,2022-06-22,1735,1741,1738,3,19897,19968,19931,37,45,4,4,10,2355,2355,2351,2351
Kings,27,2022-06-22,435,435,434,1,4529,4545,4535,10,10,0,0,0,449,449,449,449
Lake,27,2022-06-22,113,113,113,0,1234,1239,1236,3,1,0,0,0,139,139,139,139
Lassen,27,2022-06-22,44,44,44,0,1140,1144,1142,2,0,0,0,0,62,62,62,62
Los Angeles,27,2022-06-22,28672,28774,28756,18,351918,353161,352938,223,619,66,66,69,32216,32216,32150,32150
Madera,27,2022-06-22,361,361,360,1,4188,4203,4192,11,4,0,0,1,368,368,368,368
Marin,27,2022-06-22,667,667,665,2,6370,6392,6376,16,16,0,0,2,302,302,302,302
Mariposa,27,2022-06-22,48,48,48,0,333,333,332,1,0,0,0,0,28,28,28,28
Mendocino,27,2022-06-22,184,184,183,1,1527,1532,1527,5,4,0,0,0,130,130,130,130
Merced,27,2022-06-22,574,574,573,1,4067,4081,4073,8,10,3,3,2,832,832,829,829
Modoc,27,2022-06-22,8,8,8,0,33,34,33,1,0,0,0,0,8,8,8,8
Mono,27,2022-06-22,6,6,6,0,78,79,78,1,0,0,0,0,7,7,7,7
Monterey,27,2022-06-22,925,928,924,4,8648,8678,8643,35,31,0,0,3,742,742,742,742
Napa,27,2022-06-22,353,353,352,1,3014,3025,3020,5,5,2,2,0,146,146,144,144
Nevada,27,2022-06-22,161,161,161,0,1615,1620,1616,4,7,1,1,0,131,131,130,130
Orange,27,2022-06-22,7059,7083,7073,10,58642,58847,58760,87,158,11,11,23,7164,7164,7153,7153
Placer,27,2022-06-22,695,695,693,2,6112,6133,6116,17,78,3,3,6,636,636,633,633
Plumas,27,2022-06-22,44,44,44,0,251,251,250,1,1,0,0,0,13,13,13,13
Riverside,27,2022-06-22,5329,5347,5336,11,42980,43132,43046,86,112,9,9,14,6413,6413,6404,6404
Sacramento,27,2022-06-22,4005,4020,4011,9,34878,35001,34926,75,166,13,13,20,3136,3136,3123,3123
San Benito,27,2022-06-22,192,192,192,0,1551,1556,1553,3,0,1,1,1,95,95,94,94
San Bernardino,27,2022-06-22,4728,4744,4736,8,47001,47166,47090,76,105,15,15,18,7907,7907,7892,7892
San Diego,27,2022-06-22,9954,9989,9982,7,78413,78689,78636,53,238,11,11,25,5375,5375,5364,5364
San Francisco,27,2022-06-22,3138,3148,3134,14,28409,28508,28382,126,88,10,10,20,925,925,915,915
San Joaquin,27,2022-06-22,1775,1782,1778,4,17950,18013,17971,42,40,6,6,6,2267,2267,2261,2261
San Luis Obispo,27,2022-06-22,599,599,598,1,5824,5845,5834,11,25,6,6,0,499,499,493,493
San Mateo,27,2022-06-22,2781,2791,2787,4,26136,26230,26191,39,40,2,2,3,714,714,712,712
Santa Barbara,27,2022-06-22,1019,1022,1020,2,8940,8971,8953,18,37,3,3,5,700,700,697,697
Santa Clara,27,2022-06-22,7071,7095,7090,5,60059,60272,60229,43,162,9,9,17,2362,2362,2353,2353
Santa Cruz,27,2022-06-22,856,858,857,1,9105,9136,9120,16,23,1,1,1,266,266,265,265
Shasta,27,2022-06-22,279,279,278,1,3319,3330,3323,7,15,0,0,3,572,572,572,572
Siskiyou,27,2022-06-22,68,68,68,0,378,378,377,1,2,1,1,0,85,85,84,84
Solano,27,2022-06-22,1496,1501,1498,3,12299,12343,12318,25,52,0,0,4,451,451,451,451
Sonoma,27,2022-06-22,1400,1406,1403,3,10404,10440,10420,20,28,1,1,3,502,502,501,501
Stanislaus,27,2022-06-22,1071,1075,1072,3,8617,8649,8622,27,76,3,3,8,1707,1707,1704,1704
Sutter,27,2022-06-22,185,185,185,0,1854,1860,1856,4,0,0,0,0,228,228,228,228
Tehama,27,2022-06-22,89,89,89,0,865,869,866,3,1,0,0,0,204,204,204,204
Trinity,27,2022-06-22,18,18,18,0,126,127,126,1,0,0,0,0,20,20,20,20
Tulare,27,2022-06-22,865,868,865,3,8404,8434,8407,27,30,6,6,2,1507,1507,1501,1501
Tuolumne,27,2022-06-22,157,157,157,0,1596,1602,1598,4,5,1,1,0,191,191,190,190
Ventura,27,2022-06-22,1909,1916,1913,3,18867,18933,18907,26,55,2,2,4,1510,1510,1508,1508
Yolo,27,2022-06-22,731,732,731,1,10958,10995,10975,20,8,2,2,2,326,326,324,324
Yuba,27,2022-06-22,154,154,154,0,1404,1409,1406,3,8,1,1,4,119,119,118,118
Alameda,28,2022-06-29,5533,5554,5547,7,46998,47186,47127,59,132,9,9,18,1928,1928,1919,1919
Amador,28,2022-06-29,91,91,91,0,1219,1224,1222,2,5,0,0,1,87,87,87,87
Butte,28,2022-06-29,388,388,388,0,3238,3251,3248,3,31,3,3,0,447,447,444,444
Calaveras,28,2022-06-29,78,78,78,0,544,544,543,1,1,1,1,0,126,126,125,125
Colusa,28,2022-06-29,30,30,30,0,282,283,282,1,5,0,0,0,22,22,22,22
Contra Costa,28,2022-06-29,3645,3660,3652,8,25486,25588,25534,54,80,6,6,7,1358,1358,1352,1352
Del Norte,28,2022-06-29,154,154,154,0,643,644,643,1,5,1,1,1,53,53,52,52
El Dorado,28,2022-06-29,401,401,400,1,3181,3194,3188,6,6,0,0,0,222,222,222,222
Fresno,28,2022-06-29,2775,2787,2781,6,19453,19531,19492,39,152,2,2,18,2791,2791,2789,2789
Glenn,28,2022-06-29,31,31,31,0,281,282,281,1,1,0,0,0,42,42,42,42
Humboldt,28,2022-06-29,216,216,216,0,2057,2065,2062,3,13,1,1,5,150,150,149,149
Imperial,28,2022-06-29,709,711,710,1,3824,3838,3831,7,9,1,1,4,948,948,947,947
Inyo,28,2022-06-29,39,39,39,0,329,329,328,1,4,0,0,0,56,56,56,56
Kern,28,2022-06-29,1844,1851,1848,3,16351,16417,16393,24,56,8,8,9,2363,2363,2355,2355
Kings,28,2022-06-29,480,480,479,1,3957,3973,3966,7,4,0,0,0,449,449,449,449
Lake,28,2022-06-29,107,107,107,0,1075,1080,1078,2,0,1,1,0,140,140,139,139
Lassen,28,2022-06-29,52,52,52,0,871,873,872,1,2,0,0,0,62,62,62,62
Los Angeles,28,2022-06-29,34623,34761,34744,17,353312,354719,354544,175,734,68,68,74,32284,32284,32216,32216
Madera,28,2022-06-29,390,390,389,1,4070,4086,4078,8,14,0,0,1,368,368,368,368
Marin,28,2022-06-29,681,681,680,1,5998,6021,6009,12,19,1,1,1,303,303,302,302
Mariposa,28,2022-06-29,52,52,52,0,298,298,297,1,0,0,0,0,28,28,28,28
Mendocino,28,2022-06-29,153,153,153,0,1395,1400,1396,4,2,1,1,4,131,131,130,130
Merced,28,2022-06-29,631,632,631,1,3876,3892,3886,6,12,1,1,0,833,833,832,832
Modoc,28,2022-06-29,10,10,10,0,31,32,31,1,1,0,0,0,8,8,8,8
Mono,28,2022-06-29,30,30,30,0,113,114,113,1,0,0,0,0,7,7,7,7
Monterey,28,2022-06-29,902,906,903,3,8043,8073,8048,25,45,1,1,2,743,743,742,742
Napa,28,2022-06-29,405,405,404,1,3312,3325,3321,4,4,1,1,2,147,147,146,146
Nevada,28,2022-06-29,196,196,196,0,1560,1566,1563,3,7,0,0,1,131,131,131,131
Orange,28,2022-06-29,7773,7806,7797,9,59157,59393,59325,68,201,18,18,29,7182,7182,7164,7164
Placer,28,2022-06-29,836,839,837,2,6107,6131,6118,13,90,4,4,6,640,640,636,636
Plumas,28,2022-06-29,40,40,40,0,227,228,227,1,2,0,0,0,13,13,13,13
Riverside,28,2022-06-29,6631,6659,6649,10,44886,45064,44994,70,142,10,10,11,6423,6423,6413,6413
Sacramento,28,2022-06-29,4155,4171,4164,7,33574,33708,33652,56,168,10,10,23,3146,3146,3136,3136
San Benito,28,2022-06-29,233,233,233,0,1680,1685,1683,2,1,0,0,1,95,95,95,95
San Bernardino,28,2022-06-29,6212,6237,6229,8,47534,47724,47664,60,113,10,10,30,7917,7917,7907,7907
San Diego,28,2022-06-29,10988,11033,11027,6,78119,78430,78389,41,288,7,7,34,5382,5382,5375,5375
San Francisco,28,2022-06-29,3248,3261,3250,11,27791,27901,27805,96,97,9,9,18,934,934,925,925
San Joaquin,28,2022-06-29,1890,1898,1895,3,17245,17313,17281,32,38,2,2,6,2269,2269,2267,2267
San Luis Obispo,28,2022-06-29,663,664,663,1,5534,5555,5547,8,31,2,2,0,501,501,499,499
San Mateo,28,2022-06-29,2793,2804,2801,3,25669,25770,25740,30,48,1,1,2,715,715,714,714
Santa Barbara,28,2022-06-29,1151,1158,1156,2,9572,9612,9597,15,30,3,3,3,703,703,700,700
Santa Clara,28,2022-06-29,7662,7693,7689,4,59177,59413,59380,33,206,10,10,24,2372,2372,2362,2362
Santa Cruz,28,2022-06-29,860,863,862,1,9359,9396,9383,13,23,1,1,2,267,267,266,266
Shasta,28,2022-06-29,345,345,344,1,3277,3292,3287,5,22,0,0,3,572,572,572,572
Siskiyou,28,2022-06-29,59,59,59,0,365,366,365,1,5,0,0,0,85,85,85,85
Solano,28,2022-06-29,1584,1590,1588,2,11945,11992,11973,19,39,0,0,4,451,451,451,451
Sonoma,28,2022-06-29,1296,1302,1300,2,9769,9808,9793,15,35,2,2,1,504,504,502,502
Stanislaus,28,2022-06-29,1262,1268,1265,3,8619,8653,8632,21,107,2,2,9,1709,1709,1707,1707
Sutter,28,2022-06-29,218,218,218,0,1852,1858,1855,3,0,0,0,0,228,228,228,228
Tehama,28,2022-06-29,104,104,104,0,922,926,924,2,2,0,0,1,204,204,204,204
Trinity,28,2022-06-29,18,18,18,0,160,161,160,1,2,0,0,0,20,20,20,20
Tulare,28,2022-06-29,985,989,987,2,7742,7772,7753,19,33,0,0,2,1507,1507,1507,1507
Tuolumne,28,2022-06-29,178,178,178,0,1408,1413,1410,3,2,2,2,1,193,193,191,191
Ventura,28,2022-06-29,2133,2142,2140,2,18371,18444,18424,20,71,2,2,2,1512,1512,1510,1510
Yolo,28,2022-06-29,738,739,738,1,9942,9980,9966,14,7,1,1,1,327,327,326,326
Yuba,28,2022-06-29,180,180,180,0,1300,1305,1303,2,9,1,1,2,120,120,119,119
Alameda,29,2022-07-06,5168,5190,5185,5,40623,40804,40764,40,120,13,13,18,1941,1941,1928,1928
Amador,29,2022-07-06,74,74,74,0,1758,1765,1762,3,2,1,1,1,88,88,87,87
Butte,29,2022-07-06,356,357,357,0,2673,2685,2683,2,28,2,2,3,449,449,447,447
Calaveras,29,2022-07-06,77,77,77,0,507,507,506,1,1,2,2,0,128,128,126,126
Colusa,29,2022-07-06,25,25,25,0,263,265,264,1,4,0,0,0,22,22,22,22
Contra Costa,29,2022-07-06,3383,3397,3391,6,22691,22792,22755,37,87,12,12,8,1370,1370,1358,1358
Del Norte,29,2022-07-06,140,140,140,0,593,595,594,1,2,0,0,2,53,53,53,53
El Dorado,29,2022-07-06,329,329,329,0,2550,2563,2560,3,9,1,1,1,223,223,222,222
Fresno,29,2022-07-06,2784,2797,2793,4,17447,17523,17496,27,156,7,7,18,2798,2798,2791,2791
Glenn,29,2022-07-06,27,27,27,0,177,178,177,1,0,0,0,0,42,42,42,42
Humboldt,29,2022-07-06,242,242,242,0,1840,1847,1845,2,6,1,1,4,151,151,150,150
Imperial,29,2022-07-06,811,813,812,1,3556,3572,3567,5,19,0,0,1,948,948,948,948
Inyo,29,2022-07-06,42,42,42,0,347,348,347,1,0,0,0,0,56,56,56,56
Kern,29,2022-07-06,1981,1990,1988,2,14929,14995,14978,17,74,4,4,12,2367,2367,2363,2363
Kings,29,2022-07-06,548,550,549,1,3612,3628,3623,5,8,0,0,1,449,449,449,449
Lake,29,2022-07-06,113,113,113,0,864,867,866,1,1,1,1,0,141,141,140,140
Lassen,29,2022-07-06,34,34,34,0,660,662,661,1,4,0,0,0,62,62,62,62
Los Angeles,29,2022-07-06,35115,35271,35257,14,307118,308486,308368,118,886,89,89,103,32373,32373,32284,32284
Madera,29,2022-07-06,396,396,395,1,3242,3257,3252,5,9,0,0,1,368,368,368,368
Marin,29,2022-07-06,611,612,611,1,5348,5371,5363,8,24,2,2,2,305,305,303,303
Mariposa,29,2022-07-06,39,39,39,0,230,231,230,1,0,0,0,0,28,28,28,28
Mendocino,29,2022-07-06,187,187,187,0,1224,1229,1226,3,14,2,2,0,133,133,131,131
Merced,29,2022-07-06,635,637,636,1,3375,3390,3386,4,16,2,2,2,835,835,833,833
Modoc,29,2022-07-06,19,19,19,0,46,47,46,1,0,0,0,0,8,8,8,8
Mono,29,2022-07-06,19,19,19,0,85,86,85,1,3,0,0,0,7,7,7,7
Monterey,29,2022-07-06,921,925,923,2,6769,6800,6783,17,38,4,4,3,747,747,743,743
Napa,29,2022-07-06,319,319,319,0,2954,2966,2963,3,8,0,0,3,147,147,147,147
Nevada,29,2022-07-06,198,198,198,0,1448,1454,1452,2,8,0,0,1,131,131,131,131
Orange,29,2022-07-06,7574,7607,7600,7,54160,54401,54352,49,223,24,24,35,7206,7206,7182,7182
Placer,29,2022-07-06,810,813,812,1,5093,5115,5106,9,81,4,4,9,644,644,640,640
Plumas,29,2022-07-06,54,54,54,0,234,235,234,1,3,0,0,0,13,13,13,13
Riverside,29,2022-07-06,7149,7181,7172,9,41339,41523,41473,50,154,3,3,12,6426,6426,6423,6423
Sacramento,29,2022-07-06,3583,3598,3593,5,28914,29043,29005,38,160,18,18,24,3164,3164,3146,3146
San Benito,29,2022-07-06,206,206,206,0,1350,1355,1354,1,2,0,0,0,95,95,95,95
San Bernardino,29,2022-07-06,6764,6793,6786,7,44832,45031,44987,44,176,16,16,18,7933,7933,7917,7917
San Diego,29,2022-07-06,10807,10853,10849,4,71497,71815,71786,29,311,7,7,42,5389,5389,5382,5382
San Francisco,29,2022-07-06,2914,2926,2918,8,23971,24079,24014,65,101,11,11,24,945,945,934,934
San Joaquin,29,2022-07-06,1775,1784,1781,3,15793,15863,15840,23,44,8,8,4,2277,2277,2269,2269
San Luis Obispo,29,2022-07-06,728,731,730,1,4481,4501,4496,5,26,0,0,0,501,501,501,501
San Mateo,29,2022-07-06,2613,2624,2622,2,21385,21479,21460,19,42,2,2,2,717,717,715,715
Santa Barbara,29,2022-07-06,1146,1151,1150,1,8134,8171,8161,10,29,4,4,4,707,707,703,703
Santa Clara,29,2022-07-06,6907,6937,6934,3,51547,51775,51753,22,196,14,14,37,2386,2386,2372,2372
Santa Cruz,29,2022-07-06,803,807,806,1,7521,7555,7547,8,27,0,0,0,267,267,267,267
Shasta,29,2022-07-06,291,291,291,0,2756,2768,2764,4,20,5,5,3,577,577,572,572
Siskiyou,29,2022-07-06,45,45,45,0,321,322,321,1,1,0,0,1,85,85,85,85
Solano,29,2022-07-06,1343,1349,1347,2,10338,10382,10369,13,44,0,0,6,451,451,451,451
Sonoma,29,2022-07-06,1222,1227,1226,1,8712,8749,8739,10,40,2,2,0,506,506,504,504
Stanislaus,29,2022-07-06,1267,1274,1272,2,7413,7446,7432,14,102,7,7,17,1716,1716,1709,1709
Sutter,29,2022-07-06,243,243,243,0,1558,1563,1561,2,0,0,0,0,228,228,228,228
Tehama,29,2022-07-06,141,141,141,0,810,813,812,1,4,1,1,0,205,205,204,204
Trinity,29,2022-07-06,26,26,26,0,124,125,124,1,2,0,0,0,20,20,20,20
Tulare,29,2022-07-06,1054,1058,1056,2,7072,7103,7090,13,38,6,6,2,1513,1513,1507,1507
Tuolumne,29,2022-07-06,174,174,174,0,1019,1023,1021,2,3,0,0,0,193,193,193,193
Ventura,29,2022-07-06,2109,2118,2116,2,16446,16518,16504,14,65,2,2,3,1514,1514,1512,1512
Yolo,29,2022-07-06,475,475,474,1,5952,5977,5970,7,4,0,0,1,327,327,327,327
Yuba,29,2022-07-06,172,172,172,0,1182,1186,1185,1,11,0,0,1,120,120,120,120
Alameda,30,2022-07-13,5320,5347,5343,4,44620,44839,44805,34,130,4,4,22,1945,1945,1941,1941
Amador,30,2022-07-13,104,104,104,0,1412,1418,1416,2,1,0,0,0,88,88,88,88
Butte,30,2022-07-13,420,420,420,0,3001,3017,3015,2,32,1,1,2,450,450,449,449
Calaveras,30,2022-07-13,88,88,88,0,553,554,553,1,0,1,1,1,129,129,128,128
Colusa,30,2022-07-13,23,23,23,0,387,390,389,1,3,0,0,0,22,22,22,22
Contra Costa,30,2022-07-13,3325,3341,3337,4,23784,23900,23870,30,79,8,8,15,1378,1378,1370,1370
Del Norte,30,2022-07-13,193,193,193,0,705,709,708,1,6,0,0,1,53,53,53,53
El Dorado,30,2022-07-13,343,343,343,0,2785,2799,2796,3,6,2,2,4,225,225,223,223
Fresno,30,2022-07-13,3612,3630,3626,4,20730,20832,20807,25,172,8,8,18,2806,2806,2798,2798
Glenn,30,2022-07-13,34,34,34,0,352,354,353,1,0,0,0,0,42,42,42,42
Humboldt,30,2022-07-13,291,291,291,0,1992,2004,2002,2,13,1,1,3,152,152,151,151
Imperial,30,2022-07-13,1102,1107,1106,1,4630,4652,4647,5,21,3,3,0,951,951,948,948
Inyo,30,2022-07-13,32,32,32,0,332,335,334,1,0,1,1,0,57,57,56,56
Kern,30,2022-07-13,2232,2244,2242,2,15869,15946,15932,14,78,4,4,11,2371,2371,2367,2367
Kings,30,2022-07-13,710,714,713,1,4210,4232,4227,5,8,3,3,0,452,452,449,449
Lake,30,2022-07-13,128,128,128,0,981,986,985,1,0,0,0,1,141,141,141,141
Lassen,30,2022-07-13,60,60,60,0,758,761,760,1,1,1,1,0,63,63,62,62
Los Angeles,30,2022-07-13,41469,41671,41659,12,355783,357526,357419,107,1080,100,100,122,32473,32473,32373,32373
Madera,30,2022-07-13,524,525,524,1,3940,3958,3953,5,11,0,0,2,368,368,368,368
Marin,30,2022-07-13,548,548,547,1,5545,5573,5566,7,14,1,1,5,306,306,305,305
Mariposa,30,2022-07-13,51,51,51,0,253,254,253,1,0,0,0,0,28,28,28,28
Mendocino,30,2022-07-13,187,187,187,0,1346,1353,1351,2,4,0,0,1,133,133,133,133
Merced,30,2022-07-13,746,751,750,1,3986,4005,4001,4,18,5,5,1,840,840,835,835
Modoc,30,2022-07-13,20,20,20,0,44,45,44,1,0,0,0,0,8,8,8,8
Mono,30,2022-07-13,9,9,9,0,91,92,91,1,0,0,0,0,7,7,7,7
Monterey,30,2022-07-13,1038,1044,1042,2,7241,7276,7262,14,50,3,3,3,750,750,747,747
Napa,30,2022-07-13,364,364,364,0,3166,3182,3179,3,15,1,1,1,148,148,147,147
Nevada,30,2022-07-13,179,179,179,0,1510,1516,1514,2,11,0,0,2,131,131,131,131
Orange,30,2022-07-13,9343,9388,9381,7,61153,61453,61410,43,260,19,19,36,7225,7225,7206,7206
Placer,30,2022-07-13,722,727,726,1,5560,5588,5581,7,63,1,1,8,645,645,644,644
Plumas,30,2022-07-13,60,60,60,0,260,261,260,1,1,0,0,0,13,13,13,13
Riverside,30,2022-07-13,8801,8842,8834,8,48838,49077,49031,46,231,14,14,11,6440,6440,6426,6426
Sacramento,30,2022-07-13,3901,3919,3915,4,31621,31776,31744,32,176,17,17,24,3181,3181,3164,3164
San Benito,30,2022-07-13,227,227,227,0,1623,1631,1630,1,2,0,0,0,95,95,95,95
San Bernardino,30,2022-07-13,8187,8227,8221,6,54384,54650,54608,42,204,14,14,29,7947,7947,7933,7933
San Diego,30,2022-07-13,13434,13499,13495,4,81295,81693,81667,26,352,12,12,43,5401,5401,5389,5389
San Francisco,30,2022-07-13,2643,2656,2650,6,25317,25441,25388,53,110,8,8,21,953,953,945,945
San Joaquin,30,2022-07-13,2051,2062,2060,2,18303,18392,18371,21,53,4,4,13,2281,2281,2277,2277
San Luis Obispo,30,2022-07-13,593,596,595,1,4868,4891,4887,4,14,3,3,1,504,504,501,501
San Mateo,30,2022-07-13,2533,2545,2543,2,23480,23596,23579,17,40,3,3,4,720,720,717,717
Santa Barbara,30,2022-07-13,1301,1308,1307,1,9227,9272,9263,9,43,4,4,6,711,711,707,707
Santa Clara,30,2022-07-13,6730,6764,6762,2,55601,55873,55854,19,205,11,11,38,2397,2397,2386,2386
Santa Cruz,30,2022-07-13,940,945,944,1,8630,8672,8665,7,18,0,0,1,267,267,267,267
Shasta,30,2022-07-13,328,328,328,0,3180,3196,3193,3,25,3,3,6,580,580,577,577
Siskiyou,30,2022-07-13,44,44,44,0,348,349,348,1,4,1,1,0,86,86,85,85
Solano,30,2022-07-13,1399,1405,1404,1,10134,10184,10174,10,47,2,2,4,453,453,451,451
Sonoma,30,2022-07-13,1112,1118,1117,1,9104,9148,9140,8,39,0,0,6,506,506,506,506
Stanislaus,30,2022-07-13,1435,1442,1440,2,8457,8499,8486,13,107,7,7,10,1723,1723,1716,1716
Sutter,30,2022-07-13,276,276,276,0,1759,1768,1766,2,0,0,0,0,228,228,228,228
Tehama,30,2022-07-13,117,117,117,0,904,908,907,1,8,0,0,1,205,205,205,205
Trinity,30,2022-07-13,31,31,31,0,98,99,98,1,1,0,0,0,20,20,20,20
Tulare,30,2022-07-13,1288,1295,1293,2,8831,8875,8862,13,39,2,2,2,1515,1515,1513,1513
Tuolumne,30,2022-07-13,249,249,249,0,1119,1124,1123,1,8,0,0,0,193,193,193,193
Ventura,30,2022-07-13,2404,2416,2414,2,18988,19081,19069,12,92,6,6,5,1520,1520,1514,1514
Yolo,30,2022-07-13,456,456,456,0,4684,4708,4704,4,4,2,2,2,329,329,327,327
Yuba,30,2022-07-13,214,214,214,0,1340,1345,1344,1,11,0,0,1,120,120,120,120
Alameda,31,2022-07-20,4641,4666,4663,3,41949,42171,42146,25,132,11,11,19,1956,1956,1945,1945
Amador,31,2022-07-20,71,71,71,0,1232,1238,1237,1,3,0,0,0,88,88,88,88
Butte,31,2022-07-20,340,340,340,0,3008,3024,3023,1,30,0,0,1,450,450,450,450
Calaveras,31,2022-07-20,69,69,69,0,541,543,542,1,0,0,0,1,129,129,129,129
Colusa,31,2022-07-20,23,23,23,0,373,375,374,1,2,0,0,0,22,22,22,22
Contra Costa,31,2022-07-20,2981,2996,2993,3,22813,22934,22911,23,83,5,5,19,1383,1383,1378,1378
Del Norte,31,2022-07-20,108,108,108,0,620,623,622,1,6,0,0,2,53,53,53,53
El Dorado,31,2022-07-20,278,278,278,0,2576,2590,2588,2,8,1,1,1,226,226,225,225
Fresno,31,2022-07-20,3650,3670,3667,3,20799,20909,20889,20,185,10,10,19,2816,2816,2806,2806
Glenn,31,2022-07-20,37,37,37,0,276,278,277,1,1,0,0,0,42,42,42,42
Humboldt,31,2022-07-20,259,259,259,0,2017,2029,2027,2,12,1,1,4,153,153,152,152
Imperial,31,2022-07-20,987,992,991,1,4557,4581,4577,4,26,0,0,1,951,951,951,951
Inyo,31,2022-07-20,26,26,26,0,311,314,313,1,0,0,0,0,57,57,57,57
Kern,31,2022-07-20,2209,2222,2220,2,15785,15869,15858,11,87,7,7,13,2378,2378,2371,2371
Kings,31,2022-07-20,656,660,659,1,4123,4144,4141,3,13,1,1,1,453,453,452,452
Lake,31,2022-07-20,137,137,137,0,1013,1018,1017,1,4,0,0,1,141,141,141,141
Lassen,31,2022-07-20,69,69,69,0,1279,1285,1284,1,0,0,0,0,63,63,63,63
Los Angeles,31,2022-07-20,40506,40722,40712,10,350303,352160,352078,82,1187,110,111,142,32583,32584,32473,32473
Madera,31,2022-07-20,542,544,543,1,3612,3631,3628,3,9,0,0,2,368,368,368,368
Marin,31,2022-07-20,493,494,494,0,5405,5436,5431,5,22,0,0,4,306,306,306,306
Mariposa,31,2022-07-20,36,36,36,0,250,251,250,1,0,1,1,0,29,29,28,28
Mendocino,31,2022-07-20,166,166,166,0,1472,1480,1478,2,10,0,0,3,133,133,133,133
Merced,31,2022-07-20,740,744,743,1,3863,3883,3880,3,15,2,2,0,842,842,840,840
Modoc,31,2022-07-20,7,7,7,0,31,32,31,1,0,1,1,0,9,9,8,8
Mono,31,2022-07-20,12,12,12,0,82,83,82,1,1,0,0,0,7,7,7,7
Monterey,31,2022-07-20,975,981,980,1,7241,7280,7269,11,37,6,6,2,756,756,750,750
Napa,31,2022-07-20,299,299,299,0,3032,3048,3046,2,6,4,4,1,152,152,148,148
Nevada,31,2022-07-20,124,124,124,0,1340,1346,1345,1,5,1,1,0,132,132,131,131
Orange,31,2022-07-20,8547,8592,8587,5,59362,59677,59644,33,271,30,30,48,7255,7255,7225,7225
Placer,31,2022-07-20,636,638,637,1,5117,5143,5138,5,86,4,4,8,649,649,645,645
Plumas,31,2022-07-20,58,58,58,0,248,249,248,1,0,0,0,0,13,13,13,13
Riverside,31,2022-07-20,8122,8164,8158,6,47787,48039,48004,35,216,13,13,19,6453,6453,6440,6440
Sacramento,31,2022-07-20,3626,3645,3642,3,30372,30532,30508,24,193,16,16,26,3197,3197,3181,3181
San Benito,31,2022-07-20,198,198,198,0,1562,1571,1570,1,1,1,1,0,96,96,95,95
San Bernardino,31,2022-07-20,7620,7661,7656,5,51983,52259,52228,31,235,18,18,36,7965,7965,7947,7947
San Diego,31,2022-07-20,12757,12826,12823,3,78645,79062,79042,20,412,16,16,49,5417,5417,5401,5401
San Francisco,31,2022-07-20,2419,2432,2428,4,25097,25231,25190,41,114,9,9,30,962,962,953,953
San Joaquin,31,2022-07-20,1954,1966,1964,2,17161,17252,17237,15,71,4,4,12,2285,2285,2281,2281
San Luis Obispo,31,2022-07-20,552,555,555,0,4567,4591,4588,3,12,7,7,1,511,511,504,504
San Mateo,31,2022-07-20,2141,2152,2151,1,21912,22029,22017,12,40,0,0,9,720,720,720,720
Santa Barbara,31,2022-07-20,1281,1288,1287,1,9292,9341,9334,7,51,1,1,2,712,712,711,711
Santa Clara,31,2022-07-20,6082,6115,6113,2,52673,52953,52939,14,203,14,14,33,2411,2411,2397,2397
Santa Cruz,31,2022-07-20,858,862,861,1,7318,7356,7351,5,21,1,1,3,268,268,267,267
Shasta,31,2022-07-20,281,281,281,0,3168,3184,3182,2,41,2,2,6,582,582,580,580
Siskiyou,31,2022-07-20,41,41,41,0,332,333,332,1,3,1,1,0,87,87,86,86
Solano,31,2022-07-20,1256,1262,1261,1,9544,9594,9587,7,45,0,0,7,453,453,453,453
Sonoma,31,2022-07-20,1032,1038,1037,1,8668,8715,8709,6,36,0,0,4,506,506,506,506
Stanislaus,31,2022-07-20,1393,1400,1398,2,8205,8248,8239,9,120,7,7,10,1730,1730,1723,1723
Sutter,31,2022-07-20,239,239,239,0,1714,1723,1722,1,0,0,0,0,228,228,228,228
Tehama,31,2022-07-20,111,111,111,0,895,899,898,1,6,1,1,1,206,206,205,205
Trinity,31,2022-07-20,15,15,15,0,111,112,111,1,0,0,0,0,20,20,20,20
Tulare,31,2022-07-20,1176,1183,1182,1,8048,8090,8081,9,44,1,1,0,1516,1516,1515,1515
Tuolumne,31,2022-07-20,224,224,224,0,1170,1175,1174,1,4,0,0,0,193,193,193,193
Ventura,31,2022-07-20,2326,2338,2337,1,19283,19384,19374,10,82,5,5,8,1525,1525,1520,1520
Yolo,31,2022-07-20,427,427,427,0,4616,4641,4638,3,5,2,2,2,331,331,329,329
Yuba,31,2022-07-20,217,217,217,0,1319,1325,1324,1,16,0,0,0,120,120,120,120
Alameda,32,2022-07-27,4360,4387,4385,2,39674,39917,39899,18,154,12,12,22,1968,1968,1956,1956
Amador,32,2022-07-27,84,84,84,0,1163,1169,1168,1,4,1,1,0,89,89,88,88
Butte,32,2022-07-27,372,372,372,0,2814,2831,2830,1,27,1,1,2,451,451,450,450
Calaveras,32,2022-07-27,82,82,82,0,559,563,562,1,3,3,3,2,132,132,129,129
Colusa,32,2022-07-27,22,22,22,0,362,364,363,1,1,0,0,0,22,22,22,22
Contra Costa,32,2022-07-27,2826,2843,2841,2,21566,21698,21681,17,100,7,7,15,1390,1390,1383,1383
Del Norte,32,2022-07-27,67,67,67,0,528,532,531,1,5,0,0,0,53,53,53,53
El Dorado,32,2022-07-27,261,261,261,0,2475,2490,2488,2,7,3,3,0,229,229,226,226
Fresno,32,2022-07-27,3274,3295,3293,2,20161,20285,20270,15,204,8,8,33,2824,2824,2816,2816
Glenn,32,2022-07-27,34,34,34,0,267,269,268,1,0,0,0,0,42,42,42,42
Humboldt,32,2022-07-27,218,218,218,0,1891,1903,1902,1,17,1,1,5,154,154,153,153
Imperial,32,2022-07-27,812,818,817,1,4077,4102,4099,3,14,3,3,7,954,954,951,951
Inyo,32,2022-07-27,17,17,17,0,285,287,286,1,0,1,1,0,58,58,57,57
Kern,32,2022-07-27,1913,1925,1924,1,15496,15591,15583,8,102,3,3,14,2381,2381,2378,2378
Kings,32,2022-07-27,612,615,615,0,3911,3935,3932,3,7,1,1,0,454,454,453,453
Lake,32,2022-07-27,136,136,136,0,1049,1055,1054,1,3,1,1,1,142,142,141,141
Lassen,32,2022-07-27,50,50,50,0,1017,1023,1022,1,1,0,0,0,63,63,63,63
Los Angeles,32,2022-07-27,34642,34854,34848,6,320402,322374,322315,59,1092,128,133,147,32711,32717,32583,32584
Madera,32,2022-07-27,498,500,500,0,3883,3906,3903,3,8,0,0,5,368,368,368,368
Marin,32,2022-07-27,485,485,485,0,5560,5594,5590,4,31,2,2,2,308,308,306,306
Mariposa,32,2022-07-27,32,32,32,0,213,214,213,1,0,0,0,0,29,29,29,29
Mendocino,32,2022-07-27,196,196,196,0,1404,1413,1412,1,5,1,1,0,134,134,133,133
Merced,32,2022-07-27,701,706,706,0,3859,3881,3879,2,20,3,3,2,845,845,842,842
Modoc,32,2022-07-27,10,10,10,0,28,29,28,1,1,0,0,0,9,9,9,9
Mono,32,2022-07-27,14,14,14,0,81,82,81,1,0,0,0,0,7,7,7,7
Monterey,32,2022-07-27,910,917,916,1,6794,6835,6827,8,42,0,0,1,756,756,756,756
Napa,32,2022-07-27,279,279,279,0,2881,2900,2899,1,9,1,1,2,153,153,152,152
Nevada,32,2022-07-27,123,123,123,0,1408,1417,1416,1,5,0,0,1,132,132,132,132
Orange,32,2022-07-27,7561,7607,7604,3,56011,56356,56332,24,302,31,31,48,7286,7286,7255,7255
Placer,32,2022-07-27,630,634,633,1,5071,5101,5097,4,74,3,3,11,652,652,649,649
Plumas,32,2022-07-27,19,19,19,0,174,175,174,1,0,0,0,0,13,13,13,13
Riverside,32,2022-07-27,7019,7061,7057,4,44331,44603,44577,26,222,14,14,35,6467,6467,6453,6453
Sacramento,32,2022-07-27,3443,3464,3462,2,28858,29038,29020,18,169,14,14,33,3211,3211,3197,3197
San Benito,32,2022-07-27,174,174,174,0,979,985,984,1,1,1,1,0,97,97,96,96
San Bernardino,32,2022-07-27,6877,6921,6918,3,49969,50278,50255,23,210,24,24,20,7989,7989,7965,7965
San Diego,32,2022-07-27,10961,11028,11026,2,73864,74318,74304,14,403,15,15,47,5432,5432,5417,5417
San Francisco,32,2022-07-27,2109,2122,2119,3,23139,23282,23252,30,119,10,10,22,972,972,962,962
San Joaquin,32,2022-07-27,1796,1807,1806,1,16082,16181,16170,11,77,4,4,7,2289,2289,2285,2285
San Luis Obispo,32,2022-07-27,540,543,543,0,4140,4165,4163,2,16,2,2,1,513,513,511,511
San Mateo,32,2022-07-27,1979,1991,1990,1,21570,21704,21695,9,62,1,1,8,721,721,720,720
Santa Barbara,32,2022-07-27,1137,1144,1143,1,8169,8220,8215,5,31,2,2,3,714,714,712,712
Santa Clara,32,2022-07-27,5575,5611,5610,1,48271,48568,48558,10,233,13,13,35,2424,2424,2411,2411
Santa Cruz,32,2022-07-27,786,792,792,0,7548,7593,7589,4,18,1,1,0,269,269,268,268
Shasta,32,2022-07-27,310,310,310,0,3024,3044,3042,2,31,1,1,7,583,583,582,582
Siskiyou,32,2022-07-27,52,52,52,0,328,329,328,1,2,0,0,0,87,87,87,87
Solano,32,2022-07-27,1163,1170,1169,1,9436,9494,9489,5,45,0,0,8,453,453,453,453
Sonoma,32,2022-07-27,1035,1042,1041,1,8656,8708,8703,5,52,1,1,3,507,507,506,506
Stanislaus,32,2022-07-27,1320,1328,1327,1,8115,8165,8158,7,102,11,11,14,1741,1741,1730,1730
Sutter,32,2022-07-27,233,233,233,0,1665,1676,1675,1,0,1,1,0,229,229,228,228
Tehama,32,2022-07-27,102,102,102,0,888,893,892,1,5,2,2,0,208,208,206,206
Trinity,32,2022-07-27,10,10,10,0,88,89,88,1,1,0,0,0,20,20,20,20
Tulare,32,2022-07-27,1107,1114,1113,1,7838,7888,7881,7,44,1,1,1,1517,1517,1516,1516
Tuolumne,32,2022-07-27,177,177,177,0,1152,1158,1157,1,6,0,0,2,193,193,193,193
Ventura,32,2022-07-27,2042,2055,2054,1,17488,17597,17590,7,81,5,5,3,1530,1530,1525,1525
Yolo,32,2022-07-27,393,393,393,0,4404,4430,4428,2,4,2,2,1,333,333,331,331
Yuba,32,2022-07-27,162,162,162,0,1240,1246,1245,1,6,0,0,1,120,120,120,120
Alameda,33,2022-08-03,3639,3665,3664,1,35618,35875,35862,13,172,5,5,23,1973,1973,1968,1968
Amador,33,2022-08-03,47,47,47,0,974,980,979,1,4,0,0,1,89,89,89,89
Butte,33,2022-08-03,328,329,329,0,2656,2676,2675,1,31,1,1,1,452,452,451,451
Calaveras,33,2022-08-03,65,65,65,0,611,617,616,1,2,1,1,0,133,133,132,132
Colusa,33,2022-08-03,31,31,31,0,364,367,366,1,5,0,0,0,22,22,22,22
Contra Costa,33,2022-08-03,2437,2455,2454,1,20152,20297,20285,12,101,10,10,16,1400,1400,1390,1390
Del Norte,33,2022-08-03,47,47,47,0,485,489,488,1,3,0,0,0,53,53,53,53
El Dorado,33,2022-08-03,212,212,212,0,2382,2401,2400,1,3,1,1,1,230,230,229,229
Fresno,33,2022-08-03,2721,2740,2738,2,17826,17955,17945,10,211,5,5,12,2829,2829,2824,2824
Glenn,33,2022-08-03,28,28,28,0,237,239,238,1,2,0,0,0,42,42,42,42
Humboldt,33,2022-08-03,226,226,226,0,1930,1944,1943,1,12,0,0,4,154,154,154,154
Imperial,33,2022-08-03,593,598,598,0,3429,3454,3452,2,17,2,2,2,956,956,954,954
Inyo,33,2022-08-03,22,22,22,0,280,283,282,1,0,0,0,0,58,58,58,58
Kern,33,2022-08-03,1550,1562,1561,1,14324,14427,14421,6,70,6,6,16,2387,2387,2381,2381
Kings,33,2022-08-03,547,552,552,0,3726,3753,3751,2,8,0,0,0,454,454,454,454
Lake,33,2022-08-03,115,115,115,0,947,953,952,1,4,0,0,1,142,142,142,142
Lassen,33,2022-08-03,115,116,116,0,1055,1063,1062,1,0,0,0,0,63,63,63,63
Los Angeles,33,2022-08-03,28481,28686,28682,4,301134,303304,303261,43,1124,135,142,130,32846,32859,32711,32717
Madera,33,2022-08-03,460,464,464,0,3210,3234,3232,2,9,0,0,10,368,368,368,368
Marin,33,2022-08-03,382,383,383,0,4915,4951,4948,3,26,0,0,3,308,308,308,308
Mariposa,33,2022-08-03,25,25,25,0,224,225,224,1,0,0,0,0,29,29,29,29
Mendocino,33,2022-08-03,166,166,166,0,1204,1212,1211,1,5,0,0,1,134,134,134,134
Merced,33,2022-08-03,614,619,619,0,3514,3539,3537,2,21,4,4,3,849,849,845,845
Modoc,33,2022-08-03,9,9,9,0,30,31,30,1,1,0,0,0,9,9,9,9
Mono,33,2022-08-03,6,6,6,0,75,76,75,1,0,0,0,0,7,7,7,7
Monterey,33,2022-08-03,894,901,900,1,6223,6268,6262,6,32,3,3,0,759,759,756,756
Napa,33,2022-08-03,287,287,287,0,2727,2747,2746,1,11,1,1,0,154,154,153,153
Nevada,33,2022-08-03,115,115,115,0,1338,1346,1345,1,9,0,0,1,132,132,132,132
Orange,33,2022-08-03,5935,5978,5976,2,50628,50993,50976,17,222,33,33,36,7319,7319,7286,7286
Placer,33,2022-08-03,538,543,543,0,4562,4594,4591,3,63,0,0,9,652,652,652,652
Plumas,33,2022-08-03,24,24,24,0,193,194,193,1,0,0,0,0,13,13,13,13
Riverside,33,2022-08-03,5924,5968,5965,3,41178,41475,41456,19,186,6,6,25,6473,6473,6467,6467
Sacramento,33,2022-08-03,2884,2904,2903,1,27256,27453,27440,13,183,17,17,29,3228,3228,3211,3211
San Benito,33,2022-08-03,156,156,156,0,670,676,675,1,0,1,1,0,98,98,97,97
San Bernardino,33,2022-08-03,5661,5701,5699,2,46159,46491,46474,17,183,24,24,23,8013,8013,7989,7989
San Diego,33,2022-08-03,8492,8554,8553,1,66371,66850,66840,10,373,11,11,47,5443,5443,5432,5432
San Francisco,33,2022-08-03,1698,1711,1709,2,21170,21322,21301,21,106,12,12,21,984,984,972,972
San Joaquin,33,2022-08-03,1639,1652,1651,1,15834,15947,15939,8,69,7,7,8,2296,2296,2289,2289
San Luis Obispo,33,2022-08-03,573,578,578,0,3877,3903,3901,2,22,1,1,2,514,514,513,513
San Mateo,33,2022-08-03,1645,1657,1656,1,19303,19441,19435,6,75,0,0,6,721,721,721,721
Santa Barbara,33,2022-08-03,1073,1081,1081,0,7902,7959,7955,4,42,1,1,2,715,715,714,714
Santa Clara,33,2022-08-03,4469,4501,4500,1,42272,42577,42570,7,242,17,17,33,2441,2441,2424,2424
Santa Cruz,33,2022-08-03,716,722,722,0,6295,6340,6338,2,29,0,0,2,269,269,269,269
Shasta,33,2022-08-03,205,205,205,0,2998,3021,3020,1,31,0,0,8,583,583,583,583
Siskiyou,33,2022-08-03,58,58,58,0,311,312,311,1,1,1,1,0,88,88,87,87
Solano,33,2022-08-03,1057,1063,1063,0,8746,8810,8806,4,40,0,0,8,453,453,453,453
Sonoma,33,2022-08-03,949,956,956,0,7992,8050,8046,4,40,4,4,5,511,511,507,507
Stanislaus,33,2022-08-03,1149,1157,1156,1,7180,7232,7227,5,98,2,2,10,1743,1743,1741,1741
Sutter,33,2022-08-03,245,245,245,0,1630,1642,1641,1,0,2,2,0,231,231,229,229
Tehama,33,2022-08-03,79,79,79,0,718,724,723,1,2,0,0,0,208,208,208,208
Trinity,33,2022-08-03,9,9,9,0,75,76,75,1,0,0,0,0,20,20,20,20
Tulare,33,2022-08-03,978,985,984,1,7353,7406,7401,5,50,2,2,3,1519,1519,1517,1517
Tuolumne,33,2022-08-03,141,141,141,0,1087,1094,1093,1,6,0,0,1,193,193,193,193
Ventura,33,2022-08-03,1686,1698,1697,1,16705,16827,16822,5,71,7,7,12,1537,1537,1530,1530
Yolo,33,2022-08-03,315,315,315,0,3998,4027,4025,2,5,2,2,4,335,335,333,333
Yuba,33,2022-08-03,148,148,148,0,1139,1148,1147,1,7,0,0,3,120,120,120,120
Alameda,34,2022-08-10,2961,2987,2986,1,34658,34948,34938,10,141,11,11,17,1984,1984,1973,1973
Amador,34,2022-08-10,49,49,49,0,821,828,827,1,4,0,0,0,89,89,89,89
Butte,34,2022-08-10,326,327,327,0,2465,2486,2485,1,25,1,1,1,453,453,452,452
Calaveras,34,2022-08-10,51,51,51,0,558,564,563,1,2,0,0,0,133,133,133,133
Colusa,34,2022-08-10,11,11,11,0,405,409,408,1,0,0,0,0,22,22,22,22
Contra Costa,34,2022-08-10,2075,2092,2091,1,19494,19656,19647,9,89,5,5,12,1405,1405,1400,1400
Del Norte,34,2022-08-10,58,58,58,0,495,500,499,1,3,1,1,0,54,54,53,53
El Dorado,34,2022-08-10,191,191,191,0,2306,2326,2325,1,7,0,0,2,230,230,230,230
Fresno,34,2022-08-10,2187,2205,2204,1,17214,17359,17351,8,143,8,8,38,2837,2837,2829,2829
Glenn,34,2022-08-10,18,18,18,0,252,254,253,1,0,0,0,0,42,42,42,42
Humboldt,34,2022-08-10,196,196,196,0,1830,1846,1845,1,16,1,1,2,155,155,154,154
Imperial,34,2022-08-10,472,478,478,0,3158,3184,3183,1,16,2,2,3,958,958,956,956
Inyo,34,2022-08-10,3,3,3,0,254,257,256,1,0,1,1,0,59,59,58,58
Kern,34,2022-08-10,1282,1293,1293,0,13282,13393,13389,4,62,8,8,13,2395,2395,2387,2387
Kings,34,2022-08-10,419,424,424,0,3232,3259,3258,1,14,0,0,2,454,454,454,454
Lake,34,2022-08-10,105,105,105,0,936,944,943,1,1,0,0,1,142,142,142,142
Lassen,34,2022-08-10,128,128,128,0,1013,1023,1022,1,1,0,0,0,63,63,63,63
Los Angeles,34,2022-08-10,23472,23667,23664,3,285285,287679,287647,32,973,114,120,125,32960,32979,32846,32859
Madera,34,2022-08-10,339,339,339,0,3005,3031,3030,1,19,0,0,3,368,368,368,368
Marin,34,2022-08-10,353,353,353,0,4241,4275,4273,2,24,2,2,4,310,310,308,308
Mariposa,34,2022-08-10,25,25,25,0,209,210,209,1,0,0,0,0,29,29,29,29
Mendocino,34,2022-08-10,106,106,106,0,1055,1065,1064,1,3,1,1,3,135,135,134,134
Merced,34,2022-08-10,473,478,478,0,3421,3451,3450,1,11,1,1,6,850,850,849,849
Modoc,34,2022-08-10,3,3,3,0,21,22,21,1,1,0,0,0,9,9,9,9
Mono,34,2022-08-10,7,7,7,0,82,83,82,1,0,0,0,0,7,7,7,7
Monterey,34,2022-08-10,678,684,684,0,5617,5664,5660,4,33,0,0,0,759,759,759,759
Napa,34,2022-08-10,229,229,229,0,2515,2536,2535,1,12,1,1,2,155,155,154,154
Nevada,34,2022-08-10,91,91,91,0,1219,1230,1229,1,2,0,0,0,132,132,132,132
Orange,34,2022-08-10,5078,5120,5119,1,46042,46428,46416,12,243,31,31,46,7350,7350,7319,7319
Placer,34,2022-08-10,474,479,479,0,4509,4546,4544,2,67,3,3,12,655,655,652,652
Plumas,34,2022-08-10,22,22,22,0,180,181,180,1,0,0,0,0,13,13,13,13
Riverside,34,2022-08-10,5123,5167,5165,2,38990,39317,39303,14,184,8,8,13,6481,6481,6473,6473
Sacramento,34,2022-08-10,2578,2598,2597,1,26108,26327,26317,10,162,15,15,20,3243,3243,3228,3228
San Benito,34,2022-08-10,160,160,160,0,694,702,701,1,1,1,1,1,99,99,98,98
San Bernardino,34,2022-08-10,4752,4793,4792,1,44114,44484,44472,12,166,19,19,23,8032,8032,8013,8013
San Diego,34,2022-08-10,6685,6741,6740,1,61243,61756,61749,7,290,9,9,36,5452,5452,5443,5443
San Francisco,34,2022-08-10,1443,1455,1454,1,19739,19906,19891,15,109,13,13,13,997,997,984,984
San Joaquin,34,2022-08-10,1475,1488,1487,1,15277,15405,15399,6,53,6,6,9,2302,2302,2296,2296
San Luis Obispo,34,2022-08-10,436,441,441,0,3579,3611,3610,1,13,2,2,2,516,516,514,514
San Mateo,34,2022-08-10,1363,1374,1374,0,17379,17525,17520,5,59,0,0,4,721,721,721,721
Santa Barbara,34,2022-08-10,905,913,913,0,7242,7302,7299,3,40,2,2,4,717,717,715,715
Santa Clara,34,2022-08-10,3869,3902,3902,0,38652,38976,38971,5,198,10,10,31,2451,2451,2441,2441
Santa Cruz,34,2022-08-10,572,578,578,0,5951,6001,5999,2,24,1,1,0,270,270,269,269
Shasta,34,2022-08-10,193,193,193,0,2823,2847,2846,1,24,2,2,0,585,585,583,583
Siskiyou,34,2022-08-10,35,35,35,0,289,291,290,1,1,0,0,0,88,88,88,88
Solano,34,2022-08-10,754,760,760,0,7424,7486,7483,3,51,0,0,8,453,453,453,453
Sonoma,34,2022-08-10,704,711,711,0,7531,7594,7591,3,38,4,4,3,515,515,511,511
Stanislaus,34,2022-08-10,966,974,973,1,7321,7383,7379,4,87,7,7,9,1750,1750,1743,1743
Sutter,34,2022-08-10,200,200,200,0,1567,1581,1580,1,0,1,1,0,232,232,231,231
Tehama,34,2022-08-10,72,72,72,0,665,671,670,1,1,0,0,1,208,208,208,208
Trinity,34,2022-08-10,6,6,6,0,60,61,60,1,0,0,0,0,20,20,20,20
Tulare,34,2022-08-10,820,827,827,0,7156,7215,7211,4,35,5,5,5,1524,1524,1519,1519
Tuolumne,34,2022-08-10,105,105,105,0,1042,1052,1051,1,2,0,0,0,193,193,193,193
Ventura,34,2022-08-10,1459,1471,1471,0,15699,15831,15827,4,80,6,6,8,1543,1543,1537,1537
Yolo,34,2022-08-10,279,279,279,0,3759,3789,3788,1,8,0,0,2,335,335,335,335
Yuba,34,2022-08-10,133,133,133,0,1097,1106,1105,1,8,0,0,0,120,120,120,120
Alameda,35,2022-08-17,2427,2451,2450,1,33311,33640,33633,7,102,9,9,22,1993,1993,1984,1984
Amador,35,2022-08-17,56,56,56,0,903,913,912,1,4,0,0,1,89,89,89,89
Butte,35,2022-08-17,219,220,220,0,2191,2212,2211,1,17,0,0,2,453,453,453,453
Calaveras,35,2022-08-17,43,43,43,0,525,531,530,1,0,0,0,0,133,133,133,133
Colusa,35,2022-08-17,17,17,17,0,350,354,353,1,0,0,0,0,22,22,22,22
Contra Costa,35,2022-08-17,1629,1645,1644,1,18997,19183,19176,7,57,6,6,8,1411,1411,1405,1405
Del Norte,35,2022-08-17,34,34,34,0,488,493,492,1,2,0,0,0,54,54,54,54
El Dorado,35,2022-08-17,169,169,169,0,2306,2329,2328,1,7,0,0,2,230,230,230,230
Fresno,35,2022-08-17,1710,1726,1725,1,15945,16102,16096,6,173,5,5,15,2842,2842,2837,2837
Glenn,35,2022-08-17,17,17,17,0,226,228,227,1,2,0,0,0,42,42,42,42
Humboldt,35,2022-08-17,161,161,161,0,1598,1614,1613,1,9,1,1,2,156,156,155,155
Imperial,35,2022-08-17,336,339,339,0,3083,3114,3113,1,15,0,0,0,958,958,958,958
Inyo,35,2022-08-17,16,16,16,0,268,271,270,1,1,0,0,0,59,59,59,59
Kern,35,2022-08-17,1049,1060,1060,0,13366,13498,13495,3,57,5,5,19,2400,2400,2395,2395
Kings,35,2022-08-17,326,329,329,0,3254,3286,3285,1,7,0,0,1,454,454,454,454
Lake,35,2022-08-17,89,89,89,0,988,998,997,1,3,1,1,0,143,143,142,142
Lassen,35,2022-08-17,54,54,54,0,821,830,829,1,0,0,0,0,63,63,63,63
Los Angeles,35,2022-08-17,19992,20189,20187,2,279442,282195,282171,24,887,109,116,109,33069,33095,32960,32979
Madera,35,2022-08-17,300,303,303,0,2887,2915,2914,1,13,1,1,3,369,369,368,368
Marin,35,2022-08-17,262,262,262,0,4017,4056,4055,1,14,0,0,3,310,310,310,310
Mariposa,35,2022-08-17,6,6,6,0,185,186,185,1,0,0,0,0,29,29,29,29
Mendocino,35,2022-08-17,102,102,102,0,1030,1042,1041,1,5,0,0,2,135,135,135,135
Merced,35,2022-08-17,442,446,446,0,3534,3570,3569,1,10,3,3,3,853,853,850,850
Modoc,35,2022-08-17,7,7,7,0,27,28,27,1,0,0,0,0,9,9,9,9
Mono,35,2022-08-17,6,6,6,0,62,63,62,1,0,0,0,0,7,7,7,7
Monterey,35,2022-08-17,636,643,643,0,6048,6109,6106,3,38,0,0,0,759,759,759,759
Napa,35,2022-08-17,191,191,191,0,2129,2150,2149,1,9,1,1,1,156,156,155,155
Nevada,35,2022-08-17,96,96,96,0,1177,1191,1190,1,3,0,0,1,132,132,132,132
Orange,35,2022-08-17,4261,4303,4302,1,41488,41896,41888,8,255,23,23,42,7373,7373,7350,7350
Placer,35,2022-08-17,403,408,408,0,4372,4415,4413,2,62,1,1,13,656,656,655,655
Plumas,35,2022-08-17,15,15,15,0,158,160,159,1,1,0,0,0,13,13,13,13
Riverside,35,2022-08-17,4479,4523,4522,1,37242,37609,37599,10,142,12,12,24,6493,6493,6481,6481
Sacramento,35,2022-08-17,2254,2276,2275,1,24649,24891,24884,7,155,15,15,22,3258,3258,3243,3243
San Benito,35,2022-08-17,119,119,119,0,618,624,623,1,4,1,1,0,100,100,99,99
San Bernardino,35,2022-08-17,4670,4717,4716,1,42883,43306,43297,9,163,16,16,22,8048,8048,8032,8032
San Diego,35,2022-08-17,5159,5210,5210,0,58233,58806,58801,5,265,12,12,36,5464,5464,5452,5452
San Francisco,35,2022-08-17,1103,1113,1112,1,18954,19140,19128,12,117,15,15,9,1012,1012,997,997
San Joaquin,35,2022-08-17,1373,1386,1386,0,15239,15388,15383,5,60,5,5,12,2307,2307,2302,2302
San Luis Obispo,35,2022-08-17,270,271,271,0,3154,3186,3185,1,15,3,3,1,519,519,516,516
San Mateo,35,2022-08-17,1161,1173,1173,0,16996,17164,17161,3,46,0,0,4,721,721,721,721
Santa Barbara,35,2022-08-17,756,763,763,0,7137,7207,7205,2,41,2,2,4,719,719,717,717
Santa Clara,35,2022-08-17,3180,3211,3211,0,39282,39670,39666,4,170,7,7,30,2458,2458,2451,2451
Santa Cruz,35,2022-08-17,474,480,480,0,8697,8783,8781,2,19,3,3,2,273,273,270,270
Shasta,35,2022-08-17,188,188,188,0,2726,2754,2753,1,14,0,0,2,585,585,585,585
Siskiyou,35,2022-08-17,27,27,27,0,263,265,264,1,3,0,0,1,88,88,88,88
Solano,35,2022-08-17,587,593,593,0,7253,7324,7322,2,49,0,0,10,453,453,453,453
Sonoma,35,2022-08-17,597,604,604,0,7232,7304,7302,2,37,2,2,3,517,517,515,515
Stanislaus,35,2022-08-17,939,947,947,0,7581,7655,7652,3,104,10,10,9,1760,1760,1750,1750
Sutter,35,2022-08-17,185,185,185,0,1626,1643,1642,1,0,0,0,0,232,232,232,232
Tehama,35,2022-08-17,50,50,50,0,626,633,632,1,2,0,0,0,208,208,208,208
Trinity,35,2022-08-17,12,12,12,0,61,62,61,1,0,0,0,0,20,20,20,20
Tulare,35,2022-08-17,679,687,687,0,7231,7303,7300,3,30,1,1,3,1525,1525,1524,1524
Tuolumne,35,2022-08-17,106,106,106,0,998,1010,1009,1,1,0,0,0,193,193,193,193
Ventura,35,2022-08-17,1476,1491,1491,0,15156,15305,15302,3,65,3,3,5,1546,1546,1543,1543
Yolo,35,2022-08-17,218,218,218,0,3466,3500,3499,1,4,0,0,0,335,335,335,335
Yuba,35,2022-08-17,127,127,127,0,1084,1097,1096,1,10,0,0,2,120,120,120,120
Alameda,36,2022-08-24,2157,2181,2181,0,33117,33489,33483,6,97,11,11,14,2004,2004,1993,1993
Amador,36,2022-08-24,40,40,40,0,797,807,806,1,1,2,2,1,91,91,89,89
Butte,36,2022-08-24,243,245,245,0,2103,2129,2128,1,22,0,0,2,453,453,453,453
Calaveras,36,2022-08-24,53,53,53,0,591,599,598,1,0,0,0,0,133,133,133,133
Colusa,36,2022-08-24,17,17,17,0,392,396,395,1,0,0,0,0,22,22,22,22
Contra Costa,36,2022-08-24,1437,1453,1453,0,18598,18808,18803,5,48,5,5,7,1416,1416,1411,1411
Del Norte,36,2022-08-24,27,27,27,0,478,484,483,1,1,1,1,0,55,55,54,54
El Dorado,36,2022-08-24,141,141,141,0,2069,2092,2091,1,3,1,1,0,231,231,230,230
Fresno,36,2022-08-24,1502,1519,1519,0,16120,16302,16298,4,156,6,6,12,2848,2848,2842,2842
Glenn,36,2022-08-24,22,22,22,0,213,215,214,1,1,0,0,0,42,42,42,42
Humboldt,36,2022-08-24,131,131,131,0,1748,1768,1767,1,4,0,0,2,156,156,156,156
Imperial,36,2022-08-24,304,306,306,0,2787,2819,2818,1,8,1,1,5,959,959,958,958
Inyo,36,2022-08-24,6,6,6,0,203,206,205,1,0,0,0,0,59,59,59,59
Kern,36,2022-08-24,921,932,932,0,13883,14039,14036,3,54,5,5,6,2405,2405,2400,2400
Kings,36,2022-08-24,353,357,357,0,3772,3815,3814,1,8,1,1,0,455,455,454,454
Lake,36,2022-08-24,108,108,108,0,904,916,915,1,1,1,1,0,144,144,143,143
Lassen,36,2022-08-24,28,28,28,0,811,822,821,1,0,0,0,0,63,63,63,63
Los Angeles,36,2022-08-24,17321,17517,17516,1,274150,277234,277215,19,767,105,114,96,33174,33209,33069,33095
Madera,36,2022-08-24,279,283,283,0,2694,2724,2723,1,3,1,1,0,370,370,369,369
Marin,36,2022-08-24,229,230,230,0,3873,3917,3916,1,18,0,0,2,310,310,310,310
Mariposa,36,2022-08-24,19,19,19,0,189,191,190,1,0,0,0,0,29,29,29,29
Mendocino,36,2022-08-24,121,121,121,0,1133,1148,1147,1,3,0,0,1,135,135,135,135
Merced,36,2022-08-24,421,426,426,0,3531,3571,3570,1,13,3,3,1,856,856,853,853
Modoc,36,2022-08-24,2,2,2,0,21,22,21,1,0,0,0,0,9,9,9,9
Mono,36,2022-08-24,2,2,2,0,57,58,57,1,0,0,0,0,7,7,7,7
Monterey,36,2022-08-24,493,500,500,0,5672,5737,5735,2,6,2,2,20,761,761,759,759
Napa,36,2022-08-24,127,127,127,0,2003,2028,2027,1,5,0,0,1,156,156,156,156
Nevada,36,2022-08-24,83,83,83,0,1194,1209,1208,1,5,0,0,0,132,132,132,132
Orange,36,2022-08-24,3481,3520,3519,1,40146,40597,40591,6,182,21,21,28,7394,7394,7373,7373
Placer,36,2022-08-24,385,391,391,0,4292,4340,4339,1,60,1,1,12,657,657,656,656
Plumas,36,2022-08-24,21,21,21,0,184,186,185,1,0,0,0,0,13,13,13,13
Riverside,36,2022-08-24,4162,4209,4208,1,36888,37303,37295,8,110,12,12,22,6505,6505,6493,6493
Sacramento,36,2022-08-24,2010,2033,2033,0,24704,24981,24975,6,128,10,10,26,3268,3268,3258,3258
San Benito,36,2022-08-24,117,117,117,0,637,645,644,1,2,0,0,1,100,100,100,100
San Bernardino,36,2022-08-24,4350,4400,4399,1,42382,42860,42853,7,136,15,15,16,8063,8063,8048,8048
San Diego,36,2022-08-24,4431,4481,4481,0,57838,58490,58486,4,242,5,5,24,5469,5469,5464,5464
San Francisco,36,2022-08-24,1039,1051,1051,0,17915,18117,18108,9,82,11,11,8,1023,1023,1012,1012
San Joaquin,36,2022-08-24,1092,1105,1105,0,14778,14944,14940,4,36,2,2,8,2309,2309,2307,2307
San Luis Obispo,36,2022-08-24,271,275,275,0,3200,3235,3234,1,20,0,0,0,519,519,519,519
San Mateo,36,2022-08-24,903,913,913,0,16443,16629,16626,3,29,0,0,1,721,721,721,721
Santa Barbara,36,2022-08-24,709,716,716,0,7745,7832,7830,2,37,0,0,1,719,719,719,719
Santa Clara,36,2022-08-24,2801,2832,2832,0,39099,39537,39534,3,171,7,7,29,2465,2465,2458,2458
Santa Cruz,36,2022-08-24,501,507,507,0,13251,13399,13397,2,11,0,0,0,273,273,273,273
Shasta,36,2022-08-24,155,155,155,0,2746,2776,2775,1,14,2,2,2,587,587,585,585
Siskiyou,36,2022-08-24,22,22,22,0,258,261,260,1,3,1,1,0,89,89,88,88
Solano,36,2022-08-24,521,528,528,0,7291,7374,7372,2,41,0,0,8,453,453,453,453
Sonoma,36,2022-08-24,562,569,569,0,7144,7224,7223,1,30,0,0,3,517,517,517,517
Stanislaus,36,2022-08-24,891,901,901,0,7868,7958,7955,3,77,6,6,15,1766,1766,1760,1760
Sutter,36,2022-08-24,186,186,186,0,1579,1598,1597,1,0,0,0,0,232,232,232,232
Tehama,36,2022-08-24,52,52,52,0,654,661,660,1,1,0,0,0,208,208,208,208
Trinity,36,2022-08-24,8,8,8,0,63,64,63,1,0,0,0,0,20,20,20,20
Tulare,36,2022-08-24,731,738,738,0,7172,7254,7252,2,37,2,2,1,1527,1527,1525,1525
Tuolumne,36,2022-08-24,119,119,119,0,1013,1026,1025,1,1,0,0,0,193,193,193,193
Ventura,36,2022-08-24,1144,1157,1157,0,14682,14847,14845,2,69,3,3,5,1549,1549,1546,1546
Yolo,36,2022-08-24,209,209,209,0,3584,3623,3622,1,10,1,1,1,336,336,335,335
Yuba,36,2022-08-24,132,132,132,0,1114,1127,1126,1,10,0,0,2,120,120,120,120
Alameda,37,2022-08-31,1841,1864,1864,0,33714,34142,34137,5,94,11,11,21,2015,2015,2004,2004
Amador,37,2022-08-31,55,55,55,0,816,828,827,1,2,0,0,1,91,91,91,91
Butte,37,2022-08-31,233,235,235,0,2380,2411,2410,1,21,0,0,3,453,453,453,453
Calaveras,37,2022-08-31,43,43,43,0,580,588,587,1,1,0,0,0,133,133,133,133
Colusa,37,2022-08-31,5,5,5,0,288,293,292,1,1,0,0,0,22,22,22,22
Contra Costa,37,2022-08-31,1228,1243,1243,0,18514,18748,18744,4,48,4,4,9,1420,1420,1416,1416
Del Norte,37,2022-08-31,24,24,24,0,391,397,396,1,5,0,0,1,55,55,55,55
El Dorado,37,2022-08-31,130,130,130,0,1928,1953,1952,1,1,0,0,1,231,231,231,231
Fresno,37,2022-08-31,1332,1349,1349,0,15388,15583,15580,3,156,3,3,17,2851,2851,2848,2848
Glenn,37,2022-08-31,17,17,17,0,230,232,231,1,3,0,0,0,42,42,42,42
Humboldt,37,2022-08-31,132,132,132,0,1597,1619,1618,1,5,0,0,0,156,156,156,156
Imperial,37,2022-08-31,263,266,266,0,3015,3054,3053,1,13,1,1,4,960,960,959,959
Inyo,37,2022-08-31,6,6,6,0,173,176,175,1,0,0,0,0,59,59,59,59
Kern,37,2022-08-31,821,832,832,0,13357,13527,13525,2,64,1,1,6,2406,2406,2405,2405
Kings,37,2022-08-31,336,341,341,0,3429,3472,3471,1,7,0,0,0,455,455,455,455
Lake,37,2022-08-31,68,68,68,0,846,859,858,1,5,2,2,0,146,146,144,144
Lassen,37,2022-08-31,31,31,31,0,782,793,792,1,0,0,0,0,63,63,63,63
Los Angeles,37,2022-08-31,14037,14215,14214,1,270143,273576,273562,14,674,78,86,90,33252,33295,33174,33209
Madera,37,2022-08-31,283,286,286,0,3155,3195,3194,1,12,0,0,6,370,370,370,370
Marin,37,2022-08-31,213,213,213,0,3910,3959,3958,1,15,2,2,1,312,312,310,310
Mariposa,37,2022-08-31,18,18,18,0,195,197,196,1,0,0,0,0,29,29,29,29
Mendocino,37,2022-08-31,70,70,70,0,966,980,979,1,2,1,1,1,136,136,135,135
Merced,37,2022-08-31,351,357,357,0,3366,3408,3407,1,11,3,3,0,859,859,856,856
Modoc,37,2022-08-31,2,2,2,0,30,31,30,1,0,0,0,0,9,9,9,9
Mono,37,2022-08-31,5,5,5,0,50,51,50,1,0,0,0,0,7,7,7,7
Monterey,37,2022-08-31,331,335,335,0,5232,5297,5295,2,30,2,2,4,763,763,761,761
Napa,37,2022-08-31,121,121,121,0,2272,2302,2301,1,7,0,0,1,156,156,156,156
Nevada,37,2022-08-31,117,117,117,0,1185,1201,1200,1,5,0,0,0,132,132,132,132
Orange,37,2022-08-31,2709,2743,2743,0,38694,39185,39180,5,168,19,19,40,7413,7413,7394,7394
Placer,37,2022-08-31,302,306,306,0,4146,4198,4197,1,59,1,1,11,658,658,657,657
Plumas,37,2022-08-31,13,13,13,0,159,161,160,1,0,0,0,0,13,13,13,13
Riverside,37,2022-08-31,3375,3416,3415,1,35838,36292,36286,6,127,8,8,16,6513,6513,6505,6505
Sacramento,37,2022-08-31,1653,1674,1674,0,23621,23920,23916,4,141,13,13,18,3281,3281,3268,3268
San Benito,37,2022-08-31,99,99,99,0,670,680,679,1,0,0,0,1,100,100,100,100
San Bernardino,37,2022-08-31,3300,3341,3341,0,40346,40857,40852,5,140,16,17,23,8079,8080,8063,8063
San Diego,37,2022-08-31,3777,3825,3825,0,56002,56713,56710,3,241,15,15,28,5484,5484,5469,5469
San Francisco,37,2022-08-31,780,790,790,0,18439,18672,18665,7,61,9,9,11,1032,1032,1023,1023
San Joaquin,37,2022-08-31,946,959,959,0,13399,13569,13566,3,43,6,6,9,2315,2315,2309,2309
San Luis Obispo,37,2022-08-31,284,286,286,0,3244,3286,3285,1,12,3,3,0,522,522,519,519
San Mateo,37,2022-08-31,786,795,795,0,15812,16013,16011,2,25,0,0,3,721,721,721,721
Santa Barbara,37,2022-08-31,589,597,597,0,7590,7687,7686,1,30,2,2,3,721,721,719,719
Santa Clara,37,2022-08-31,2209,2237,2237,0,38067,38551,38549,2,155,7,7,20,2472,2472,2465,2465
Santa Cruz,37,2022-08-31,363,368,368,0,12582,12741,12739,2,9,0,0,1,273,273,273,273
Shasta,37,2022-08-31,127,127,127,0,2551,2584,2583,1,15,1,1,0,588,588,587,587
Siskiyou,37,2022-08-31,32,32,32,0,235,238,237,1,2,1,1,1,90,90,89,89
Solano,37,2022-08-31,526,532,532,0,7404,7498,7497,1,34,1,1,8,454,454,453,453
Sonoma,37,2022-08-31,465,472,472,0,7327,7419,7418,1,35,0,0,2,517,517,517,517
Stanislaus,37,2022-08-31,781,792,792,0,7969,8070,8068,2,80,6,6,6,1772,1772,1766,1766
Sutter,37,2022-08-31,161,161,161,0,1651,1673,1672,1,0,0,0,0,232,232,232,232
Tehama,37,2022-08-31,65,65,65,0,766,777,776,1,4,0,0,0,208,208,208,208
Trinity,37,2022-08-31,4,4,4,0,53,54,53,1,0,0,0,0,20,20,20,20
Tulare,37,2022-08-31,597,604,604,0,7072,7163,7161,2,39,0,0,2,1527,1527,1527,1527
Tuolumne,37,2022-08-31,82,82,82,0,866,877,876,1,1,0,0,0,193,193,193,193
Ventura,37,2022-08-31,976,988,988,0,14718,14904,14902,2,54,7,7,5,1556,1556,1549,1549
Yolo,37,2022-08-31,183,184,184,0,3305,3347,3346,1,4,3,3,3,339,339,336,336
Yuba,37,2022-08-31,118,118,118,0,1190,1206,1205,1,9,0,0,0,120,120,120,120
Alameda,38,2022-09-07,1408,1428,1428,0,28071,28477,28474,3,93,0,0,18,2015,2015,2015,2015
Amador,38,2022-09-07,26,26,26,0,756,768,767,1,5,0,0,1,91,91,91,91
Butte,38,2022-09-07,190,191,191,0,2183,2215,2214,1,17,2,2,3,455,455,453,453
Calaveras,38,2022-09-07,22,22,22,0,452,460,459,1,0,0,0,0,133,133,133,133
Colusa,38,2022-09-07,16,16,16,0,250,254,253,1,2,0,0,0,22,22,22,22
Contra Costa,38,2022-09-07,964,979,979,0,15842,16071,16068,3,52,4,4,11,1424,1424,1420,1420
Del Norte,38,2022-09-07,18,18,18,0,463,471,470,1,1,0,0,1,55,55,55,55
El Dorado,38,2022-09-07,92,92,92,0,1658,1682,1681,1,1,0,0,1,231,231,231,231
Fresno,38,2022-09-07,1022,1036,1036,0,13361,13555,13553,2,165,12,12,13,2863,2863,2851,2851
Glenn,38,2022-09-07,13,13,13,0,186,188,187,1,1,0,0,0,42,42,42,42
Humboldt,38,2022-09-07,94,94,94,0,1403,1424,1423,1,5,1,1,0,157,157,156,156
Imperial,38,2022-09-07,247,250,250,0,2776,2817,2816,1,13,0,0,1,960,960,960,960
Inyo,38,2022-09-07,14,14,14,0,184,188,187,1,0,0,0,0,59,59,59,59
Kern,38,2022-09-07,642,651,651,0,11062,11222,11221,1,43,3,3,13,2409,2409,2406,2406
Kings,38,2022-09-07,197,199,199,0,2761,2802,2801,1,7,0,0,1,455,455,455,455
Lake,38,2022-09-07,48,48,48,0,757,770,769,1,5,0,0,0,146,146,146,146
Lassen,38,2022-09-07,21,21,21,0,804,817,816,1,0,0,0,0,63,63,63,63
Los Angeles,38,2022-09-07,10393,10545,10545,0,237411,240863,240853,10,679,98,111,101,33350,33406,33252,33295
Madera,38,2022-09-07,213,216,216,0,2483,2520,2519,1,11,0,0,5,370,370,370,370
Marin,38,2022-09-07,179,179,179,0,3681,3735,3734,1,16,0,0,2,312,312,312,312
Mariposa,38,2022-09-07,12,12,12,0,178,180,179,1,0,0,0,0,29,29,29,29
Mendocino,38,2022-09-07,54,54,54,0,876,889,888,1,4,0,0,2,136,136,136,136
Merced,38,2022-09-07,235,237,237,0,2763,2803,2802,1,12,2,2,3,861,861,859,859
Modoc,38,2022-09-07,4,4,4,0,19,20,19,1,0,0,0,0,9,9,9,9
Mono,38,2022-09-07,3,3,3,0,58,59,58,1,0,0,0,0,7,7,7,7
Monterey,38,2022-09-07,251,255,255,0,4478,4544,4543,1,29,2,2,0,765,765,763,763
Napa,38,2022-09-07,106,106,106,0,1859,1887,1886,1,6,1,1,1,157,157,156,156
Nevada,38,2022-09-07,62,62,62,0,978,993,992,1,2,0,0,0,132,132,132,132
Orange,38,2022-09-07,2098,2129,2129,0,32349,32818,32815,3,176,16,18,28,7429,7431,7413,7413
Placer,38,2022-09-07,256,261,261,0,3499,3551,3550,1,40,0,0,4,658,658,658,658
Plumas,38,2022-09-07,12,12,12,0,150,152,151,1,0,0,0,0,13,13,13,13
Riverside,38,2022-09-07,2364,2399,2399,0,28930,29350,29346,4,126,5,5,14,6518,6518,6513,6513
Sacramento,38,2022-09-07,1268,1286,1286,0,20344,20638,20635,3,141,10,10,27,3291,3291,3281,3281
San Benito,38,2022-09-07,79,79,79,0,521,530,529,1,1,0,0,2,100,100,100,100
San Bernardino,38,2022-09-07,1969,1998,1998,0,33272,33754,33751,3,116,13,14,22,8092,8094,8079,8080
San Diego,38,2022-09-07,2769,2809,2809,0,48638,49342,49340,2,207,5,5,31,5489,5489,5484,5484
San Francisco,38,2022-09-07,738,749,749,0,15214,15435,15431,4,69,8,8,10,1040,1040,1032,1032
San Joaquin,38,2022-09-07,755,765,765,0,12462,12642,12640,2,31,5,5,9,2320,2320,2315,2315
San Luis Obispo,38,2022-09-07,193,195,195,0,2802,2844,2843,1,12,2,2,1,524,524,522,522
San Mateo,38,2022-09-07,613,622,622,0,12840,13027,13026,1,23,0,0,1,721,721,721,721
Santa Barbara,38,2022-09-07,427,434,434,0,6891,6992,6991,1,32,1,1,6,722,722,721,721
Santa Clara,38,2022-09-07,1786,1812,1812,0,32306,32775,32774,1,142,7,7,28,2479,2479,2472,2472
Santa Cruz,38,2022-09-07,301,305,305,0,10405,10554,10553,1,13,0,0,0,273,273,273,273
Shasta,38,2022-09-07,137,138,138,0,2220,2253,2252,1,20,0,0,1,588,588,588,588
Siskiyou,38,2022-09-07,27,27,27,0,239,243,242,1,4,0,0,1,90,90,90,90
Solano,38,2022-09-07,357,361,361,0,5955,6040,6039,1,27,1,1,5,455,455,454,454
Sonoma,38,2022-09-07,351,355,355,0,6070,6158,6157,1,41,2,2,2,519,519,517,517
Stanislaus,38,2022-09-07,483,490,490,0,6704,6801,6800,1,79,4,4,4,1776,1776,1772,1772
Sutter,38,2022-09-07,118,118,118,0,1447,1470,1469,1,0,0,0,0,232,232,232,232
Tehama,38,2022-09-07,51,51,51,0,632,641,640,1,2,0,0,0,208,208,208,208
Trinity,38,2022-09-07,3,3,3,0,54,55,54,1,0,0,0,0,20,20,20,20
Tulare,38,2022-09-07,390,396,396,0,5468,5547,5546,1,37,2,2,1,1529,1529,1527,1527
Tuolumne,38,2022-09-07,67,67,67,0,733,745,744,1,1,0,0,1,193,193,193,193
Ventura,38,2022-09-07,860,872,872,0,12928,13116,13115,1,61,5,5,3,1561,1561,1556,1556
Yolo,38,2022-09-07,130,130,130,0,2645,2684,2683,1,1,1,1,2,340,340,339,339
Yuba,38,2022-09-07,100,100,100,0,999,1015,1014,1,7,0,0,0,120,120,120,120
Alameda,39,2022-09-14,1457,1482,1482,0,29650,30146,30144,2,85,5,6,16,2020,2021,2015,2015
Amador,39,2022-09-14,38,38,38,0,837,853,852,1,3,2,2,1,93,93,91,91
Butte,39,2022-09-14,156,157,157,0,2435,2476,2475,1,21,0,0,1,455,455,455,455
Calaveras,39,2022-09-14,16,16,16,0,474,485,484,1,0,0,0,0,133,133,133,133
Colusa,39,2022-09-14,10,10,10,0,399,406,405,1,2,0,0,0,22,22,22,22
Contra Costa,39,2022-09-14,870,884,884,0,16457,16733,16731,2,65,6,6,8,1430,1430,1424,1424
Del Norte,39,2022-09-14,27,27,27,0,521,532,531,1,2,0,0,1,55,55,55,55
El Dorado,39,2022-09-14,91,91,91,0,1708,1738,1737,1,5,0,0,2,231,231,231,231
Fresno,39,2022-09-14,749,761,761,0,13976,14210,14208,2,129,6,7,11,2869,2870,2863,2863
Glenn,39,2022-09-14,16,16,16,0,203,206,205,1,3,0,0,0,42,42,42,42
Humboldt,39,2022-09-14,103,103,103,0,1566,1595,1594,1,7,0,0,3,157,157,157,157
Imperial,39,2022-09-14,198,200,200,0,3056,3110,3109,1,16,0,0,3,960,960,960,960
Inyo,39,2022-09-14,13,13,13,0,169,172,171,1,0,1,1,0,60,60,59,59
Kern,39,2022-09-14,575,585,585,0,12340,12547,12546,1,51,7,8,7,2416,2417,2409,2409
Kings,39,2022-09-14,184,187,187,0,2838,2886,2885,1,6,2,2,0,457,457,455,455
Lake,39,2022-09-14,50,50,50,0,834,850,849,1,3,0,0,0,146,146,146,146
Lassen,39,2022-09-14,8,8,8,0,732,747,746,1,0,0,0,0,63,63,63,63
Los Angeles,39,2022-09-14,9479,9636,9636,0,253056,257298,257290,8,593,64,75,84,33414,33481,33350,33406
Madera,39,2022-09-14,163,165,165,0,2875,2923,2922,1,16,0,0,3,370,370,370,370
Marin,39,2022-09-14,149,149,149,0,3572,3634,3633,1,15,2,2,2,314,314,312,312
Mariposa,39,2022-09-14,13,13,13,0,194,198,197,1,0,0,0,0,29,29,29,29
Mendocino,39,2022-09-14,38,38,38,0,915,932,931,1,1,0,0,0,136,136,136,136
Merced,39,2022-09-14,194,197,197,0,2945,2995,2994,1,6,4,4,1,865,865,861,861
Modoc,39,2022-09-14,0,0,0,0,20,21,20,1,0,0,0,0,9,9,9,9
Mono,39,2022-09-14,9,9,9,0,70,71,70,1,0,0,0,0,7,7,7,7
Monterey,39,2022-09-14,183,184,184,0,4516,4592,4591,1,13,1,1,1,766,766,765,765
Napa,39,2022-09-14,114,114,114,0,1925,1958,1957,1,5,0,0,0,157,157,157,157
Nevada,39,2022-09-14,61,61,61,0,1102,1121,1120,1,3,0,0,0,132,132,132,132
Orange,39,2022-09-14,1810,1840,1840,0,33993,34563,34560,3,129,17,20,21,7446,7451,7429,7431
Placer,39,2022-09-14,206,209,209,0,3908,3973,3972,1,56,1,1,7,659,659,658,658
Plumas,39,2022-09-14,20,20,20,0,167,170,169,1,0,0,0,0,13,13,13,13
Riverside,39,2022-09-14,1748,1777,1777,0,29325,29816,29813,3,112,5,5,6,6523,6523,6518,6518
Sacramento,39,2022-09-14,1111,1129,1129,0,21529,21889,21887,2,113,11,13,17,3302,3304,3291,3291
San Benito,39,2022-09-14,70,70,70,0,538,548,547,1,1,0,0,0,100,100,100,100
San Bernardino,39,2022-09-14,1765,1794,1794,0,33328,33886,33883,3,99,7,7,25,8099,8101,8092,8094
San Diego,39,2022-09-14,2784,2830,2830,0,53653,54552,54550,2,181,8,8,26,5497,5497,5489,5489
San Francisco,39,2022-09-14,705,717,717,0,16079,16346,16342,4,52,9,10,10,1049,1050,1040,1040
San Joaquin,39,2022-09-14,575,585,585,0,12902,13117,13115,2,27,8,9,3,2328,2329,2320,2320
San Luis Obispo,39,2022-09-14,139,140,140,0,2904,2952,2951,1,12,0,0,1,524,524,524,524
San Mateo,39,2022-09-14,597,607,607,0,13232,13453,13452,1,23,0,0,1,721,721,721,721
Santa Barbara,39,2022-09-14,267,273,273,0,6814,6929,6928,1,23,1,1,2,723,723,722,722
Santa Clara,39,2022-09-14,1736,1764,1764,0,35071,35657,35656,1,137,4,4,28,2483,2483,2479,2479
Santa Cruz,39,2022-09-14,184,186,186,0,12552,12761,12760,1,10,0,0,0,273,273,273,273
Shasta,39,2022-09-14,138,138,138,0,2224,2263,2262,1,24,1,1,3,589,589,588,588
Siskiyou,39,2022-09-14,26,26,26,0,275,282,281,1,3,1,1,1,91,91,90,90
Solano,39,2022-09-14,359,365,365,0,6262,6367,6366,1,24,0,0,5,455,455,455,455
Sonoma,39,2022-09-14,360,365,365,0,6574,6682,6681,1,28,2,2,3,521,521,519,519
Stanislaus,39,2022-09-14,383,389,389,0,7070,7188,7187,1,63,2,2,4,1778,1778,1776,1776
Sutter,39,2022-09-14,89,89,89,0,1486,1512,1511,1,0,0,0,0,232,232,232,232
Tehama,39,2022-09-14,46,46,46,0,634,646,645,1,2,0,0,0,208,208,208,208
Trinity,39,2022-09-14,3,3,3,0,74,75,74,1,0,0,0,0,20,20,20,20
Tulare,39,2022-09-14,288,293,293,0,6575,6686,6685,1,37,4,4,1,1533,1533,1529,1529
Tuolumne,39,2022-09-14,44,44,44,0,787,801,800,1,1,0,0,0,193,193,193,193
Ventura,39,2022-09-14,697,709,709,0,13587,13814,13813,1,49,2,2,5,1563,1563,1561,1561
Yolo,39,2022-09-14,129,129,129,0,3491,3550,3549,1,3,0,0,3,340,340,340,340
Yuba,39,2022-09-14,72,72,72,0,1109,1129,1128,1,5,0,0,0,120,120,120,120
Alameda,40,2022-09-21,1136,1158,1158,0,27852,28408,28406,2,73,5,5,9,2025,2026,2020,2021
Amador,40,2022-09-21,31,31,31,0,749,765,764,1,1,1,1,1,94,94,93,93
Butte,40,2022-09-21,100,100,100,0,1870,1908,1907,1,21,0,0,3,455,455,455,455
Calaveras,40,2022-09-21,28,28,28,0,403,412,411,1,3,0,0,0,133,133,133,133
Colusa,40,2022-09-21,12,12,12,0,296,302,301,1,2,0,0,0,22,22,22,22
Contra Costa,40,2022-09-21,768,784,784,0,16495,16824,16822,2,48,8,9,6,1438,1439,1430,1430
Del Norte,40,2022-09-21,22,22,22,0,481,493,492,1,2,0,0,0,55,55,55,55
El Dorado,40,2022-09-21,67,67,67,0,1570,1603,1602,1,1,0,0,1,231,231,231,231
Fresno,40,2022-09-21,532,544,544,0,12687,12941,12940,1,106,11,13,6,2880,2883,2869,2870
Glenn,40,2022-09-21,11,11,11,0,199,203,202,1,5,0,0,0,42,42,42,42
Humboldt,40,2022-09-21,96,96,96,0,1406,1436,1435,1,8,0,0,2,157,157,157,157
Imperial,40,2022-09-21,142,142,142,0,2782,2840,2839,1,5,0,0,2,960,960,960,960
Inyo,40,2022-09-21,6,6,6,0,185,189,188,1,0,0,0,0,60,60,60,60
Kern,40,2022-09-21,383,390,390,0,11097,11320,11319,1,32,2,2,12,2418,2419,2416,2417
Kings,40,2022-09-21,120,121,121,0,2635,2689,2688,1,3,2,2,0,459,459,457,457
Lake,40,2022-09-21,30,30,30,0,844,862,861,1,0,1,1,1,147,147,146,146
Lassen,40,2022-09-21,14,14,14,0,621,635,634,1,0,0,0,0,63,63,63,63
Los Angeles,40,2022-09-21,7996,8155,8155,0,248525,253511,253505,6,474,57,71,77,33471,33552,33414,33481
Madera,40,2022-09-21,117,119,119,0,2621,2674,2673,1,6,1,1,3,371,371,370,370
Marin,40,2022-09-21,154,156,156,0,3771,3848,3847,1,5,0,0,0,314,314,314,314
Mariposa,40,2022-09-21,5,5,5,0,171,177,176,1,0,0,0,0,29,29,29,29
Mendocino,40,2022-09-21,34,34,34,0,943,962,961,1,2,0,0,0,136,136,136,136
Merced,40,2022-09-21,141,143,143,0,2785,2842,2841,1,8,1,1,1,866,866,865,865
Modoc,40,2022-09-21,2,2,2,0,14,15,14,1,0,0,0,0,9,9,9,9
Mono,40,2022-09-21,0,0,0,0,69,70,69,1,0,0,0,0,7,7,7,7
Monterey,40,2022-09-21,150,152,152,0,4168,4252,4251,1,16,1,1,3,767,767,766,766
Napa,40,2022-09-21,80,80,80,0,1769,1805,1804,1,1,0,0,0,157,157,157,157
Nevada,40,2022-09-21,52,52,52,0,1129,1153,1152,1,2,0,0,0,132,132,132,132
Orange,40,2022-09-21,1671,1704,1704,0,32435,33085,33083,2,103,21,26,21,7467,7477,7446,7451
Placer,40,2022-09-21,203,208,208,0,3638,3711,3710,1,48,0,0,5,659,659,659,659
Plumas,40,2022-09-21,20,20,20,0,181,186,185,1,1,0,0,0,13,13,13,13
Riverside,40,2022-09-21,1330,1356,1356,0,27146,27689,27687,2,76,2,2,15,6525,6525,6523,6523
Sacramento,40,2022-09-21,959,978,978,0,20315,20721,20719,2,101,12,14,17,3314,3318,3302,3304
San Benito,40,2022-09-21,49,49,49,0,514,525,524,1,0,0,0,1,100,100,100,100
San Bernardino,40,2022-09-21,1310,1337,1337,0,28941,29521,29519,2,65,7,8,21,8106,8109,8099,8101
San Diego,40,2022-09-21,2488,2539,2539,0,55118,56223,56222,1,159,8,9,21,5505,5506,5497,5497
San Francisco,40,2022-09-21,625,638,638,0,15840,16155,16152,3,49,5,6,11,1054,1056,1049,1050
San Joaquin,40,2022-09-21,423,431,431,0,11796,12032,12031,1,27,3,3,2,2331,2332,2328,2329
San Luis Obispo,40,2022-09-21,125,125,125,0,2563,2615,2614,1,6,0,0,0,524,524,524,524
San Mateo,40,2022-09-21,576,587,587,0,13344,13611,13610,1,28,0,0,0,721,721,721,721
Santa Barbara,40,2022-09-21,246,252,252,0,6568,6699,6698,1,27,1,1,0,724,724,723,723
Santa Clara,40,2022-09-21,1358,1386,1386,0,36206,36931,36930,1,120,10,11,17,2493,2494,2483,2483
Santa Cruz,40,2022-09-21,146,148,148,0,12680,12935,12934,1,10,0,0,1,273,273,273,273
Shasta,40,2022-09-21,80,80,80,0,1940,1980,1979,1,19,0,0,3,589,589,589,589
Siskiyou,40,2022-09-21,21,21,21,0,205,210,209,1,4,0,0,1,91,91,91,91
Solano,40,2022-09-21,252,257,257,0,5936,6055,6054,1,26,0,0,5,455,455,455,455
Sonoma,40,2022-09-21,316,323,323,0,6340,6468,6467,1,27,1,1,1,522,522,521,521
Stanislaus,40,2022-09-21,307,313,313,0,5892,6010,6009,1,43,3,3,6,1781,1781,1778,1778
Sutter,40,2022-09-21,72,72,72,0,1199,1222,1221,1,0,0,0,0,232,232,232,232
Tehama,40,2022-09-21,27,27,27,0,537,550,549,1,1,0,0,0,208,208,208,208
Trinity,40,2022-09-21,1,1,1,0,40,41,40,1,0,0,0,0,20,20,20,20
Tulare,40,2022-09-21,185,188,188,0,5105,5209,5208,1,23,0,0,1,1533,1533,1533,1533
Tuolumne,40,2022-09-21,54,54,54,0,706,722,721,1,1,0,0,0,193,193,193,193
Ventura,40,2022-09-21,567,579,579,0,12776,13031,13030,1,35,2,2,5,1565,1565,1563,1563
Yolo,40,2022-09-21,88,88,88,0,3823,3902,3901,1,5,3,4,2,343,344,340,340
Yuba,40,2022-09-21,51,51,51,0,960,979,978,1,4,0,0,0,120,120,120,120
Alameda,41,2022-09-28,1146,1176,1176,0,27180,27876,27875,1,65,2,3,8,2027,2029,2025,2026
Amador,41,2022-09-28,18,18,18,0,701,721,720,1,0,0,0,0,94,94,94,94
Butte,41,2022-09-28,81,82,82,0,1718,1764,1763,1,19,0,0,2,455,455,455,455
Calaveras,41,2022-09-28,16,16,16,0,364,374,373,1,1,2,2,0,135,135,133,133
Colusa,41,2022-09-28,8,8,8,0,275,282,281,1,2,0,0,0,22,22,22,22
Contra Costa,41,2022-09-28,760,781,781,0,16071,16482,16481,1,32,3,4,10,1441,1443,1438,1439
Del Norte,41,2022-09-28,14,14,14,0,443,455,454,1,2,0,0,0,55,55,55,55
El Dorado,41,2022-09-28,83,83,83,0,1511,1551,1550,1,5,0,0,0,231,231,231,231
Fresno,41,2022-09-28,482,495,495,0,11622,11921,11920,1,86,6,9,7,2886,2892,2880,2883
Glenn,41,2022-09-28,6,6,6,0,172,177,176,1,5,0,0,0,42,42,42,42
Humboldt,41,2022-09-28,88,88,88,0,1290,1323,1322,1,3,2,2,0,159,159,157,157
Imperial,41,2022-09-28,115,117,117,0,2495,2560,2559,1,7,1,2,0,961,962,960,960
Inyo,41,2022-09-28,5,5,5,0,163,167,166,1,0,0,0,0,60,60,60,60
Kern,41,2022-09-28,326,336,336,0,10112,10372,10371,1,31,2,2,6,2420,2421,2418,2419
Kings,41,2022-09-28,97,97,97,0,2419,2483,2482,1,3,0,0,0,459,459,459,459
Lake,41,2022-09-28,24,24,24,0,793,815,814,1,0,0,0,1,147,147,147,147
Lassen,41,2022-09-28,7,7,7,0,564,579,578,1,0,0,0,0,63,63,63,63
Los Angeles,41,2022-09-28,7351,7539,7539,0,230962,236904,236899,5,441,26,36,58,33497,33588,33471,33552
Madera,41,2022-09-28,76,77,77,0,1805,1851,1850,1,10,0,0,3,371,371,371,371
Marin,41,2022-09-28,175,180,180,0,3655,3750,3749,1,9,0,0,0,314,314,314,314
Mariposa,41,2022-09-28,5,5,5,0,139,144,143,1,0,0,0,0,29,29,29,29
Mendocino,41,2022-09-28,40,40,40,0,800,822,821,1,3,0,0,0,136,136,136,136
Merced,41,2022-09-28,108,109,109,0,2797,2870,2869,1,12,1,1,0,867,867,866,866
Modoc,41,2022-09-28,2,2,2,0,10,11,10,1,1,0,0,0,9,9,9,9
Mono,41,2022-09-28,4,4,4,0,61,62,61,1,0,0,0,0,7,7,7,7
Monterey,41,2022-09-28,117,119,119,0,3934,4037,4036,1,13,0,0,1,767,767,767,767
Napa,41,2022-09-28,95,95,95,0,1915,1964,1963,1,2,0,0,1,157,157,157,157
Nevada,41,2022-09-28,52,52,52,0,1003,1029,1028,1,3,0,0,0,132,132,132,132
Orange,41,2022-09-28,1586,1627,1627,0,29602,30361,30360,1,125,36,51,22,7503,7528,7467,7477
Placer,41,2022-09-28,206,213,213,0,3356,3442,3441,1,41,2,3,6,661,662,659,659
Plumas,41,2022-09-28,20,20,20,0,145,149,148,1,0,0,0,0,13,13,13,13
Riverside,41,2022-09-28,1226,1258,1258,0,23309,23903,23902,1,63,5,6,11,6530,6531,6525,6525
Sacramento,41,2022-09-28,867,890,890,0,18470,18945,18944,1,94,12,18,17,3326,3336,3314,3318
San Benito,41,2022-09-28,38,38,38,0,475,489,488,1,0,1,1,0,101,101,100,100
San Bernardino,41,2022-09-28,1197,1227,1227,0,25151,25797,25796,1,78,1,1,20,8107,8110,8106,8109
San Diego,41,2022-09-28,2428,2489,2489,0,48026,49258,49257,1,182,8,11,19,5513,5517,5505,5506
San Francisco,41,2022-09-28,656,673,673,0,15164,15550,15548,2,42,2,2,6,1056,1058,1054,1056
San Joaquin,41,2022-09-28,362,372,372,0,10014,10270,10269,1,30,3,4,3,2334,2336,2331,2332
San Luis Obispo,41,2022-09-28,149,152,152,0,2483,2548,2547,1,4,0,0,1,524,524,524,524
San Mateo,41,2022-09-28,555,569,569,0,12102,12413,12412,1,22,0,0,0,721,721,721,721
Santa Barbara,41,2022-09-28,253,260,260,0,6278,6441,6440,1,20,2,3,1,726,727,724,724
Santa Clara,41,2022-09-28,1392,1427,1427,0,33692,34555,34554,1,115,8,12,16,2501,2506,2493,2494
Santa Cruz,41,2022-09-28,235,240,240,0,11825,12124,12123,1,8,1,1,0,274,274,273,273
Shasta,41,2022-09-28,57,57,57,0,1565,1606,1605,1,12,0,0,3,589,589,589,589
Siskiyou,41,2022-09-28,13,13,13,0,182,189,188,1,1,1,1,1,92,92,91,91
Solano,41,2022-09-28,298,305,305,0,5573,5718,5717,1,26,1,1,2,456,456,455,455
Sonoma,41,2022-09-28,298,306,306,0,6077,6233,6232,1,28,3,4,0,525,526,522,522
Stanislaus,41,2022-09-28,226,233,233,0,5626,5769,5768,1,44,0,0,5,1781,1781,1781,1781
Sutter,41,2022-09-28,74,74,74,0,1177,1208,1207,1,0,0,0,0,232,232,232,232
Tehama,41,2022-09-28,31,31,31,0,584,601,600,1,1,0,0,0,208,208,208,208
Trinity,41,2022-09-28,3,3,3,0,44,45,44,1,0,0,0,0,20,20,20,20
Tulare,41,2022-09-28,179,183,183,0,4952,5081,5080,1,18,4,5,2,1537,1538,1533,1533
Tuolumne,41,2022-09-28,36,36,36,0,678,697,696,1,0,0,0,0,193,193,193,193
Ventura,41,2022-09-28,520,533,533,0,10937,11216,11215,1,39,2,2,4,1567,1567,1565,1565
Yolo,41,2022-09-28,145,148,148,0,3530,3621,3620,1,6,1,1,2,344,345,343,344
Yuba,41,2022-09-28,35,35,35,0,882,907,906,1,9,0,0,0,120,120,120,120
Alameda,42,2022-10-05,1064,1102,1102,0,24352,25223,25222,1,49,1,2,8,2028,2031,2027,2029
Amador,42,2022-10-05,13,13,13,0,666,693,692,1,0,0,0,1,94,94,94,94
Butte,42,2022-10-05,68,70,70,0,1735,1800,1799,1,12,1,2,1,456,457,455,455
Calaveras,42,2022-10-05,14,14,14,0,324,336,335,1,0,0,0,0,135,135,135,135
Colusa,42,2022-10-05,4,4,4,0,102,108,107,1,0,0,0,0,22,22,22,22
Contra Costa,42,2022-10-05,640,663,663,0,14930,15466,15465,1,32,2,4,5,1443,1447,1441,1443
Del Norte,42,2022-10-05,13,13,13,0,372,387,386,1,1,0,0,1,55,55,55,55
El Dorado,42,2022-10-05,51,51,51,0,1326,1374,1373,1,5,0,0,0,231,231,231,231
Fresno,42,2022-10-05,452,468,468,0,10805,11195,11194,1,70,1,2,6,2887,2894,2886,2892
Glenn,42,2022-10-05,6,6,6,0,145,151,150,1,1,0,0,0,42,42,42,42
Humboldt,42,2022-10-05,79,82,82,0,1146,1189,1188,1,5,1,2,1,160,161,159,159
Imperial,42,2022-10-05,146,151,151,0,2507,2599,2598,1,9,0,0,0,961,962,961,962
Inyo,42,2022-10-05,5,5,5,0,111,115,114,1,0,0,0,0,60,60,60,60
Kern,42,2022-10-05,261,271,271,0,10119,10488,10487,1,20,0,0,8,2420,2421,2420,2421
Kings,42,2022-10-05,81,83,83,0,2395,2483,2482,1,1,0,0,0,459,459,459,459
Lake,42,2022-10-05,31,31,31,0,706,732,731,1,1,0,0,0,147,147,147,147
Lassen,42,2022-10-05,8,8,8,0,483,500,499,1,1,0,0,0,63,63,63,63
Los Angeles,42,2022-10-05,6170,6389,6389,0,197924,205071,205068,3,450,21,42,66,33518,33630,33497,33588
Madera,42,2022-10-05,52,53,53,0,1405,1457,1456,1,6,0,0,2,371,371,371,371
Marin,42,2022-10-05,178,185,185,0,3204,3320,3319,1,6,0,0,1,314,314,314,314
Mariposa,42,2022-10-05,3,3,3,0,135,141,140,1,0,0,0,0,29,29,29,29
Mendocino,42,2022-10-05,34,34,34,0,800,830,829,1,1,0,0,0,136,136,136,136
Merced,42,2022-10-05,101,103,103,0,2485,2577,2576,1,10,2,3,2,869,870,867,867
Modoc,42,2022-10-05,2,2,2,0,17,18,17,1,0,0,0,0,9,9,9,9
Mono,42,2022-10-05,1,1,1,0,64,66,65,1,0,0,0,0,7,7,7,7
Monterey,42,2022-10-05,99,103,103,0,3711,3847,3846,1,7,1,2,2,768,769,767,767
Napa,42,2022-10-05,72,73,73,0,1608,1667,1666,1,2,0,0,2,157,157,157,157
Nevada,42,2022-10-05,36,36,36,0,896,929,928,1,1,0,0,0,132,132,132,132
Orange,42,2022-10-05,1420,1472,1472,0,25961,26901,26900,1,119,29,56,14,7532,7584,7503,7528
Placer,42,2022-10-05,134,140,140,0,2991,3099,3098,1,34,1,2,4,662,664,661,662
Plumas,42,2022-10-05,13,13,13,0,98,103,102,1,2,0,0,0,13,13,13,13
Riverside,42,2022-10-05,1052,1091,1091,0,20682,21428,21427,1,55,6,12,13,6536,6543,6530,6531
Sacramento,42,2022-10-05,796,824,824,0,16657,17259,17258,1,90,6,10,16,3332,3346,3326,3336
San Benito,42,2022-10-05,41,42,42,0,429,446,445,1,0,0,0,0,101,101,101,101
San Bernardino,42,2022-10-05,1080,1119,1119,0,22087,22889,22888,1,94,2,4,14,8109,8114,8107,8110
San Diego,42,2022-10-05,1876,1945,1945,0,45107,46746,46745,1,149,4,9,22,5517,5526,5513,5517
San Francisco,42,2022-10-05,569,589,589,0,14037,14538,14536,2,53,0,0,7,1056,1058,1056,1058
San Joaquin,42,2022-10-05,322,334,334,0,8714,9024,9023,1,28,1,2,5,2335,2338,2334,2336
San Luis Obispo,42,2022-10-05,110,113,113,0,2341,2426,2425,1,5,0,0,0,524,524,524,524
San Mateo,42,2022-10-05,537,556,556,0,11551,11970,11969,1,20,0,0,1,721,721,721,721
Santa Barbara,42,2022-10-05,240,249,249,0,6420,6655,6654,1,15,0,0,3,726,727,726,727
Santa Clara,42,2022-10-05,1297,1344,1344,0,28292,29308,29307,1,92,1,2,18,2502,2508,2501,2506
Santa Cruz,42,2022-10-05,233,241,241,0,10805,11190,11189,1,14,0,0,2,274,274,274,274
Shasta,42,2022-10-05,51,51,51,0,1221,1265,1264,1,15,0,0,2,589,589,589,589
Siskiyou,42,2022-10-05,10,10,10,0,198,206,205,1,1,1,2,1,93,94,92,92
Solano,42,2022-10-05,264,273,273,0,5213,5403,5402,1,19,0,0,1,456,456,456,456
Sonoma,42,2022-10-05,278,289,289,0,5844,6054,6053,1,16,1,2,5,526,528,525,526
Stanislaus,42,2022-10-05,197,204,204,0,5053,5236,5235,1,53,0,0,8,1781,1781,1781,1781
Sutter,42,2022-10-05,46,46,46,0,984,1019,1018,1,0,0,0,0,232,232,232,232
Tehama,42,2022-10-05,17,17,17,0,477,496,495,1,2,0,0,0,208,208,208,208
Trinity,42,2022-10-05,1,1,1,0,46,47,46,1,0,0,0,0,20,20,20,20
Tulare,42,2022-10-05,137,143,143,0,4792,4968,4967,1,13,0,0,1,1537,1538,1537,1538
Tuolumne,42,2022-10-05,20,20,20,0,578,601,600,1,0,0,0,0,193,193,193,193
Ventura,42,2022-10-05,427,443,443,0,10015,10376,10375,1,36,2,4,2,1569,1571,1567,1567
Yolo,42,2022-10-05,99,102,102,0,2889,2995,2994,1,5,2,4,0,346,349,344,345
Yuba,42,2022-10-05,34,34,34,0,744,772,771,1,3,0,0,2,120,120,120,120
Alameda,43,2022-10-12,1045,1116,1116,0,27432,29316,29315,1,53,0,0,11,2028,2031,2028,2031
Amador,43,2022-10-12,14,14,14,0,773,829,828,1,0,0,0,1,94,94,94,94
Butte,43,2022-10-12,63,67,67,0,1503,1607,1606,1,10,0,0,0,456,457,456,457
Calaveras,43,2022-10-12,14,14,14,0,364,390,389,1,0,0,0,1,135,135,135,135
Colusa,43,2022-10-12,4,4,4,0,106,113,112,1,0,0,0,0,22,22,22,22
Contra Costa,43,2022-10-12,743,792,792,0,16527,17663,17662,1,26,0,0,7,1443,1447,1443,1447
Del Norte,43,2022-10-12,14,14,14,0,492,528,527,1,1,0,0,1,55,55,55,55
El Dorado,43,2022-10-12,71,78,78,0,1614,1726,1725,1,7,0,0,2,231,231,231,231
Fresno,43,2022-10-12,450,480,480,0,10952,11702,11701,1,64,3,9,9,2890,2903,2887,2894
Glenn,43,2022-10-12,10,10,10,0,216,233,232,1,2,0,0,0,42,42,42,42
Humboldt,43,2022-10-12,87,94,94,0,1373,1466,1465,1,4,0,0,0,160,161,160,161
Imperial,43,2022-10-12,154,165,165,0,2815,3009,3008,1,7,0,0,0,961,962,961,962
Inyo,43,2022-10-12,3,3,3,0,137,148,147,1,0,0,0,0,60,60,60,60
Kern,43,2022-10-12,249,265,265,0,11276,12060,12059,1,31,0,0,5,2420,2421,2420,2421
Kings,43,2022-10-12,84,89,89,0,2633,2823,2822,1,1,0,0,0,459,459,459,459
Lake,43,2022-10-12,33,35,35,0,973,1041,1040,1,0,0,0,0,147,147,147,147
Lassen,43,2022-10-12,1,1,1,0,551,591,590,1,0,0,0,0,63,63,63,63
Los Angeles,43,2022-10-12,5793,6187,6187,0,218985,234337,234334,3,405,8,30,50,33525,33655,33517,33625
Madera,43,2022-10-12,60,64,64,0,1646,1760,1759,1,7,0,0,1,371,371,371,371
Marin,43,2022-10-12,169,180,180,0,3688,3941,3940,1,11,0,0,1,314,314,314,314
Mariposa,43,2022-10-12,10,10,10,0,114,124,123,1,0,0,0,0,29,29,29,29
Mendocino,43,2022-10-12,34,35,35,0,905,969,968,1,3,0,0,2,136,136,136,136
Merced,43,2022-10-12,105,113,113,0,2618,2807,2806,1,8,0,0,3,869,870,869,870
Modoc,43,2022-10-12,4,4,4,0,9,10,9,1,0,0,0,0,9,9,9,9
Mono,43,2022-10-12,3,3,3,0,50,53,52,1,0,0,0,0,7,7,7,7
Monterey,43,2022-10-12,88,95,95,0,4111,4401,4400,1,12,0,0,1,768,769,768,769
Napa,43,2022-10-12,71,74,74,0,1658,1770,1769,1,3,0,0,2,157,157,157,157
Nevada,43,2022-10-12,34,35,35,0,925,990,989,1,3,0,0,0,132,132,132,132
Orange,43,2022-10-12,1352,1444,1444,0,28876,30891,30890,1,104,4,13,21,7536,7597,7532,7584
Placer,43,2022-10-12,119,128,128,0,3442,3676,3675,1,28,0,0,4,662,664,662,664
Plumas,43,2022-10-12,10,10,10,0,93,99,98,1,0,0,0,0,13,13,13,13
Riverside,43,2022-10-12,1032,1102,1102,0,22674,24245,24244,1,60,0,0,5,6536,6543,6536,6543
Sacramento,43,2022-10-12,874,934,934,0,18994,20315,20314,1,83,1,6,12,3333,3352,3332,3346
San Benito,43,2022-10-12,25,26,26,0,433,464,463,1,3,0,0,0,101,101,101,101
San Bernardino,43,2022-10-12,1002,1070,1070,0,25423,27201,27200,1,74,1,4,13,8110,8118,8109,8114
San Diego,43,2022-10-12,1816,1940,1940,0,49874,53354,53353,1,124,0,0,20,5517,5526,5517,5526
San Francisco,43,2022-10-12,593,634,634,0,15368,16415,16414,1,39,0,0,12,1056,1058,1056,1058
San Joaquin,43,2022-10-12,400,428,428,0,10282,10983,10982,1,14,0,0,6,2335,2338,2335,2338
San Luis Obispo,43,2022-10-12,85,91,91,0,2433,2607,2606,1,1,1,3,1,525,527,524,524
San Mateo,43,2022-10-12,596,637,637,0,13034,13943,13942,1,17,0,0,2,721,721,721,721
Santa Barbara,43,2022-10-12,225,239,239,0,7288,7792,7791,1,15,0,0,3,726,727,726,727
Santa Clara,43,2022-10-12,1290,1379,1379,0,32964,35249,35248,1,105,0,0,19,2502,2508,2502,2508
Santa Cruz,43,2022-10-12,312,333,333,0,11660,12444,12443,1,14,2,10,1,275,279,273,269
Shasta,43,2022-10-12,78,83,83,0,1199,1284,1283,1,12,2,6,0,591,595,589,589
Siskiyou,43,2022-10-12,12,12,12,0,251,271,270,1,2,0,0,1,93,94,93,94
Solano,43,2022-10-12,306,329,329,0,5900,6307,6306,1,32,1,6,2,457,462,456,456
Sonoma,43,2022-10-12,279,298,298,0,6568,7019,7018,1,18,0,0,2,526,528,526,528
Stanislaus,43,2022-10-12,202,216,216,0,5565,5954,5953,1,46,0,0,9,1781,1781,1781,1781
Sutter,43,2022-10-12,56,59,59,0,1102,1178,1177,1,0,0,0,0,232,232,232,232
Tehama,43,2022-10-12,18,18,18,0,509,544,543,1,2,0,0,0,208,208,208,208
Trinity,43,2022-10-12,1,1,1,0,44,45,44,1,0,0,0,0,20,20,20,20
Tulare,43,2022-10-12,146,156,156,0,4914,5263,5262,1,9,0,0,1,1537,1538,1537,1538
Tuolumne,43,2022-10-12,40,42,42,0,659,708,707,1,0,0,0,0,193,193,193,193
Ventura,43,2022-10-12,384,410,410,0,10618,11355,11354,1,35,0,0,1,1569,1571,1569,1571
Yolo,43,2022-10-12,108,117,117,0,2786,2977,2976,1,4,0,0,0,346,349,346,349
Yuba,43,2022-10-12,30,31,31,0,935,1002,1001,1,2,0,0,0,120,120,120,120
Alameda,44,2022-10-17,395,514,514,0,12238,15529,15528,1,60,2,18,8,2030,2049,2028,2031
Amador,44,2022-10-17,9,12,12,0,212,279,278,1,1,0,0,0,94,94,94,94
Butte,44,2022-10-17,20,26,26,0,777,983,982,1,13,0,0,0,456,457,456,457
Calaveras,44,2022-10-17,13,18,18,0,162,229,228,1,0,0,0,0,135,135,135,135
Colusa,44,2022-10-17,0,0,0,0,36,50,49,1,0,0,0,0,22,22,22,22
Contra Costa,44,2022-10-17,284,370,370,0,7504,9633,9632,1,30,0,0,6,1443,1447,1443,1447
Del Norte,44,2022-10-17,3,4,4,0,167,227,226,1,1,0,0,0,55,55,55,55
El Dorado,44,2022-10-17,29,39,39,0,503,646,645,1,2,0,0,1,231,231,231,231
Fresno,44,2022-10-17,141,185,185,0,4797,6109,6108,1,62,0,0,11,2890,2903,2890,2903
Glenn,44,2022-10-17,3,3,3,0,35,46,45,1,1,0,0,0,42,42,42,42
Humboldt,44,2022-10-17,22,32,32,0,529,690,689,1,1,0,0,0,160,161,160,161
Imperial,44,2022-10-17,38,49,49,0,927,1166,1165,1,5,0,0,0,961,962,961,962
Inyo,44,2022-10-17,1,1,1,0,73,98,97,1,1,0,0,0,60,60,60,60
Kern,44,2022-10-17,100,125,125,0,3597,4414,4413,1,32,0,0,1,2420,2421,2420,2421
Kings,44,2022-10-17,35,46,46,0,892,1144,1143,1,2,1,14,0,460,473,459,459
Lake,44,2022-10-17,14,17,17,0,382,508,507,1,1,0,0,0,147,147,147,147
Lassen,44,2022-10-17,6,7,7,0,202,245,244,1,1,0,0,0,63,63,63,63
Los Angeles,44,2022-10-17,704,813,813,0,28493,32640,32639,1,350,1,9,53,33526,33664,33525,33655
Madera,44,2022-10-17,25,34,34,0,687,874,873,1,3,0,0,2,371,371,371,371
Marin,44,2022-10-17,71,94,94,0,1567,2042,2041,1,8,0,0,1,314,314,314,314
Mariposa,44,2022-10-17,2,3,3,0,66,87,86,1,0,0,0,0,29,29,29,29
Mendocino,44,2022-10-17,18,23,23,0,397,532,531,1,2,0,0,0,136,136,136,136
Merced,44,2022-10-17,41,49,49,0,885,1105,1104,1,15,0,0,2,869,870,869,870
Modoc,44,2022-10-17,0,0,0,0,1,2,1,1,0,0,0,0,9,9,9,9
Mono,44,2022-10-17,4,6,6,0,23,33,32,1,1,0,0,0,7,7,7,7
Monterey,44,2022-10-17,47,64,64,0,1552,2020,2019,1,12,0,0,1,768,769,768,769
Napa,44,2022-10-17,31,41,41,0,788,1017,1016,1,2,0,0,1,157,157,157,157
Nevada,44,2022-10-17,17,20,20,0,318,390,389,1,0,0,0,5,132,132,132,132
Orange,44,2022-10-17,500,642,642,0,10898,13901,13900,1,91,0,0,18,7536,7597,7536,7597
Placer,44,2022-10-17,47,61,61,0,1409,1841,1840,1,32,0,0,3,662,664,662,664
Plumas,44,2022-10-17,7,10,10,0,62,85,84,1,0,0,0,0,13,13,13,13
Riverside,44,2022-10-17,374,477,477,0,8689,10813,10812,1,66,0,0,2,6536,6543,6536,6543
Sacramento,44,2022-10-17,366,475,475,0,6901,8755,8754,1,84,0,0,14,3333,3352,3333,3352
San Benito,44,2022-10-17,14,19,19,0,173,223,222,1,0,0,0,0,101,101,101,101
San Bernardino,44,2022-10-17,291,359,359,0,8742,10806,10805,1,63,0,0,9,8110,8118,8110,8118
San Diego,44,2022-10-17,757,952,952,0,18198,22485,22484,1,117,0,0,24,5517,5526,5517,5526
San Francisco,44,2022-10-17,240,310,310,0,7202,9118,9117,1,34,0,0,13,1056,1058,1056,1058
San Joaquin,44,2022-10-17,155,204,204,0,3838,4888,4887,1,8,0,0,8,2335,2338,2335,2338
San Luis Obispo,44,2022-10-17,29,37,37,0,905,1126,1125,1,4,0,0,0,525,527,525,527
San Mateo,44,2022-10-17,254,336,336,0,5345,6822,6821,1,21,0,0,1,721,721,721,721
Santa Barbara,44,2022-10-17,65,83,83,0,2605,3318,3317,1,18,0,0,2,726,727,726,727
Santa Clara,44,2022-10-17,553,722,722,0,13193,16655,16654,1,93,0,0,16,2502,2508,2502,2508
Santa Cruz,44,2022-10-17,82,99,99,0,4114,4783,4782,1,7,0,0,0,275,279,275,279
Shasta,44,2022-10-17,18,20,20,0,308,372,371,1,12,0,0,2,591,595,591,595
Siskiyou,44,2022-10-17,6,7,7,0,88,115,114,1,2,1,18,0,94,112,93,94
Solano,44,2022-10-17,157,212,212,0,2470,3293,3292,1,25,0,0,3,457,462,457,462
Sonoma,44,2022-10-17,104,139,139,0,2857,3677,3676,1,20,0,0,1,526,528,526,528
Stanislaus,44,2022-10-17,110,137,137,0,2637,3389,3388,1,45,0,0,5,1781,1781,1781,1781
Sutter,44,2022-10-17,21,28,28,0,421,551,550,1,0,0,0,0,232,232,232,232
Tehama,44,2022-10-17,7,7,7,0,136,164,163,1,0,0,0,0,208,208,208,208
Trinity,44,2022-10-17,0,0,0,0,18,25,24,1,0,0,0,0,20,20,20,20
Tulare,44,2022-10-17,58,77,77,0,1565,1926,1925,1,11,0,0,1,1537,1538,1537,1538
Tuolumne,44,2022-10-17,21,26,26,0,291,379,378,1,2,0,0,0,193,193,193,193
Ventura,44,2022-10-17,159,207,207,0,4402,5593,5592,1,32,0,0,1,1569,1571,1569,1571
Yolo,44,2022-10-17,43,54,54,0,1019,1335,1334,1,3,0,0,3,346,349,346,349
Yuba,44,2022-10-17,19,25,25,0,360,467,466,1,1,0,0,0,120,120,120,120
