county,time,date,cases,est_cases,est_omicron_cases,est_other_cases,hospitalizations
Alameda,0.42857142857142855,2021-12-17,969,988,432,556,96
Amador,0.42857142857142855,2021-12-17,20,20,9,11,7
Butte,0.42857142857142855,2021-12-17,68,69,28,41,30
Calaveras,0.42857142857142855,2021-12-17,26,26,11,15,1
Colusa,0.42857142857142855,2021-12-17,3,3,1,2,0
Contra Costa,0.42857142857142855,2021-12-17,612,623,274,349,43
Del Norte,0.42857142857142855,2021-12-17,7,7,3,4,0
El Dorado,0.42857142857142855,2021-12-17,100,103,45,58,11
Fresno,0.42857142857142855,2021-12-17,450,458,197,261,196
Glenn,0.42857142857142855,2021-12-17,3,3,1,2,0
Humboldt,0.42857142857142855,2021-12-17,59,59,26,33,13
Imperial,0.42857142857142855,2021-12-17,221,225,99,126,67
Inyo,0.42857142857142855,2021-12-17,9,9,4,5,1
Kern,0.42857142857142855,2021-12-17,414,423,183,240,124
Kings,0.42857142857142855,2021-12-17,89,91,38,53,22
Lake,0.42857142857142855,2021-12-17,23,23,9,14,0
Lassen,0.42857142857142855,2021-12-17,4,4,2,2,0
Los Angeles,0.42857142857142855,2021-12-17,11542,11765,5137,6628,835
Madera,0.42857142857142855,2021-12-17,72,73,32,41,18
Marin,0.42857142857142855,2021-12-17,153,156,67,89,14
Mariposa,0.42857142857142855,2021-12-17,9,9,4,5,0
Mendocino,0.42857142857142855,2021-12-17,41,42,16,26,5
Merced,0.42857142857142855,2021-12-17,125,128,55,73,21
Modoc,0.42857142857142855,2021-12-17,0,0,0,0,3
Mono,0.42857142857142855,2021-12-17,17,17,8,9,0
Monterey,0.42857142857142855,2021-12-17,178,181,77,104,24
Napa,0.42857142857142855,2021-12-17,88,91,40,51,5
Nevada,0.42857142857142855,2021-12-17,73,73,31,42,7
Orange,0.42857142857142855,2021-12-17,1700,1733,753,980,200
Placer,0.42857142857142855,2021-12-17,205,209,90,119,98
Plumas,0.42857142857142855,2021-12-17,8,8,3,5,1
Riverside,0.42857142857142855,2021-12-17,2177,2220,972,1248,329
Sacramento,0.42857142857142855,2021-12-17,882,900,387,513,164
San Benito,0.42857142857142855,2021-12-17,38,38,15,23,4
San Bernardino,0.42857142857142855,2021-12-17,1768,1802,780,1022,425
San Diego,0.42857142857142855,2021-12-17,3508,3576,1548,2028,391
San Francisco,0.42857142857142855,2021-12-17,967,986,432,554,50
San Joaquin,0.42857142857142855,2021-12-17,400,408,174,234,83
San Luis Obispo,0.42857142857142855,2021-12-17,173,176,77,99,14
San Mateo,0.42857142857142855,2021-12-17,450,459,202,257,22
Santa Barbara,0.42857142857142855,2021-12-17,297,303,133,170,38
Santa Clara,0.42857142857142855,2021-12-17,950,969,420,549,154
Santa Cruz,0.42857142857142855,2021-12-17,152,155,65,90,15
Shasta,0.42857142857142855,2021-12-17,72,74,32,42,33
Siskiyou,0.42857142857142855,2021-12-17,7,7,3,4,3
Solano,0.42857142857142855,2021-12-17,176,179,79,100,45
Sonoma,0.42857142857142855,2021-12-17,264,270,118,152,29
Stanislaus,0.42857142857142855,2021-12-17,278,284,123,161,111
Sutter,0.42857142857142855,2021-12-17,45,45,20,25,0
Tehama,0.42857142857142855,2021-12-17,18,18,8,10,6
Trinity,0.42857142857142855,2021-12-17,1,1,0,1,0
Tulare,0.42857142857142855,2021-12-17,172,175,73,102,59
Tuolumne,0.42857142857142855,2021-12-17,40,40,18,22,8
Ventura,0.42857142857142855,2021-12-17,705,718,315,403,77
Yolo,0.42857142857142855,2021-12-17,109,112,50,62,4
Yuba,0.42857142857142855,2021-12-17,43,43,18,25,9
Alameda,0.8571428571428571,2021-12-20,1527,1559,1083,476,95
Amador,0.8571428571428571,2021-12-20,25,25,17,8,5
Butte,0.8571428571428571,2021-12-20,90,91,63,28,25
Calaveras,0.8571428571428571,2021-12-20,27,27,19,8,1
Colusa,0.8571428571428571,2021-12-20,3,3,2,1,1
Contra Costa,0.8571428571428571,2021-12-20,871,889,616,273,51
Del Norte,0.8571428571428571,2021-12-20,8,8,6,2,0
El Dorado,0.8571428571428571,2021-12-20,109,112,77,35,7
Fresno,0.8571428571428571,2021-12-20,436,445,308,137,191
Glenn,0.8571428571428571,2021-12-20,11,11,7,4,0
Humboldt,0.8571428571428571,2021-12-20,74,75,52,23,13
Imperial,0.8571428571428571,2021-12-20,247,252,174,78,67
Inyo,0.8571428571428571,2021-12-20,20,20,14,6,1
Kern,0.8571428571428571,2021-12-20,373,381,263,118,112
Kings,0.8571428571428571,2021-12-20,106,108,75,33,18
Lake,0.8571428571428571,2021-12-20,14,14,10,4,0
Lassen,0.8571428571428571,2021-12-20,6,6,4,2,0
Los Angeles,0.8571428571428571,2021-12-20,16295,16641,11507,5134,830
Madera,0.8571428571428571,2021-12-20,55,56,38,18,20
Marin,0.8571428571428571,2021-12-20,342,350,242,108,12
Mariposa,0.8571428571428571,2021-12-20,11,11,8,3,0
Mendocino,0.8571428571428571,2021-12-20,34,34,23,11,7
Merced,0.8571428571428571,2021-12-20,155,159,111,48,23
Modoc,0.8571428571428571,2021-12-20,3,3,2,1,2
Mono,0.8571428571428571,2021-12-20,8,8,5,3,1
Monterey,0.8571428571428571,2021-12-20,151,155,106,49,31
Napa,0.8571428571428571,2021-12-20,127,131,91,40,4
Nevada,0.8571428571428571,2021-12-20,68,69,48,21,6
Orange,0.8571428571428571,2021-12-20,2536,2590,1794,796,195
Placer,0.8571428571428571,2021-12-20,270,276,190,86,90
Plumas,0.8571428571428571,2021-12-20,4,4,3,1,0
Riverside,0.8571428571428571,2021-12-20,2745,2803,1937,866,349
Sacramento,0.8571428571428571,2021-12-20,940,960,662,298,157
San Benito,0.8571428571428571,2021-12-20,42,43,30,13,4
San Bernardino,0.8571428571428571,2021-12-20,2400,2451,1696,755,424
San Diego,0.8571428571428571,2021-12-20,4309,4401,3060,1341,363
San Francisco,0.8571428571428571,2021-12-20,1647,1682,1167,515,44
San Joaquin,0.8571428571428571,2021-12-20,417,426,298,128,78
San Luis Obispo,0.8571428571428571,2021-12-20,167,170,120,50,17
San Mateo,0.8571428571428571,2021-12-20,758,773,535,238,23
Santa Barbara,0.8571428571428571,2021-12-20,392,401,279,122,34
Santa Clara,0.8571428571428571,2021-12-20,1713,1750,1212,538,147
Santa Cruz,0.8571428571428571,2021-12-20,198,202,139,63,16
Shasta,0.8571428571428571,2021-12-20,70,71,49,22,36
Siskiyou,0.8571428571428571,2021-12-20,9,9,6,3,4
Solano,0.8571428571428571,2021-12-20,220,224,153,71,38
Sonoma,0.8571428571428571,2021-12-20,383,391,269,122,29
Stanislaus,0.8571428571428571,2021-12-20,268,274,190,84,125
Sutter,0.8571428571428571,2021-12-20,68,69,48,21,0
Tehama,0.8571428571428571,2021-12-20,20,20,13,7,7
Trinity,0.8571428571428571,2021-12-20,0,0,0,0,0
Tulare,0.8571428571428571,2021-12-20,171,175,121,54,50
Tuolumne,0.8571428571428571,2021-12-20,41,41,28,13,7
Ventura,0.8571428571428571,2021-12-20,1099,1122,776,346,80
Yolo,0.8571428571428571,2021-12-20,144,148,102,46,5
Yuba,0.8571428571428571,2021-12-20,39,39,27,12,7
Alameda,1.2857142857142858,2021-12-23,2689,2752,2220,532,95
Amador,1.2857142857142858,2021-12-23,36,36,29,7,5
Butte,1.2857142857142858,2021-12-23,171,174,140,34,29
Calaveras,1.2857142857142858,2021-12-23,32,32,26,6,1
Colusa,1.2857142857142858,2021-12-23,4,4,3,1,2
Contra Costa,1.2857142857142858,2021-12-23,1637,1675,1354,321,59
Del Norte,1.2857142857142858,2021-12-23,3,3,2,1,0
El Dorado,1.2857142857142858,2021-12-23,181,184,148,36,10
Fresno,1.2857142857142858,2021-12-23,744,761,615,146,165
Glenn,1.2857142857142858,2021-12-23,29,29,23,6,0
Humboldt,1.2857142857142858,2021-12-23,168,172,139,33,10
Imperial,1.2857142857142858,2021-12-23,279,286,230,56,62
Inyo,1.2857142857142858,2021-12-23,33,33,27,6,1
Kern,1.2857142857142858,2021-12-23,635,650,526,124,107
Kings,1.2857142857142858,2021-12-23,145,148,120,28,19
Lake,1.2857142857142858,2021-12-23,16,16,13,3,0
Lassen,1.2857142857142858,2021-12-23,9,9,7,2,1
Los Angeles,1.2857142857142858,2021-12-23,37645,38528,31147,7381,955
Madera,1.2857142857142858,2021-12-23,103,106,86,20,17
Marin,1.2857142857142858,2021-12-23,585,599,483,116,9
Mariposa,1.2857142857142858,2021-12-23,17,17,14,3,0
Mendocino,1.2857142857142858,2021-12-23,37,37,30,7,7
Merced,1.2857142857142858,2021-12-23,200,205,166,39,22
Modoc,1.2857142857142858,2021-12-23,2,2,2,0,3
Mono,1.2857142857142858,2021-12-23,47,48,38,10,1
Monterey,1.2857142857142858,2021-12-23,222,227,184,43,28
Napa,1.2857142857142858,2021-12-23,304,311,252,59,5
Nevada,1.2857142857142858,2021-12-23,96,99,79,20,7
Orange,1.2857142857142858,2021-12-23,5816,5952,4822,1130,239
Placer,1.2857142857142858,2021-12-23,429,439,356,83,84
Plumas,1.2857142857142858,2021-12-23,5,5,4,1,0
Riverside,1.2857142857142858,2021-12-23,4860,4974,4024,950,403
Sacramento,1.2857142857142858,2021-12-23,1769,1811,1463,348,187
San Benito,1.2857142857142858,2021-12-23,138,141,114,27,2
San Bernardino,1.2857142857142858,2021-12-23,4541,4647,3755,892,437
San Diego,1.2857142857142858,2021-12-23,10713,10965,8870,2095,358
San Francisco,1.2857142857142858,2021-12-23,2905,2973,2397,576,43
San Joaquin,1.2857142857142858,2021-12-23,791,809,654,155,67
San Luis Obispo,1.2857142857142858,2021-12-23,427,437,354,83,22
San Mateo,1.2857142857142858,2021-12-23,1479,1513,1224,289,34
Santa Barbara,1.2857142857142858,2021-12-23,678,694,561,133,35
Santa Clara,1.2857142857142858,2021-12-23,3057,3129,2529,600,141
Santa Cruz,1.2857142857142858,2021-12-23,298,306,248,58,15
Shasta,1.2857142857142858,2021-12-23,79,81,66,15,37
Siskiyou,1.2857142857142858,2021-12-23,5,5,4,1,0
Solano,1.2857142857142858,2021-12-23,430,439,356,83,42
Sonoma,1.2857142857142858,2021-12-23,684,700,568,132,22
Stanislaus,1.2857142857142858,2021-12-23,412,422,341,81,121
Sutter,1.2857142857142858,2021-12-23,79,81,66,15,0
Tehama,1.2857142857142858,2021-12-23,29,29,24,5,9
Trinity,1.2857142857142858,2021-12-23,0,0,0,0,0
Tulare,1.2857142857142858,2021-12-23,268,274,221,53,42
Tuolumne,1.2857142857142858,2021-12-23,57,58,47,11,7
Ventura,1.2857142857142858,2021-12-23,1711,1750,1415,335,77
Yolo,1.2857142857142858,2021-12-23,258,265,214,51,8
Yuba,1.2857142857142858,2021-12-23,50,50,40,10,9
Alameda,1.7142857142857142,2021-12-26,2228,2287,1988,299,120
Amador,1.7142857142857142,2021-12-26,37,37,32,5,4
Butte,1.7142857142857142,2021-12-26,194,198,172,26,38
Calaveras,1.7142857142857142,2021-12-26,43,44,38,6,2
Colusa,1.7142857142857142,2021-12-26,12,12,10,2,2
Contra Costa,1.7142857142857142,2021-12-26,1419,1457,1268,189,69
Del Norte,1.7142857142857142,2021-12-26,17,17,15,2,0
El Dorado,1.7142857142857142,2021-12-26,149,152,132,20,10
Fresno,1.7142857142857142,2021-12-26,626,643,559,84,170
Glenn,1.7142857142857142,2021-12-26,11,11,10,1,0
Humboldt,1.7142857142857142,2021-12-26,182,186,162,24,11
Imperial,1.7142857142857142,2021-12-26,255,262,228,34,55
Inyo,1.7142857142857142,2021-12-26,51,53,46,7,0
Kern,1.7142857142857142,2021-12-26,607,623,543,80,105
Kings,1.7142857142857142,2021-12-26,172,176,153,23,19
Lake,1.7142857142857142,2021-12-26,23,23,20,3,0
Lassen,1.7142857142857142,2021-12-26,5,5,4,1,0
Los Angeles,1.7142857142857142,2021-12-26,24576,25226,21912,3314,1078
Madera,1.7142857142857142,2021-12-26,110,113,98,15,14
Marin,1.7142857142857142,2021-12-26,604,620,540,80,6
Mariposa,1.7142857142857142,2021-12-26,13,13,11,2,0
Mendocino,1.7142857142857142,2021-12-26,60,61,53,8,6
Merced,1.7142857142857142,2021-12-26,186,191,166,25,18
Modoc,1.7142857142857142,2021-12-26,0,0,0,0,3
Mono,1.7142857142857142,2021-12-26,7,7,6,1,1
Monterey,1.7142857142857142,2021-12-26,223,229,199,30,36
Napa,1.7142857142857142,2021-12-26,253,260,226,34,6
Nevada,1.7142857142857142,2021-12-26,77,80,69,11,6
Orange,1.7142857142857142,2021-12-26,5411,5555,4833,722,303
Placer,1.7142857142857142,2021-12-26,392,402,349,53,95
Plumas,1.7142857142857142,2021-12-26,3,3,3,0,0
Riverside,1.7142857142857142,2021-12-26,4345,4461,3882,579,391
Sacramento,1.7142857142857142,2021-12-26,1484,1524,1326,198,191
San Benito,1.7142857142857142,2021-12-26,89,91,79,12,4
San Bernardino,1.7142857142857142,2021-12-26,4165,4275,3720,555,466
San Diego,1.7142857142857142,2021-12-26,6555,6730,5864,866,404
San Francisco,1.7142857142857142,2021-12-26,2151,2208,1919,289,45
San Joaquin,1.7142857142857142,2021-12-26,717,736,640,96,81
San Luis Obispo,1.7142857142857142,2021-12-26,228,233,203,30,22
San Mateo,1.7142857142857142,2021-12-26,1570,1611,1402,209,36
Santa Barbara,1.7142857142857142,2021-12-26,742,762,663,99,39
Santa Clara,1.7142857142857142,2021-12-26,3139,3223,2803,420,143
Santa Cruz,1.7142857142857142,2021-12-26,347,356,309,47,14
Shasta,1.7142857142857142,2021-12-26,84,87,76,11,40
Siskiyou,1.7142857142857142,2021-12-26,8,8,7,1,0
Solano,1.7142857142857142,2021-12-26,269,276,240,36,42
Sonoma,1.7142857142857142,2021-12-26,705,723,630,93,22
Stanislaus,1.7142857142857142,2021-12-26,442,454,395,59,116
Sutter,1.7142857142857142,2021-12-26,78,80,70,10,0
Tehama,1.7142857142857142,2021-12-26,39,39,34,5,11
Trinity,1.7142857142857142,2021-12-26,3,3,3,0,0
Tulare,1.7142857142857142,2021-12-26,259,266,231,35,48
Tuolumne,1.7142857142857142,2021-12-26,71,73,63,10,6
Ventura,1.7142857142857142,2021-12-26,2095,2150,1873,277,84
Yolo,1.7142857142857142,2021-12-26,247,254,221,33,8
Yuba,1.7142857142857142,2021-12-26,62,64,56,8,11
Alameda,2.142857142857143,2021-12-29,7519,7746,6924,822,151
Amador,2.142857142857143,2021-12-29,59,61,55,6,6
Butte,2.142857142857143,2021-12-29,412,424,379,45,40
Calaveras,2.142857142857143,2021-12-29,59,61,54,7,2
Colusa,2.142857142857143,2021-12-29,25,25,22,3,2
Contra Costa,2.142857142857143,2021-12-29,5752,5926,5296,630,86
Del Norte,2.142857142857143,2021-12-29,20,20,18,2,1
El Dorado,2.142857142857143,2021-12-29,498,513,459,54,12
Fresno,2.142857142857143,2021-12-29,2416,2490,2226,264,178
Glenn,2.142857142857143,2021-12-29,41,42,38,4,0
Humboldt,2.142857142857143,2021-12-29,368,379,338,41,11
Imperial,2.142857142857143,2021-12-29,745,767,685,82,61
Inyo,2.142857142857143,2021-12-29,109,113,101,12,0
Kern,2.142857142857143,2021-12-29,1996,2056,1836,220,117
Kings,2.142857142857143,2021-12-29,437,450,402,48,22
Lake,2.142857142857143,2021-12-29,54,56,50,6,0
Lassen,2.142857142857143,2021-12-29,20,20,18,2,1
Los Angeles,2.142857142857143,2021-12-29,94177,97015,86677,10338,1508
Madera,2.142857142857143,2021-12-29,358,368,329,39,16
Marin,2.142857142857143,2021-12-29,1160,1196,1068,128,14
Mariposa,2.142857142857143,2021-12-29,32,32,29,3,0
Mendocino,2.142857142857143,2021-12-29,173,178,159,19,7
Merced,2.142857142857143,2021-12-29,710,731,653,78,22
Modoc,2.142857142857143,2021-12-29,3,3,3,0,0
Mono,2.142857142857143,2021-12-29,130,135,121,14,0
Monterey,2.142857142857143,2021-12-29,633,651,582,69,28
Napa,2.142857142857143,2021-12-29,806,831,743,88,7
Nevada,2.142857142857143,2021-12-29,211,218,195,23,4
Orange,2.142857142857143,2021-12-29,21006,21640,19336,2304,437
Placer,2.142857142857143,2021-12-29,1175,1210,1081,129,115
Plumas,2.142857142857143,2021-12-29,11,11,10,1,2
Riverside,2.142857142857143,2021-12-29,13568,13977,12490,1487,464
Sacramento,2.142857142857143,2021-12-29,5554,5722,5114,608,214
San Benito,2.142857142857143,2021-12-29,338,347,310,37,4
San Bernardino,2.142857142857143,2021-12-29,14997,15450,13805,1645,592
San Diego,2.142857142857143,2021-12-29,28026,28872,25800,3072,496
San Francisco,2.142857142857143,2021-12-29,4634,4773,4264,509,69
San Joaquin,2.142857142857143,2021-12-29,2723,2805,2507,298,98
San Luis Obispo,2.142857142857143,2021-12-29,1385,1427,1275,152,28
San Mateo,2.142857142857143,2021-12-29,3545,3652,3263,389,39
Santa Barbara,2.142857142857143,2021-12-29,2027,2088,1865,223,51
Santa Clara,2.142857142857143,2021-12-29,8678,8939,7987,952,180
Santa Cruz,2.142857142857143,2021-12-29,920,948,847,101,12
Shasta,2.142857142857143,2021-12-29,216,222,198,24,42
Siskiyou,2.142857142857143,2021-12-29,26,26,23,3,0
Solano,2.142857142857143,2021-12-29,1936,1994,1783,211,63
Sonoma,2.142857142857143,2021-12-29,1879,1936,1731,205,25
Stanislaus,2.142857142857143,2021-12-29,1286,1324,1183,141,124
Sutter,2.142857142857143,2021-12-29,166,172,154,18,0
Tehama,2.142857142857143,2021-12-29,62,64,57,7,6
Trinity,2.142857142857143,2021-12-29,2,2,2,0,0
Tulare,2.142857142857143,2021-12-29,717,738,659,79,46
Tuolumne,2.142857142857143,2021-12-29,115,118,105,13,8
Ventura,2.142857142857143,2021-12-29,5904,6083,5435,648,99
Yolo,2.142857142857143,2021-12-29,879,905,809,96,12
Yuba,2.142857142857143,2021-12-29,157,162,145,17,13
Alameda,2.5714285714285716,2022-01-01,4988,5157,4650,507,181
Amador,2.5714285714285716,2022-01-01,59,62,56,6,8
Butte,2.5714285714285716,2022-01-01,318,329,297,32,30
Calaveras,2.5714285714285716,2022-01-01,61,64,58,6,3
Colusa,2.5714285714285716,2022-01-01,16,16,14,2,4
Contra Costa,2.5714285714285716,2022-01-01,3776,3906,3523,383,113
Del Norte,2.5714285714285716,2022-01-01,32,32,29,3,0
El Dorado,2.5714285714285716,2022-01-01,377,390,352,38,17
Fresno,2.5714285714285716,2022-01-01,1734,1793,1617,176,209
Glenn,2.5714285714285716,2022-01-01,17,17,15,2,0
Humboldt,2.5714285714285716,2022-01-01,242,250,226,24,10
Imperial,2.5714285714285716,2022-01-01,458,474,428,46,57
Inyo,2.5714285714285716,2022-01-01,75,78,70,8,3
Kern,2.5714285714285716,2022-01-01,1712,1771,1598,173,126
Kings,2.5714285714285716,2022-01-01,330,341,308,33,17
Lake,2.5714285714285716,2022-01-01,54,56,51,5,2
Lassen,2.5714285714285716,2022-01-01,20,20,18,2,2
Los Angeles,2.5714285714285716,2022-01-01,58891,60904,54931,5973,1933
Madera,2.5714285714285716,2022-01-01,224,232,209,23,19
Marin,2.5714285714285716,2022-01-01,657,679,612,67,25
Mariposa,2.5714285714285716,2022-01-01,32,33,30,3,0
Mendocino,2.5714285714285716,2022-01-01,104,108,97,11,6
Merced,2.5714285714285716,2022-01-01,373,386,348,38,22
Modoc,2.5714285714285716,2022-01-01,8,8,7,1,0
Mono,2.5714285714285716,2022-01-01,35,36,32,4,2
Monterey,2.5714285714285716,2022-01-01,511,528,476,52,29
Napa,2.5714285714285716,2022-01-01,552,570,514,56,10
Nevada,2.5714285714285716,2022-01-01,204,211,190,21,6
Orange,2.5714285714285716,2022-01-01,14542,15039,13564,1475,540
Placer,2.5714285714285716,2022-01-01,930,962,868,94,142
Plumas,2.5714285714285716,2022-01-01,19,19,17,2,2
Riverside,2.5714285714285716,2022-01-01,9876,10212,9210,1002,578
Sacramento,2.5714285714285716,2022-01-01,4060,4198,3786,412,271
San Benito,2.5714285714285716,2022-01-01,197,204,184,20,5
San Bernardino,2.5714285714285716,2022-01-01,8990,9297,8385,912,668
San Diego,2.5714285714285716,2022-01-01,17936,18547,16725,1822,645
San Francisco,2.5714285714285716,2022-01-01,3424,3542,3195,347,89
San Joaquin,2.5714285714285716,2022-01-01,2267,2345,2115,230,98
San Luis Obispo,2.5714285714285716,2022-01-01,606,626,564,62,19
San Mateo,2.5714285714285716,2022-01-01,2779,2875,2593,282,41
Santa Barbara,2.5714285714285716,2022-01-01,1614,1670,1506,164,57
Santa Clara,2.5714285714285716,2022-01-01,7058,7301,6586,715,224
Santa Cruz,2.5714285714285716,2022-01-01,688,713,643,70,21
Shasta,2.5714285714285716,2022-01-01,178,184,166,18,13
Siskiyou,2.5714285714285716,2022-01-01,24,24,22,2,0
Solano,2.5714285714285716,2022-01-01,1123,1161,1047,114,77
Sonoma,2.5714285714285716,2022-01-01,1314,1358,1225,133,30
Stanislaus,2.5714285714285716,2022-01-01,1071,1109,1000,109,129
Sutter,2.5714285714285716,2022-01-01,180,186,168,18,0
Tehama,2.5714285714285716,2022-01-01,75,78,70,8,4
Trinity,2.5714285714285716,2022-01-01,5,5,5,0,0
Tulare,2.5714285714285716,2022-01-01,594,615,555,60,55
Tuolumne,2.5714285714285716,2022-01-01,131,135,122,13,6
Ventura,2.5714285714285716,2022-01-01,3957,4093,3692,401,129
Yolo,2.5714285714285716,2022-01-01,556,575,519,56,10
Yuba,2.5714285714285716,2022-01-01,154,160,144,16,22
Alameda,3,2022-01-04,11588,12103,10931,1172,231
Amador,3,2022-01-04,147,154,139,15,7
Butte,3,2022-01-04,752,785,709,76,40
Calaveras,3,2022-01-04,138,144,130,14,3
Colusa,3,2022-01-04,15,15,14,1,5
Contra Costa,3,2022-01-04,7526,7857,7096,761,139
Del Norte,3,2022-01-04,52,54,49,5,0
El Dorado,3,2022-01-04,702,732,661,71,15
Fresno,3,2022-01-04,4181,4366,3943,423,258
Glenn,3,2022-01-04,59,61,55,6,0
Humboldt,3,2022-01-04,524,547,494,53,16
Imperial,3,2022-01-04,1383,1444,1304,140,66
Inyo,3,2022-01-04,158,165,149,16,3
Kern,3,2022-01-04,4200,4385,3960,425,145
Kings,3,2022-01-04,701,732,661,71,19
Lake,3,2022-01-04,187,195,176,19,3
Lassen,3,2022-01-04,37,39,35,4,1
Los Angeles,3,2022-01-04,122013,127425,115085,12340,2649
Madera,3,2022-01-04,565,590,533,57,32
Marin,3,2022-01-04,1356,1415,1278,137,20
Mariposa,3,2022-01-04,76,79,71,8,0
Mendocino,3,2022-01-04,348,364,329,35,8
Merced,3,2022-01-04,1226,1280,1156,124,33
Modoc,3,2022-01-04,8,8,7,1,0
Mono,3,2022-01-04,141,147,133,14,1
Monterey,3,2022-01-04,1146,1197,1081,116,50
Napa,3,2022-01-04,1190,1243,1123,120,15
Nevada,3,2022-01-04,370,385,348,37,11
Orange,3,2022-01-04,25089,26197,23661,2536,702
Placer,3,2022-01-04,1676,1751,1581,170,145
Plumas,3,2022-01-04,40,42,38,4,1
Riverside,3,2022-01-04,19489,20349,18379,1970,771
Sacramento,3,2022-01-04,9211,9622,8690,932,313
San Benito,3,2022-01-04,433,453,409,44,5
San Bernardino,3,2022-01-04,17288,18053,16305,1748,787
San Diego,3,2022-01-04,35324,36885,33314,3571,750
San Francisco,3,2022-01-04,6503,6789,6132,657,123
San Joaquin,3,2022-01-04,4582,4786,4322,464,126
San Luis Obispo,3,2022-01-04,1691,1766,1595,171,31
San Mateo,3,2022-01-04,5413,5650,5103,547,59
Santa Barbara,3,2022-01-04,3460,3612,3262,350,64
Santa Clara,3,2022-01-04,14224,14849,13412,1437,316
Santa Cruz,3,2022-01-04,1671,1746,1577,169,17
Shasta,3,2022-01-04,379,396,358,38,52
Siskiyou,3,2022-01-04,49,51,46,5,2
Solano,3,2022-01-04,2320,2423,2188,235,83
Sonoma,3,2022-01-04,3199,3341,3017,324,35
Stanislaus,3,2022-01-04,2075,2167,1957,210,167
Sutter,3,2022-01-04,386,403,364,39,0
Tehama,3,2022-01-04,166,173,156,17,5
Trinity,3,2022-01-04,9,9,8,1,0
Tulare,3,2022-01-04,1408,1470,1328,142,73
Tuolumne,3,2022-01-04,269,281,254,27,15
Ventura,3,2022-01-04,6944,7249,6547,702,176
Yolo,3,2022-01-04,1653,1725,1558,167,12
Yuba,3,2022-01-04,300,313,283,30,22
Alameda,3.4285714285714284,2022-01-07,15257,16119,14531,1588,327
Amador,3.4285714285714284,2022-01-07,139,146,132,14,6
Butte,3.4285714285714284,2022-01-07,842,889,801,88,46
Calaveras,3.4285714285714284,2022-01-07,233,247,223,24,2
Colusa,3.4285714285714284,2022-01-07,43,46,41,5,7
Contra Costa,3.4285714285714284,2022-01-07,8505,8985,8100,885,176
Del Norte,3.4285714285714284,2022-01-07,81,86,78,8,2
El Dorado,3.4285714285714284,2022-01-07,890,941,848,93,13
Fresno,3.4285714285714284,2022-01-07,6215,6565,5918,647,315
Glenn,3.4285714285714284,2022-01-07,102,109,98,11,2
Humboldt,3.4285714285714284,2022-01-07,669,707,637,70,17
Imperial,3.4285714285714284,2022-01-07,1718,1815,1636,179,71
Inyo,3.4285714285714284,2022-01-07,208,219,197,22,3
Kern,3.4285714285714284,2022-01-07,4594,4852,4374,478,186
Kings,3.4285714285714284,2022-01-07,899,950,856,94,23
Lake,3.4285714285714284,2022-01-07,164,174,157,17,3
Lassen,3.4285714285714284,2022-01-07,58,61,55,6,2
Los Angeles,3.4285714285714284,2022-01-07,158611,167554,151048,16506,3361
Madera,3.4285714285714284,2022-01-07,808,853,769,84,34
Marin,3.4285714285714284,2022-01-07,1074,1135,1023,112,29
Mariposa,3.4285714285714284,2022-01-07,79,83,75,8,0
Mendocino,3.4285714285714284,2022-01-07,325,343,309,34,6
Merced,3.4285714285714284,2022-01-07,1689,1783,1607,176,41
Modoc,3.4285714285714284,2022-01-07,4,4,4,0,0
Mono,3.4285714285714284,2022-01-07,110,117,105,12,1
Monterey,3.4285714285714284,2022-01-07,1686,1781,1605,176,60
Napa,3.4285714285714284,2022-01-07,1208,1276,1150,126,16
Nevada,3.4285714285714284,2022-01-07,499,527,475,52,12
Orange,3.4285714285714284,2022-01-07,26137,27607,24888,2719,905
Placer,3.4285714285714284,2022-01-07,2206,2329,2100,229,177
Plumas,3.4285714285714284,2022-01-07,37,40,36,4,4
Riverside,3.4285714285714284,2022-01-07,21838,23068,20796,2272,861
Sacramento,3.4285714285714284,2022-01-07,11793,12456,11229,1227,394
San Benito,3.4285714285714284,2022-01-07,470,496,447,49,6
San Bernardino,3.4285714285714284,2022-01-07,21317,22517,20299,2218,952
San Diego,3.4285714285714284,2022-01-07,39693,41911,37784,4127,929
San Francisco,3.4285714285714284,2022-01-07,7256,7664,6909,755,165
San Joaquin,3.4285714285714284,2022-01-07,6602,6974,6287,687,156
San Luis Obispo,3.4285714285714284,2022-01-07,2161,2282,2057,225,34
San Mateo,3.4285714285714284,2022-01-07,5713,6037,5442,595,93
Santa Barbara,3.4285714285714284,2022-01-07,3739,3949,3560,389,105
Santa Clara,3.4285714285714284,2022-01-07,15620,16498,14873,1625,411
Santa Cruz,3.4285714285714284,2022-01-07,1952,2061,1858,203,20
Shasta,3.4285714285714284,2022-01-07,360,380,343,37,44
Siskiyou,3.4285714285714284,2022-01-07,42,45,41,4,4
Solano,3.4285714285714284,2022-01-07,3007,3175,2862,313,85
Sonoma,3.4285714285714284,2022-01-07,4040,4268,3848,420,64
Stanislaus,3.4285714285714284,2022-01-07,2906,3071,2768,303,176
Sutter,3.4285714285714284,2022-01-07,493,521,470,51,0
Tehama,3.4285714285714284,2022-01-07,244,258,233,25,13
Trinity,3.4285714285714284,2022-01-07,16,16,14,2,0
Tulare,3.4285714285714284,2022-01-07,2034,2149,1937,212,65
Tuolumne,3.4285714285714284,2022-01-07,293,309,279,30,15
Ventura,3.4285714285714284,2022-01-07,7240,7648,6895,753,222
Yolo,3.4285714285714284,2022-01-07,1545,1632,1471,161,11
Yuba,3.4285714285714284,2022-01-07,474,501,452,49,32
Alameda,3.857142857142857,2022-01-10,8186,8897,8026,871,363
Amador,3.857142857142857,2022-01-10,137,149,134,15,9
Butte,3.857142857142857,2022-01-10,664,722,651,71,60
Calaveras,3.857142857142857,2022-01-10,153,167,151,16,2
Colusa,3.857142857142857,2022-01-10,39,43,39,4,5
Contra Costa,3.857142857142857,2022-01-10,5737,6231,5621,610,207
Del Norte,3.857142857142857,2022-01-10,68,74,67,7,2
El Dorado,3.857142857142857,2022-01-10,558,607,548,59,16
Fresno,3.857142857142857,2022-01-10,4514,4910,4430,480,369
Glenn,3.857142857142857,2022-01-10,80,87,79,8,2
Humboldt,3.857142857142857,2022-01-10,451,490,442,48,21
Imperial,3.857142857142857,2022-01-10,1019,1113,1005,108,83
Inyo,3.857142857142857,2022-01-10,135,147,133,14,4
Kern,3.857142857142857,2022-01-10,3837,4178,3770,408,218
Kings,3.857142857142857,2022-01-10,1019,1111,1003,108,38
Lake,3.857142857142857,2022-01-10,161,175,158,17,1
Lassen,3.857142857142857,2022-01-10,78,85,77,8,1
Los Angeles,3.857142857142857,2022-01-10,81864,88921,80212,8709,3913
Madera,3.857142857142857,2022-01-10,576,627,566,61,28
Marin,3.857142857142857,2022-01-10,971,1054,951,103,26
Mariposa,3.857142857142857,2022-01-10,60,65,59,6,0
Mendocino,3.857142857142857,2022-01-10,340,370,334,36,10
Merced,3.857142857142857,2022-01-10,935,1022,922,100,44
Modoc,3.857142857142857,2022-01-10,3,3,3,0,0
Mono,3.857142857142857,2022-01-10,74,80,72,8,1
Monterey,3.857142857142857,2022-01-10,1176,1281,1156,125,59
Napa,3.857142857142857,2022-01-10,747,815,735,80,18
Nevada,3.857142857142857,2022-01-10,356,388,350,38,13
Orange,3.857142857142857,2022-01-10,15513,16884,15233,1651,1034
Placer,3.857142857142857,2022-01-10,1648,1793,1618,175,222
Plumas,3.857142857142857,2022-01-10,36,38,34,4,5
Riverside,3.857142857142857,2022-01-10,14704,16007,14442,1565,938
Sacramento,3.857142857142857,2022-01-10,7040,7663,6914,749,491
San Benito,3.857142857142857,2022-01-10,378,411,371,40,5
San Bernardino,3.857142857142857,2022-01-10,12759,13885,12527,1358,1010
San Diego,3.857142857142857,2022-01-10,22840,24834,22404,2430,1087
San Francisco,3.857142857142857,2022-01-10,4012,4355,3928,427,202
San Joaquin,3.857142857142857,2022-01-10,4559,4973,4488,485,202
San Luis Obispo,3.857142857142857,2022-01-10,1028,1122,1013,109,39
San Mateo,3.857142857142857,2022-01-10,3867,4203,3791,412,124
Santa Barbara,3.857142857142857,2022-01-10,2824,3075,2774,301,94
Santa Clara,3.857142857142857,2022-01-10,11288,12277,11076,1201,456
Santa Cruz,3.857142857142857,2022-01-10,1519,1651,1489,162,27
Shasta,3.857142857142857,2022-01-10,274,300,271,29,49
Siskiyou,3.857142857142857,2022-01-10,40,43,39,4,4
Solano,3.857142857142857,2022-01-10,1876,2042,1842,200,121
Sonoma,3.857142857142857,2022-01-10,2474,2695,2432,263,80
Stanislaus,3.857142857142857,2022-01-10,2152,2344,2115,229,212
Sutter,3.857142857142857,2022-01-10,498,542,489,53,0
Tehama,3.857142857142857,2022-01-10,171,187,169,18,14
Trinity,3.857142857142857,2022-01-10,14,15,14,1,0
Tulare,3.857142857142857,2022-01-10,1824,1989,1795,194,78
Tuolumne,3.857142857142857,2022-01-10,288,313,282,31,14
Ventura,3.857142857142857,2022-01-10,4923,5359,4835,524,270
Yolo,3.857142857142857,2022-01-10,1055,1148,1036,112,7
Yuba,3.857142857142857,2022-01-10,333,361,326,35,49
Alameda,4.285714285714286,2022-01-13,11560,13485,12254,1231,438
Amador,4.285714285714286,2022-01-13,134,156,142,14,8
Butte,4.285714285714286,2022-01-13,730,848,770,78,54
Calaveras,4.285714285714286,2022-01-13,274,319,290,29,4
Colusa,4.285714285714286,2022-01-13,72,84,76,8,3
Contra Costa,4.285714285714286,2022-01-13,7247,8467,7695,772,246
Del Norte,4.285714285714286,2022-01-13,73,86,78,8,3
El Dorado,4.285714285714286,2022-01-13,805,934,848,86,13
Fresno,4.285714285714286,2022-01-13,7116,8294,7537,757,412
Glenn,4.285714285714286,2022-01-13,101,117,106,11,0
Humboldt,4.285714285714286,2022-01-13,450,520,472,48,36
Imperial,4.285714285714286,2022-01-13,1476,1718,1561,157,95
Inyo,4.285714285714286,2022-01-13,175,204,185,19,4
Kern,4.285714285714286,2022-01-13,5054,5877,5339,538,248
Kings,4.285714285714286,2022-01-13,1342,1554,1411,143,42
Lake,4.285714285714286,2022-01-13,137,160,145,15,4
Lassen,4.285714285714286,2022-01-13,123,145,132,13,0
Los Angeles,4.285714285714286,2022-01-13,94319,110311,100263,10048,4407
Madera,4.285714285714286,2022-01-13,853,988,897,91,40
Marin,4.285714285714286,2022-01-13,1047,1233,1121,112,35
Mariposa,4.285714285714286,2022-01-13,69,78,71,7,0
Mendocino,4.285714285714286,2022-01-13,318,366,332,34,13
Merced,4.285714285714286,2022-01-13,1753,2041,1854,187,49
Modoc,4.285714285714286,2022-01-13,4,4,4,0,0
Mono,4.285714285714286,2022-01-13,103,118,107,11,0
Monterey,4.285714285714286,2022-01-13,1670,1952,1774,178,66
Napa,4.285714285714286,2022-01-13,661,772,702,70,30
Nevada,4.285714285714286,2022-01-13,469,545,495,50,14
Orange,4.285714285714286,2022-01-13,17116,19923,18101,1822,1174
Placer,4.285714285714286,2022-01-13,1748,2038,1852,186,226
Plumas,4.285714285714286,2022-01-13,50,59,54,5,5
Riverside,4.285714285714286,2022-01-13,17402,20238,18386,1852,1033
Sacramento,4.285714285714286,2022-01-13,9853,11501,10452,1049,520
San Benito,4.285714285714286,2022-01-13,358,416,378,38,8
San Bernardino,4.285714285714286,2022-01-13,17095,19858,18040,1818,1150
San Diego,4.285714285714286,2022-01-13,28098,32675,29685,2990,1204
San Francisco,4.285714285714286,2022-01-13,4910,5773,5250,523,233
San Joaquin,4.285714285714286,2022-01-13,5878,6830,6205,625,222
San Luis Obispo,4.285714285714286,2022-01-13,1710,1985,1803,182,45
San Mateo,4.285714285714286,2022-01-13,4753,5537,5031,506,150
Santa Barbara,4.285714285714286,2022-01-13,3115,3627,3296,331,104
Santa Clara,4.285714285714286,2022-01-13,13699,15949,14491,1458,491
Santa Cruz,4.285714285714286,2022-01-13,1713,1993,1811,182,35
Shasta,4.285714285714286,2022-01-13,466,542,492,50,68
Siskiyou,4.285714285714286,2022-01-13,84,99,90,9,4
Solano,4.285714285714286,2022-01-13,2528,2965,2696,269,134
Sonoma,4.285714285714286,2022-01-13,3686,4294,3902,392,85
Stanislaus,4.285714285714286,2022-01-13,2957,3447,3132,315,231
Sutter,4.285714285714286,2022-01-13,496,576,523,53,0
Tehama,4.285714285714286,2022-01-13,217,250,227,23,20
Trinity,4.285714285714286,2022-01-13,9,10,9,1,0
Tulare,4.285714285714286,2022-01-13,2738,3169,2878,291,97
Tuolumne,4.285714285714286,2022-01-13,241,280,254,26,11
Ventura,4.285714285714286,2022-01-13,5059,5867,5329,538,313
Yolo,4.285714285714286,2022-01-13,1221,1414,1284,130,14
Yuba,4.285714285714286,2022-01-13,487,564,512,52,35
