county,time,date,cases,est_cases,est_omicron_cases,est_other_cases,tests,est_tests,est_omicron_tests,est_other_tests,hospitalizations,deaths,est_deaths,icu,cum_deaths,cum_est_deaths,prev_cum_deaths,prev_cum_est_deaths
Alameda,1,2021-12-20,2965,2966,1411,1555,89635,89711,41890,47821,47,9,9,14,1545,1545,1536,1536
Amador,1,2021-12-20,49,49,18,31,1715,1715,602,1113,2,0,0,3,70,70,70,70
Butte,1,2021-12-20,193,193,101,92,4385,4390,2288,2102,24,5,5,1,359,359,354,354
Calaveras,1,2021-12-20,59,59,23,36,1520,1520,582,938,1,2,2,0,92,92,90,90
Colusa,1,2021-12-20,11,11,5,6,397,397,170,227,1,0,0,0,21,21,21,21
Contra Costa,1,2021-12-20,1686,1686,590,1096,43182,43219,14845,28374,27,4,4,7,1081,1081,1077,1077
Del Norte,1,2021-12-20,19,19,8,11,1378,1378,570,808,0,0,0,0,42,42,42,42
El Dorado,1,2021-12-20,237,237,93,144,4466,4471,1730,2741,4,4,4,3,178,178,174,174
Fresno,1,2021-12-20,1056,1056,380,676,25400,25421,9049,16372,131,19,19,45,2419,2419,2400,2400
Glenn,1,2021-12-20,20,20,8,12,462,462,185,277,0,0,0,0,38,38,38,38
Humboldt,1,2021-12-20,164,164,67,97,3774,3777,1531,2246,11,1,1,2,120,120,119,119
Imperial,1,2021-12-20,586,586,225,361,5606,5611,2138,3473,40,9,9,27,817,817,808,808
Inyo,1,2021-12-20,31,31,14,17,358,358,154,204,1,1,1,0,49,49,48,48
Kern,1,2021-12-20,928,928,401,527,26093,26115,11169,14946,84,24,24,27,2022,2022,1998,1998
Kings,1,2021-12-20,243,243,94,149,6913,6918,2640,4278,15,6,6,3,387,387,381,381
Lake,1,2021-12-20,37,37,13,24,1317,1317,464,853,0,0,0,0,116,116,116,116
Lassen,1,2021-12-20,11,11,5,6,2387,2387,1093,1294,0,0,0,0,54,54,54,54
Los Angeles,1,2021-12-20,31592,31619,22002,9617,985550,986378,676778,309600,574,107,107,174,27371,27371,27264,27264
Madera,1,2021-12-20,159,159,56,103,6016,6021,2124,3897,9,3,3,5,332,332,329,329
Marin,1,2021-12-20,566,566,210,356,11811,11821,4298,7523,5,1,1,1,256,256,255,255
Mariposa,1,2021-12-20,21,21,7,14,448,448,154,294,0,0,0,0,21,21,21,21
Mendocino,1,2021-12-20,91,91,27,64,2686,2686,789,1897,3,2,2,4,104,104,102,102
Merced,1,2021-12-20,323,323,138,185,5611,5616,2366,3250,11,6,6,12,693,693,687,687
Modoc,1,2021-12-20,5,5,2,3,67,67,30,37,2,0,0,0,6,6,6,6
Mono,1,2021-12-20,37,37,10,27,310,310,80,230,1,0,0,0,4,4,4,4
Monterey,1,2021-12-20,479,479,125,354,13245,13257,3420,9837,23,3,3,8,642,642,639,639
Napa,1,2021-12-20,229,229,106,123,5390,5395,2434,2961,2,1,1,2,108,108,107,107
Nevada,1,2021-12-20,161,161,58,103,2766,2767,1000,1767,4,1,1,2,110,110,109,109
Orange,1,2021-12-20,4859,4862,2403,2459,99357,99440,48435,51005,132,34,34,56,5998,5998,5964,5964
Placer,1,2021-12-20,547,547,187,360,11149,11158,3771,7387,53,6,6,24,501,501,495,495
Plumas,1,2021-12-20,16,16,6,10,513,513,195,318,0,0,0,0,12,12,12,12
Riverside,1,2021-12-20,5594,5600,2348,3252,78330,78396,32475,45921,238,40,40,82,5578,5578,5538,5538
Sacramento,1,2021-12-20,2144,2144,856,1288,53802,53846,21276,32570,101,21,21,41,2495,2495,2474,2474
San Benito,1,2021-12-20,92,92,41,51,1924,1924,859,1065,2,3,3,2,81,81,78,78
San Bernardino,1,2021-12-20,5004,5008,2367,2641,79683,79750,37205,42545,299,65,65,112,6505,6505,6440,6440
San Diego,1,2021-12-20,8682,8690,5939,2751,149613,149738,101610,48128,249,29,29,94,4478,4478,4449,4449
San Francisco,1,2021-12-20,2981,2982,739,2243,56926,56974,13799,43175,28,3,3,10,692,692,689,689
San Joaquin,1,2021-12-20,962,962,362,600,25287,25309,9387,15922,48,13,13,27,1972,1972,1959,1959
San Luis Obispo,1,2021-12-20,423,423,186,237,9997,10004,4354,5650,11,3,3,6,371,371,368,368
San Mateo,1,2021-12-20,1557,1557,769,788,50578,50620,24523,26097,9,0,0,5,600,600,600,600
Santa Barbara,1,2021-12-20,788,788,326,462,15819,15832,6440,9392,18,8,8,12,570,570,562,562
Santa Clara,1,2021-12-20,2946,2947,1980,967,118105,118205,78337,39868,85,8,8,38,1978,1978,1970,1970
Santa Cruz,1,2021-12-20,404,404,182,222,19810,19826,8764,11062,11,2,2,5,230,230,228,228
Shasta,1,2021-12-20,164,164,66,98,6035,6040,2394,3646,28,8,8,8,448,448,440,440
Siskiyou,1,2021-12-20,20,20,9,11,449,449,207,242,2,2,2,2,63,63,61,61
Solano,1,2021-12-20,496,496,207,289,14767,14781,6081,8700,21,4,4,5,388,388,384,384
Sonoma,1,2021-12-20,751,751,319,432,20779,20796,8675,12121,22,1,1,6,419,419,418,418
Stanislaus,1,2021-12-20,670,670,210,460,13027,13038,4041,8997,90,13,13,22,1431,1431,1418,1418
Sutter,1,2021-12-20,123,123,51,72,2313,2313,946,1367,0,2,2,0,193,193,191,191
Tehama,1,2021-12-20,52,52,17,35,1324,1324,425,899,4,0,0,3,165,165,165,165
Trinity,1,2021-12-20,1,1,0,1,98,98,31,67,0,1,1,0,19,19,18,18
Tulare,1,2021-12-20,403,403,125,278,12352,12364,3803,8561,36,19,19,13,1309,1309,1290,1290
Tuolumne,1,2021-12-20,97,97,35,62,1939,1939,693,1246,7,0,0,0,153,153,153,153
Ventura,1,2021-12-20,2046,2047,1052,995,39234,39266,19915,19351,62,9,9,14,1216,1216,1207,1207
Yolo,1,2021-12-20,316,316,141,175,24689,24709,10825,13884,4,0,0,1,270,270,270,270
Yuba,1,2021-12-20,100,100,43,57,1872,1872,798,1074,3,0,0,4,101,101,101,101
Alameda,2,2021-12-27,7418,7426,3980,3446,87238,87320,46155,41165,89,12,12,19,1557,1557,1545,1545
Amador,2,2021-12-27,92,92,38,54,1445,1445,590,855,2,0,0,3,70,70,70,70
Butte,2,2021-12-27,540,540,318,222,4552,4556,2665,1891,37,3,3,3,362,362,359,359
Calaveras,2,2021-12-27,100,100,45,55,989,989,442,547,1,1,1,1,93,93,92,92
Colusa,2,2021-12-27,27,27,14,13,241,241,118,123,4,0,0,0,21,21,21,21
Contra Costa,2,2021-12-27,5133,5138,2104,3034,46302,46347,18600,27747,44,3,3,16,1084,1084,1081,1081
Del Norte,2,2021-12-27,25,25,12,13,1423,1423,679,744,0,0,0,1,42,42,42,42
El Dorado,2,2021-12-27,513,513,232,281,4079,4083,1815,2268,7,0,0,4,178,178,178,178
Fresno,2,2021-12-27,2198,2199,930,1269,24261,24284,10108,14176,122,16,16,41,2435,2435,2419,2419
Glenn,2,2021-12-27,53,53,24,29,451,451,207,244,0,0,0,0,38,38,38,38
Humboldt,2,2021-12-27,500,500,237,263,3457,3460,1619,1841,10,1,1,0,121,121,120,120
Imperial,2,2021-12-27,881,881,396,485,6007,6012,2663,3349,35,10,10,26,827,827,817,817
Inyo,2,2021-12-27,109,109,54,55,447,447,219,228,0,1,1,0,50,50,49,49
Kern,2,2021-12-27,1987,1988,996,992,22590,22612,11175,11437,79,18,18,36,2040,2040,2022,2022
Kings,2,2021-12-27,505,505,229,276,5481,5486,2435,3051,17,1,1,3,388,388,387,387
Lake,2,2021-12-27,67,67,28,39,1203,1203,495,708,0,1,1,0,117,117,116,116
Lassen,2,2021-12-27,21,21,11,10,2241,2241,1159,1082,0,0,0,0,54,54,54,54
Los Angeles,2,2021-12-27,96023,96117,71585,24532,717639,718326,531401,186925,862,115,115,207,27486,27486,27371,27371
Madera,2,2021-12-27,341,341,144,197,4208,4212,1749,2463,9,2,2,4,334,334,332,332
Marin,2,2021-12-27,1607,1607,688,919,16779,16795,7093,9702,3,0,0,1,256,256,256,256
Mariposa,2,2021-12-27,36,36,15,21,493,493,195,298,0,0,0,0,21,21,21,21
Mendocino,2,2021-12-27,152,152,55,97,2493,2495,861,1634,5,0,0,2,104,104,104,104
Merced,2,2021-12-27,651,651,321,330,5096,5101,2472,2629,11,7,7,10,700,700,693,693
Modoc,2,2021-12-27,3,3,1,2,38,38,19,19,1,0,0,0,6,6,6,6
Mono,2,2021-12-27,123,123,38,85,366,366,110,256,1,0,0,0,4,4,4,4
Monterey,2,2021-12-27,1011,1011,319,692,12876,12887,3973,8914,21,3,3,11,645,645,642,642
Napa,2,2021-12-27,814,814,425,389,6659,6665,3446,3219,6,0,0,1,108,108,108,108
Nevada,2,2021-12-27,236,236,100,136,1983,1984,815,1169,6,1,1,1,111,111,110,110
Orange,2,2021-12-27,17985,18002,10041,7961,130270,130396,71909,58487,256,30,30,66,6028,6028,5998,5998
Placer,2,2021-12-27,1233,1233,495,738,10763,10774,4263,6511,63,2,2,27,503,503,501,501
Plumas,2,2021-12-27,18,18,8,10,299,299,129,170,0,0,0,0,12,12,12,12
Riverside,2,2021-12-27,13687,13700,6608,7092,87465,87549,41736,45813,306,53,53,81,5631,5631,5578,5578
Sacramento,2,2021-12-27,5191,5197,2413,2784,52692,52742,24126,28616,135,22,22,44,2517,2517,2495,2495
San Benito,2,2021-12-27,317,317,163,154,2305,2306,1173,1133,1,3,3,3,84,84,81,81
San Bernardino,2,2021-12-27,14352,14366,7719,6647,87885,87968,46495,41473,341,69,69,141,6574,6574,6505,6505
San Diego,2,2021-12-27,27102,27128,19937,7191,177581,177752,129754,47998,315,33,33,96,4511,4511,4478,4478
San Francisco,2,2021-12-27,6858,6865,2012,4853,65851,65913,19038,46875,31,1,1,14,693,693,692,692
San Joaquin,2,2021-12-27,2363,2364,1043,1321,22767,22789,9890,12899,61,15,15,25,1987,1987,1972,1972
San Luis Obispo,2,2021-12-27,1152,1152,582,570,11183,11194,5569,5625,11,1,1,8,372,372,371,371
San Mateo,2,2021-12-27,5278,5283,2933,2350,55493,55546,30398,25148,19,2,2,5,602,602,600,600
Santa Barbara,2,2021-12-27,2141,2142,1022,1120,15276,15291,7178,8113,33,5,5,10,575,575,570,570
Santa Clara,2,2021-12-27,9012,9021,6528,2493,105680,105781,75886,29895,95,10,10,38,1988,1988,1978,1978
Santa Cruz,2,2021-12-27,946,946,489,457,12415,12427,6307,6120,11,0,0,2,230,230,230,230
Shasta,2,2021-12-27,261,261,122,139,4621,4625,2124,2501,32,5,5,12,453,453,448,448
Siskiyou,2,2021-12-27,21,21,11,10,360,360,190,170,0,0,0,0,63,63,63,63
Solano,2,2021-12-27,1297,1298,626,672,17081,17097,8111,8986,25,5,5,5,393,393,388,388
Sonoma,2,2021-12-27,1912,1913,933,980,21666,21686,10435,11251,19,1,1,5,420,420,419,419
Stanislaus,2,2021-12-27,1252,1252,469,783,11150,11162,4118,7044,94,17,17,18,1448,1448,1431,1431
Sutter,2,2021-12-27,225,225,108,117,2132,2133,1007,1126,0,2,2,0,195,195,193,193
Tehama,2,2021-12-27,103,103,40,63,1105,1105,418,687,6,2,2,3,167,167,165,165
Trinity,2,2021-12-27,4,4,2,2,101,101,37,64,0,0,0,0,19,19,19,19
Tulare,2,2021-12-27,814,814,301,513,11117,11129,4062,7067,36,10,10,9,1319,1319,1309,1309
Tuolumne,2,2021-12-27,170,170,72,98,1670,1670,692,978,5,0,0,1,153,153,153,153
Ventura,2,2021-12-27,5720,5726,3310,2416,39324,39362,22520,16842,66,8,8,19,1224,1224,1216,1216
Yolo,2,2021-12-27,822,822,419,403,22112,22132,11088,11044,7,0,0,4,270,270,270,270
Yuba,2,2021-12-27,164,164,81,83,1532,1532,748,784,8,1,1,4,102,102,101,101
Alameda,3,2022-01-03,17440,17458,10360,7098,116956,117080,69346,47734,156,5,5,31,1562,1562,1557,1557
Amador,3,2022-01-03,218,218,104,114,2179,2180,1030,1150,5,1,1,2,71,71,70,70
Butte,3,2022-01-03,1203,1203,779,424,6871,6878,4435,2443,32,0,0,4,362,362,362,362
Calaveras,3,2022-01-03,234,234,121,113,1306,1306,667,639,0,1,1,1,94,94,93,93
Colusa,3,2022-01-03,47,47,26,21,392,392,217,175,5,0,0,0,21,21,21,21
Contra Costa,3,2022-01-03,13484,13497,6278,7219,69038,69111,32063,37048,76,10,10,21,1094,1094,1084,1084
Del Norte,3,2022-01-03,86,86,47,39,2132,2133,1144,989,0,0,0,0,42,42,42,42
El Dorado,3,2022-01-03,1281,1281,655,626,6063,6070,3083,2987,7,4,4,6,182,182,178,178
Fresno,3,2022-01-03,6412,6419,3082,3337,39125,39165,18697,20468,175,14,14,44,2449,2449,2435,2435
Glenn,3,2022-01-03,76,76,39,37,610,610,318,292,0,1,1,0,39,39,38,38
Humboldt,3,2022-01-03,880,880,470,410,5300,5306,2815,2491,9,1,1,3,122,122,121,121
Imperial,3,2022-01-03,1876,1877,955,922,9255,9266,4679,4587,35,14,14,29,841,841,827,827
Inyo,3,2022-01-03,265,265,147,118,713,713,394,319,3,0,0,0,50,50,50,50
Kern,3,2022-01-03,5834,5842,3275,2567,35871,35908,20016,15892,100,16,16,32,2056,2056,2040,2040
Kings,3,2022-01-03,1094,1094,560,534,8512,8521,4315,4206,13,3,3,5,391,391,388,388
Lake,3,2022-01-03,220,220,106,114,1777,1778,847,931,1,0,0,1,117,117,117,117
Lassen,3,2022-01-03,61,61,35,26,3115,3116,1805,1311,2,0,0,0,54,54,54,54
Los Angeles,3,2022-01-03,203983,204196,160592,43604,1086691,1087832,855826,232006,1937,149,149,303,27635,27635,27486,27486
Madera,3,2022-01-03,831,831,398,433,6362,6369,3027,3342,17,3,3,6,337,337,334,334
Marin,3,2022-01-03,2367,2368,1150,1218,17671,17689,8539,9150,15,1,1,3,257,257,256,256
Mariposa,3,2022-01-03,103,103,48,55,657,657,304,353,0,0,0,0,21,21,21,21
Mendocino,3,2022-01-03,452,452,186,266,3572,3576,1456,2120,7,1,1,2,105,105,104,104
Merced,3,2022-01-03,1546,1547,850,697,8535,8544,4664,3880,3,9,9,4,709,709,700,700
Modoc,3,2022-01-03,15,15,8,7,59,59,33,26,0,0,0,0,6,6,6,6
Mono,3,2022-01-03,180,180,65,115,436,436,156,280,2,0,0,0,4,4,4,4
Monterey,3,2022-01-03,2460,2461,906,1555,20619,20638,7547,13091,30,4,4,10,649,649,645,645
Napa,3,2022-01-03,1855,1856,1076,780,11751,11763,6794,4969,9,1,1,3,109,109,108,108
Nevada,3,2022-01-03,646,646,313,333,3070,3073,1486,1587,7,1,1,3,112,112,111,111
Orange,3,2022-01-03,45483,45532,27822,17710,220089,220320,134418,85902,504,33,33,110,6061,6061,6028,6028
Placer,3,2022-01-03,2869,2871,1316,1555,15058,15074,6864,8210,113,15,15,24,518,518,503,503
Plumas,3,2022-01-03,54,54,27,27,496,496,248,248,1,0,0,0,12,12,12,12
Riverside,3,2022-01-03,32026,32060,17316,14744,138490,138635,74548,64087,564,54,54,94,5685,5685,5631,5631
Sacramento,3,2022-01-03,14126,14139,7383,6756,80807,80892,42042,38850,219,25,25,57,2542,2542,2517,2517
San Benito,3,2022-01-03,736,736,420,316,3449,3453,1970,1483,3,1,1,2,85,85,84,84
San Bernardino,3,2022-01-03,33810,33845,20019,13826,135017,135159,79664,55495,571,92,92,136,6666,6666,6574,6574
San Diego,3,2022-01-03,61064,61126,47485,13641,253247,253513,196836,56677,561,33,33,121,4544,4544,4511,4511
San Francisco,3,2022-01-03,11424,11436,3972,7464,85447,85537,29514,56023,78,5,5,22,698,698,693,693
San Joaquin,3,2022-01-03,6968,6976,3478,3498,36020,36057,17863,18194,80,13,13,27,2000,2000,1987,1987
San Luis Obispo,3,2022-01-03,2471,2472,1386,1086,15977,15993,8934,7059,24,5,5,7,377,377,372,372
San Mateo,3,2022-01-03,10627,10640,6514,4126,81881,81967,50088,31879,37,4,4,7,606,606,602,602
Santa Barbara,3,2022-01-03,5322,5328,2852,2476,28185,28215,15064,13151,53,5,5,7,580,580,575,575
Santa Clara,3,2022-01-03,22674,22697,17449,5248,166051,166225,127612,38613,186,10,10,58,1998,1998,1988,1988
Santa Cruz,3,2022-01-03,2403,2404,1385,1019,21645,21667,12488,9179,15,5,5,3,235,235,230,230
Shasta,3,2022-01-03,598,598,316,282,6169,6174,3228,2946,33,2,2,13,455,455,453,453
Siskiyou,3,2022-01-03,74,74,44,30,589,589,347,242,0,0,0,0,63,63,63,63
Solano,3,2022-01-03,4067,4071,2180,1891,26190,26218,14027,12191,54,2,2,9,395,395,393,393
Sonoma,3,2022-01-03,4540,4544,2482,2062,32189,32223,17548,14675,25,7,7,4,427,427,420,420
Stanislaus,3,2022-01-03,3332,3334,1436,1898,17981,18000,7695,10305,129,9,9,20,1457,1457,1448,1448
Sutter,3,2022-01-03,547,547,296,251,2980,2982,1595,1387,0,2,2,0,197,197,195,195
Tehama,3,2022-01-03,211,211,94,117,1453,1454,644,810,4,1,1,2,168,168,167,167
Trinity,3,2022-01-03,13,13,6,7,107,107,46,61,0,0,0,0,19,19,19,19
Tulare,3,2022-01-03,2128,2129,912,1217,16009,16026,6783,9243,57,5,5,7,1324,1324,1319,1319
Tuolumne,3,2022-01-03,384,384,186,198,2547,2548,1229,1319,7,3,3,0,156,156,153,153
Ventura,3,2022-01-03,12667,12679,7991,4688,59648,59710,37585,22125,136,11,11,28,1235,1235,1224,1224
Yolo,3,2022-01-03,2323,2324,1325,999,31690,31724,17945,13779,8,3,3,3,273,273,270,270
Yuba,3,2022-01-03,472,472,262,210,2333,2334,1286,1048,17,1,1,6,103,103,102,102
Alameda,4,2022-01-10,30920,30954,20058,10896,193698,193913,125755,68158,277,15,15,46,1577,1577,1562,1562
Amador,4,2022-01-10,391,391,209,182,2728,2731,1450,1281,4,0,0,4,71,71,71,71
Butte,4,2022-01-10,2001,2001,1396,605,10451,10463,7289,3174,55,2,2,4,364,364,362,362
Calaveras,4,2022-01-10,522,522,299,223,2606,2609,1480,1129,0,1,1,2,95,95,94,94
Colusa,4,2022-01-10,104,104,64,40,754,754,460,294,5,0,0,0,21,21,21,21
Contra Costa,4,2022-01-10,19517,19539,10235,9304,102098,102211,53522,48689,152,12,12,24,1106,1106,1094,1094
Del Norte,4,2022-01-10,178,178,106,72,3956,3960,2364,1596,2,0,0,0,42,42,42,42
El Dorado,4,2022-01-10,2207,2207,1256,951,9356,9368,5328,4040,14,6,6,2,188,188,182,182
Fresno,4,2022-01-10,13121,13135,7099,6036,60602,60668,32715,27953,301,14,14,47,2463,2463,2449,2449
Glenn,4,2022-01-10,219,219,127,92,938,938,544,394,2,0,0,0,39,39,39,39
Humboldt,4,2022-01-10,1401,1401,827,574,8363,8373,4935,3438,18,5,5,2,127,127,122,122
Imperial,4,2022-01-10,3624,3629,2051,1578,13980,13997,7892,6105,58,11,11,25,852,852,841,841
Inyo,4,2022-01-10,408,408,248,160,1356,1356,826,530,4,2,2,0,52,52,50,50
Kern,4,2022-01-10,11935,11948,7347,4601,57111,57175,35119,22056,181,26,26,35,2082,2082,2056,2056
Kings,4,2022-01-10,2414,2415,1382,1033,13011,13026,7409,5617,33,1,1,4,392,392,391,391
Lake,4,2022-01-10,499,499,268,231,2760,2763,1478,1285,0,3,3,1,120,120,117,117
Lassen,4,2022-01-10,194,194,124,70,3435,3439,2186,1253,1,0,0,0,54,54,54,54
Los Angeles,4,2022-01-10,328812,329177,270935,58242,1914355,1916473,1577917,338556,3253,268,268,513,27903,27903,27635,27635
Madera,4,2022-01-10,1910,1910,1027,883,10379,10391,5553,4838,19,1,1,6,338,338,337,337
Marin,4,2022-01-10,2938,2941,1602,1339,21009,21033,11449,9584,18,3,3,5,260,260,257,257
Mariposa,4,2022-01-10,199,199,105,94,1158,1158,607,551,0,1,1,0,22,22,21,21
Mendocino,4,2022-01-10,873,873,410,463,5533,5539,2581,2958,8,2,2,2,107,107,105,105
Merced,4,2022-01-10,3683,3688,2233,1455,14504,14521,8778,5743,33,10,10,11,719,719,709,709
Modoc,4,2022-01-10,13,13,8,5,109,109,67,42,0,0,0,0,6,6,6,6
Mono,4,2022-01-10,253,253,106,147,863,863,360,503,1,1,1,0,5,5,4,4
Monterey,4,2022-01-10,4973,4978,2116,2862,33212,33248,14058,19190,44,5,5,12,654,654,649,649
Napa,4,2022-01-10,2650,2653,1684,969,14346,14363,9110,5253,14,1,1,4,110,110,109,109
Nevada,4,2022-01-10,1184,1184,643,541,5232,5238,2842,2396,10,2,2,3,114,114,112,112
Orange,4,2022-01-10,60012,60077,39988,20089,317545,317896,211660,106236,854,100,100,159,6161,6161,6061,6061
Placer,4,2022-01-10,5225,5231,2710,2521,22541,22566,11671,10895,179,6,6,29,524,524,518,518
Plumas,4,2022-01-10,142,142,79,63,803,803,446,357,5,0,0,0,12,12,12,12
Riverside,4,2022-01-10,48248,48300,28875,19425,187741,187949,112330,75619,762,83,83,139,5768,5768,5685,5685
Sacramento,4,2022-01-10,27461,27491,15908,11583,122236,122371,70821,51550,375,37,37,89,2579,2579,2542,2542
San Benito,4,2022-01-10,1037,1037,653,384,4594,4600,2899,1701,3,1,1,2,86,86,85,85
San Bernardino,4,2022-01-10,50654,50711,32850,17861,192682,192896,124900,67996,784,113,113,187,6779,6779,6666,6666
San Diego,4,2022-01-10,82777,82869,67522,15347,329983,330348,269213,61135,895,63,63,166,4607,4607,4544,4544
San Francisco,4,2022-01-10,15071,15088,6031,9057,117188,117317,46967,70350,158,12,12,35,710,710,698,698
San Joaquin,4,2022-01-10,14436,14453,8052,6401,66517,66591,37041,29550,151,15,15,45,2015,2015,2000,2000
San Luis Obispo,4,2022-01-10,4334,4339,2677,1662,21640,21663,13383,8280,30,2,2,7,379,379,377,377
San Mateo,4,2022-01-10,14982,15000,9991,5009,112923,113048,75290,37758,95,5,5,16,611,611,606,606
Santa Barbara,4,2022-01-10,8533,8543,5057,3486,47377,47430,28080,19350,84,9,9,10,589,589,580,580
Santa Clara,4,2022-01-10,34905,34943,28195,6748,263227,263519,212597,50922,350,26,26,68,2024,2024,1998,1998
Santa Cruz,4,2022-01-10,4541,4547,2864,1683,42794,42842,26996,15846,25,2,2,2,237,237,235,235
Shasta,4,2022-01-10,1055,1055,616,439,8396,8404,4892,3512,37,7,7,12,462,462,455,455
Siskiyou,4,2022-01-10,120,120,77,43,919,919,591,328,3,1,1,1,64,64,63,63
Solano,4,2022-01-10,6911,6917,4122,2795,37186,37227,22192,15035,94,6,6,15,401,401,395,395
Sonoma,4,2022-01-10,8861,8872,5345,3527,47193,47246,28482,18764,72,9,9,8,436,436,427,427
Stanislaus,4,2022-01-10,6732,6740,3302,3438,29297,29329,14329,15000,173,13,13,19,1470,1470,1457,1457
Sutter,4,2022-01-10,1247,1247,744,503,5061,5066,3008,2058,0,2,2,0,199,199,197,197
Tehama,4,2022-01-10,512,512,257,255,2479,2480,1240,1240,13,1,1,1,169,169,168,168
Trinity,4,2022-01-10,38,38,19,19,274,274,134,140,0,0,0,0,19,19,19,19
Tulare,4,2022-01-10,5195,5201,2534,2667,24090,24116,11691,12425,66,9,9,8,1333,1333,1324,1324
Tuolumne,4,2022-01-10,804,804,435,369,4178,4183,2259,1924,13,1,1,1,157,157,156,156
Ventura,4,2022-01-10,17504,17522,11983,5539,88195,88293,60356,27937,227,22,22,34,1257,1257,1235,1235
Yolo,4,2022-01-10,3783,3788,2358,1430,48245,48298,30037,18261,6,3,3,1,276,276,273,273
Yuba,4,2022-01-10,1022,1022,624,398,4103,4108,2504,1604,41,0,0,7,103,103,103,103
Alameda,5,2022-01-17,24997,25026,17554,7472,170347,170547,119568,50979,366,32,32,62,1609,1609,1577,1577
Amador,5,2022-01-17,476,476,282,194,3558,3561,2083,1478,10,2,2,3,73,73,71,71
Butte,5,2022-01-17,2064,2064,1539,525,9327,9338,6957,2381,58,6,6,6,370,370,364,364
Calaveras,5,2022-01-17,564,564,353,211,2469,2471,1542,929,3,2,2,3,97,97,95,95
Colusa,5,2022-01-17,162,162,108,54,719,719,476,243,3,0,0,0,21,21,21,21
Contra Costa,5,2022-01-17,16103,16122,9413,6709,87901,88004,51300,36704,198,22,22,41,1128,1128,1106,1106
Del Norte,5,2022-01-17,200,200,131,69,3758,3763,2432,1331,2,0,0,1,42,42,42,42
El Dorado,5,2022-01-17,1988,1989,1243,746,8064,8073,5047,3026,9,4,4,2,192,192,188,188
Fresno,5,2022-01-17,16956,16975,10170,6805,66643,66722,39925,26797,386,27,27,61,2490,2490,2463,2463
Glenn,5,2022-01-17,307,307,194,113,1076,1076,683,393,3,2,2,0,41,41,39,39
Humboldt,5,2022-01-17,1142,1142,738,404,8326,8336,5374,2962,10,1,1,4,128,128,127,127
Imperial,5,2022-01-17,3407,3412,2122,1290,13383,13400,8330,5070,69,12,12,29,864,864,852,852
Inyo,5,2022-01-17,327,327,216,111,1040,1040,688,352,4,0,0,0,52,52,52,52
Kern,5,2022-01-17,11690,11705,7811,3894,51813,51873,34574,17299,242,29,29,44,2111,2111,2082,2082
Kings,5,2022-01-17,3193,3197,1997,1200,14868,14885,9270,5615,40,4,4,1,396,396,392,392
Lake,5,2022-01-17,583,583,348,235,3246,3251,1939,1312,2,1,1,2,121,121,120,120
Lassen,5,2022-01-17,284,284,196,88,3322,3326,2281,1045,0,0,0,0,54,54,54,54
Los Angeles,5,2022-01-17,218239,218495,186916,31579,1609925,1611811,1377923,233888,4034,503,503,680,28406,28406,27903,27903
Madera,5,2022-01-17,2393,2395,1428,967,10610,10623,6308,4315,32,5,5,10,343,343,338,338
Marin,5,2022-01-17,2422,2424,1463,961,17704,17725,10692,7033,38,4,4,6,264,264,260,260
Mariposa,5,2022-01-17,163,163,95,68,1115,1115,648,467,0,0,0,0,22,22,22,22
Mendocino,5,2022-01-17,921,921,486,435,5012,5018,2631,2387,18,3,3,2,110,110,107,107
Merced,5,2022-01-17,3916,3921,2585,1336,13597,13613,8972,4641,41,18,18,11,737,737,719,719
Modoc,5,2022-01-17,13,13,9,4,102,102,68,34,0,1,1,0,7,7,6,6
Mono,5,2022-01-17,198,198,94,104,809,809,386,423,2,0,0,0,5,5,5,5
Monterey,5,2022-01-17,5900,5907,2862,3045,28311,28345,13718,14627,69,6,6,14,660,660,654,654
Napa,5,2022-01-17,1932,1933,1331,602,11910,11924,8184,3740,21,2,2,5,112,112,110,110
Nevada,5,2022-01-17,1252,1252,752,500,5428,5433,3263,2170,19,1,1,1,115,115,114,114
Orange,5,2022-01-17,41268,41316,29636,11680,251435,251730,180398,71332,998,111,111,199,6272,6272,6161,6161
Placer,5,2022-01-17,4325,4331,2501,1830,19465,19489,11232,8257,178,14,14,36,538,538,524,524
Plumas,5,2022-01-17,193,193,119,74,853,853,524,329,3,0,0,0,12,12,12,12
Riverside,5,2022-01-17,41215,41262,26974,14288,167973,168170,109952,58218,920,97,97,158,5865,5865,5768,5768
Sacramento,5,2022-01-17,21407,21432,13639,7793,101930,102051,64867,37184,473,63,63,97,2642,2642,2579,2579
San Benito,5,2022-01-17,851,851,583,268,4009,4014,2747,1267,4,1,1,4,87,87,86,86
San Bernardino,5,2022-01-17,38463,38509,26937,11572,164193,164386,114988,49398,936,144,144,227,6923,6923,6779,6779
San Diego,5,2022-01-17,60745,60817,51625,9192,265886,266198,225984,40214,1067,97,97,193,4704,4704,4607,4607
San Francisco,5,2022-01-17,11251,11264,5202,6062,93943,94054,43324,50730,212,14,14,44,724,724,710,710
San Joaquin,5,2022-01-17,12609,12624,7745,4879,57606,57673,35389,22284,201,20,20,57,2035,2035,2015,2015
San Luis Obispo,5,2022-01-17,3933,3938,2649,1289,21034,21059,14150,6909,46,12,12,10,391,391,379,379
San Mateo,5,2022-01-17,12464,12478,8941,3537,95830,95942,68665,27277,92,10,10,30,621,621,611,611
Santa Barbara,5,2022-01-17,6849,6857,4448,2409,40478,40526,26256,14270,123,12,12,12,601,601,589,589
Santa Clara,5,2022-01-17,28369,28402,23899,4503,228212,228479,192120,36359,451,24,24,84,2048,2048,2024,2024
Santa Cruz,5,2022-01-17,4177,4182,2866,1316,42182,42233,28882,13351,23,3,3,3,240,240,237,237
Shasta,5,2022-01-17,1341,1341,859,482,9160,9170,5848,3322,55,7,7,14,469,469,462,462
Siskiyou,5,2022-01-17,158,158,110,48,927,927,640,287,3,1,1,2,65,65,64,64
Solano,5,2022-01-17,6426,6433,4199,2234,35256,35298,23035,12263,121,6,6,22,407,407,401,401
Sonoma,5,2022-01-17,7619,7629,5027,2602,42777,42827,28164,14663,73,7,7,15,443,443,436,436
Stanislaus,5,2022-01-17,7303,7312,4010,3302,28925,28958,15862,13096,206,10,10,31,1480,1480,1470,1470
Sutter,5,2022-01-17,1252,1252,814,438,4864,4869,3164,1705,0,4,4,0,203,203,199,199
Tehama,5,2022-01-17,614,614,343,271,2418,2419,1348,1071,15,5,5,2,174,174,169,169
Trinity,5,2022-01-17,41,41,23,18,255,255,140,115,0,1,1,0,20,20,19,19
Tulare,5,2022-01-17,7472,7483,4073,3410,27090,27122,14742,12380,97,16,16,16,1349,1349,1333,1333
Tuolumne,5,2022-01-17,885,885,531,354,3834,3838,2288,1550,10,8,8,1,165,165,157,157
Ventura,5,2022-01-17,11975,11989,8791,3198,66922,67000,49066,17934,300,40,40,56,1297,1297,1257,1257
Yolo,5,2022-01-17,2817,2819,1908,911,39500,39546,26738,12808,15,4,4,4,280,280,276,276
Yuba,5,2022-01-17,1061,1061,705,356,3746,3751,2492,1259,42,2,2,6,105,105,103,103
Alameda,6,2022-01-24,19877,19901,14940,4961,171779,171988,129293,42695,373,41,41,68,1650,1650,1609,1609
Amador,6,2022-01-24,545,545,353,192,4667,4672,3022,1650,8,0,0,5,73,73,73,73
Butte,6,2022-01-24,1906,1906,1503,403,9603,9616,7597,2019,82,10,10,9,380,380,370,370
Calaveras,6,2022-01-24,556,556,378,178,2507,2509,1707,802,6,2,2,2,99,99,97,97
Colusa,6,2022-01-24,178,178,128,50,951,951,680,271,6,0,0,0,21,21,21,21
Contra Costa,6,2022-01-24,13243,13258,8519,4739,85219,85323,54893,30430,217,25,25,64,1153,1153,1128,1128
Del Norte,6,2022-01-24,347,347,245,102,4326,4331,3046,1285,3,0,0,3,42,42,42,42
El Dorado,6,2022-01-24,1425,1425,971,454,7329,7338,5007,2331,17,2,2,6,194,194,192,192
Fresno,6,2022-01-24,17360,17381,11388,5993,69412,69497,45620,23877,491,43,43,83,2533,2533,2490,2490
Glenn,6,2022-01-24,249,249,172,77,971,971,670,301,0,0,0,0,41,41,41,41
Humboldt,6,2022-01-24,915,915,641,274,7722,7732,5422,2310,25,3,3,3,131,131,128,128
Imperial,6,2022-01-24,3610,3615,2454,1161,13514,13531,9203,4328,70,14,14,27,878,878,864,864
Inyo,6,2022-01-24,142,142,102,40,625,625,449,176,1,1,1,0,53,53,52,52
Kern,6,2022-01-24,10557,10570,7610,2960,53950,54016,38940,15076,267,47,47,51,2158,2158,2111,2111
Kings,6,2022-01-24,4300,4305,2924,1381,19068,19091,12995,6096,40,4,4,4,400,400,396,396
Lake,6,2022-01-24,746,746,488,258,3417,3421,2237,1184,6,2,2,3,123,123,121,121
Lassen,6,2022-01-24,418,418,307,111,3978,3984,2934,1050,6,0,0,0,54,54,54,54
Los Angeles,6,2022-01-24,164748,164949,145707,19242,1658896,1660919,1468199,192720,3769,609,609,785,29015,29015,28406,28406
Madera,6,2022-01-24,2708,2710,1767,943,12171,12187,7949,4238,49,7,7,10,350,350,343,343
Marin,6,2022-01-24,1854,1854,1226,628,17549,17571,11623,5948,38,4,4,10,268,268,264,264
Mariposa,6,2022-01-24,134,134,86,48,946,946,606,340,0,0,0,0,22,22,22,22
Mendocino,6,2022-01-24,917,917,538,379,4871,4877,2857,2020,23,2,2,3,112,112,110,110
Merced,6,2022-01-24,3131,3136,2237,899,12888,12905,9213,3692,55,9,9,12,746,746,737,737
Modoc,6,2022-01-24,14,14,10,4,114,114,82,32,2,0,0,0,7,7,7,7
Mono,6,2022-01-24,97,97,52,45,422,422,227,195,1,0,0,0,5,5,5,5
Monterey,6,2022-01-24,5077,5083,2772,2311,31778,31818,17346,14472,80,9,9,17,669,669,660,660
Napa,6,2022-01-24,1674,1674,1238,436,12466,12483,9219,3264,23,5,5,4,117,117,112,112
Nevada,6,2022-01-24,999,999,658,341,4801,4806,3170,1636,29,1,1,6,116,116,115,115
Orange,6,2022-01-24,26655,26688,20395,6293,230901,231183,176917,54266,923,175,175,191,6447,6447,6272,6272
Placer,6,2022-01-24,3657,3662,2331,1331,18644,18666,11881,6785,215,8,8,43,546,546,538,538
Plumas,6,2022-01-24,214,214,143,71,836,836,559,277,5,0,0,0,12,12,12,12
Riverside,6,2022-01-24,31889,31927,22589,9338,158755,158949,112584,46365,901,121,121,168,5986,5986,5865,5865
Sacramento,6,2022-01-24,17484,17506,12113,5393,99396,99518,68897,30621,542,63,63,105,2705,2705,2642,2642
San Benito,6,2022-01-24,776,776,570,206,3912,3917,2880,1037,7,1,1,3,88,88,87,87
San Bernardino,6,2022-01-24,28054,28089,21049,7040,153553,153740,115327,38413,975,171,171,223,7094,7094,6923,6923
San Diego,6,2022-01-24,51557,51620,45306,6314,252064,252371,221750,30621,1056,124,124,232,4828,4828,4704,4704
San Francisco,6,2022-01-24,8098,8108,4238,3870,88933,89042,46605,42437,232,19,19,37,743,743,724,724
San Joaquin,6,2022-01-24,10962,10975,7350,3625,58785,58857,39499,19358,241,34,34,71,2069,2069,2035,2035
San Luis Obispo,6,2022-01-24,3562,3567,2586,981,21537,21563,15637,5926,42,10,10,12,401,401,391,391
San Mateo,6,2022-01-24,8492,8502,6495,2007,95102,95218,72801,22417,139,19,19,28,640,640,621,621
Santa Barbara,6,2022-01-24,6483,6491,4563,1928,43820,43874,30856,13018,127,12,12,19,613,613,601,601
Santa Clara,6,2022-01-24,22442,22469,19597,2872,229759,230040,200614,29426,412,46,46,88,2094,2094,2048,2048
Santa Cruz,6,2022-01-24,5037,5044,3710,1334,45599,45655,33600,12055,31,1,1,2,241,241,240,240
Shasta,6,2022-01-24,1484,1484,1031,453,10124,10136,7033,3103,78,7,7,9,476,476,469,469
Siskiyou,6,2022-01-24,160,160,119,41,857,857,635,222,6,3,3,1,68,68,65,65
Solano,6,2022-01-24,5116,5122,3623,1499,32685,32724,23162,9562,143,14,14,26,421,421,407,407
Sonoma,6,2022-01-24,6914,6923,4929,1994,42484,42536,30291,12245,94,7,7,18,450,450,443,443
Stanislaus,6,2022-01-24,6362,6370,3873,2497,28210,28243,17197,11046,277,27,27,44,1507,1507,1480,1480
Sutter,6,2022-01-24,1044,1044,734,310,4997,5002,3521,1481,0,2,2,0,205,205,203,203
Tehama,6,2022-01-24,578,578,358,220,2700,2704,1675,1029,19,4,4,5,178,178,174,174
Trinity,6,2022-01-24,63,63,38,25,321,321,195,126,0,0,0,0,20,20,20,20
Tulare,6,2022-01-24,7650,7660,4621,3039,29520,29557,17871,11686,138,11,11,14,1360,1360,1349,1349
Tuolumne,6,2022-01-24,950,950,626,324,3822,3827,2510,1317,17,3,3,3,168,168,165,165
Ventura,6,2022-01-24,9412,9424,7341,2083,68509,68593,53485,15108,269,28,28,68,1325,1325,1297,1297
Yolo,6,2022-01-24,2298,2299,1677,622,40465,40514,29539,10975,18,10,10,5,290,290,280,280
Yuba,6,2022-01-24,911,911,653,258,3780,3785,2715,1070,54,3,3,10,108,108,105,105
Alameda,7,2022-01-31,11020,11033,8769,2264,137257,137430,109358,28072,336,50,50,75,1700,1700,1650,1650
Amador,7,2022-01-31,347,347,244,103,3228,3232,2278,954,15,1,1,4,74,74,73,73
Butte,7,2022-01-31,1173,1173,971,202,7608,7618,6313,1305,80,6,6,7,386,386,380,380
Calaveras,7,2022-01-31,263,263,193,70,1938,1940,1424,516,3,5,5,2,104,104,99,99
Colusa,7,2022-01-31,106,106,81,25,704,704,540,164,9,0,0,0,21,21,21,21
Contra Costa,7,2022-01-31,7121,7130,4971,2159,68538,68624,47919,20705,207,37,37,54,1190,1190,1153,1153
Del Norte,7,2022-01-31,315,315,237,78,3957,3962,2981,981,6,2,2,2,44,44,42,42
El Dorado,7,2022-01-31,744,744,546,198,5993,5999,4405,1594,13,4,4,5,198,198,194,194
Fresno,7,2022-01-31,10862,10876,7713,3163,55370,55440,39371,16069,503,39,39,98,2572,2572,2533,2533
Glenn,7,2022-01-31,189,189,140,49,759,759,563,196,2,0,0,0,41,41,41,41
Humboldt,7,2022-01-31,584,584,439,145,5793,5799,4355,1444,18,3,3,3,134,134,131,131
Imperial,7,2022-01-31,2192,2194,1599,595,11505,11521,8423,3098,71,17,17,28,895,895,878,878
Inyo,7,2022-01-31,55,55,42,13,467,467,357,110,5,3,3,0,56,56,53,53
Kern,7,2022-01-31,5647,5654,4343,1311,42262,42315,32543,9772,264,47,47,54,2205,2205,2158,2158
Kings,7,2022-01-31,2387,2390,1748,642,13690,13707,10036,3671,55,5,5,4,405,405,400,400
Lake,7,2022-01-31,478,478,338,140,3193,3198,2262,936,4,4,4,4,127,127,123,123
Lassen,7,2022-01-31,311,311,243,68,3619,3624,2838,786,7,1,1,0,55,55,54,54
Los Angeles,7,2022-01-31,74518,74611,67675,6936,1302620,1304259,1183823,120436,2991,641,641,719,29656,29656,29015,29015
Madera,7,2022-01-31,1739,1740,1230,510,9628,9641,6823,2818,50,6,6,7,356,356,350,350
Marin,7,2022-01-31,1061,1061,758,303,13830,13847,9910,3937,26,5,5,9,273,273,268,268
Mariposa,7,2022-01-31,101,101,70,31,840,840,584,256,0,2,2,0,24,24,22,22
Mendocino,7,2022-01-31,463,463,299,164,3484,3489,2254,1235,12,3,3,4,115,115,112,112
Merced,7,2022-01-31,2073,2074,1579,495,10453,10467,7977,2490,54,12,12,14,758,758,746,746
Modoc,7,2022-01-31,12,12,9,3,89,89,68,21,1,0,0,0,7,7,7,7
Mono,7,2022-01-31,41,41,25,16,339,339,203,136,0,0,0,0,5,5,5,5
Monterey,7,2022-01-31,3559,3564,2157,1407,26722,26754,16236,10518,82,9,9,13,678,678,669,669
Napa,7,2022-01-31,991,991,778,213,9375,9386,7362,2024,17,7,7,10,124,124,117,117
Nevada,7,2022-01-31,565,565,401,164,3909,3914,2790,1124,26,3,3,5,119,119,116,116
Orange,7,2022-01-31,11980,11994,9676,2318,177028,177250,143108,34142,708,168,168,164,6615,6615,6447,6447
Placer,7,2022-01-31,2259,2261,1563,698,15371,15390,10658,4732,152,19,19,42,565,565,546,546
Plumas,7,2022-01-31,137,137,98,39,753,753,542,211,1,0,0,0,12,12,12,12
Riverside,7,2022-01-31,15926,15947,12052,3895,120955,121107,91739,29368,740,111,111,171,6097,6097,5986,5986
Sacramento,7,2022-01-31,10159,10172,7548,2624,77953,78052,57999,20053,501,92,92,106,2797,2797,2705,2705
San Benito,7,2022-01-31,468,468,365,103,3304,3309,2585,724,5,2,2,3,90,90,88,88
San Bernardino,7,2022-01-31,13358,13374,10612,2762,116326,116473,92539,23934,744,185,185,207,7279,7279,7094,7094
San Diego,7,2022-01-31,24917,24948,22509,2439,181373,181601,163990,17611,944,105,105,214,4933,4933,4828,4828
San Francisco,7,2022-01-31,4043,4048,2360,1688,69184,69271,40463,28808,208,23,23,45,766,766,743,743
San Joaquin,7,2022-01-31,5670,5676,4107,1569,43438,43492,31529,11963,210,36,36,75,2105,2105,2069,2069
San Luis Obispo,7,2022-01-31,1978,1980,1529,451,16250,16270,12567,3703,40,12,12,10,413,413,401,401
San Mateo,7,2022-01-31,4309,4314,3477,837,75078,75172,60623,14549,131,10,10,19,650,650,640,640
Santa Barbara,7,2022-01-31,3635,3640,2738,902,35020,35064,26414,8650,103,23,23,13,636,636,613,613
Santa Clara,7,2022-01-31,13712,13731,12321,1410,204868,205125,184113,21012,427,52,52,93,2146,2146,2094,2094
Santa Cruz,7,2022-01-31,3437,3442,2682,760,51407,51472,40191,11281,35,5,5,6,246,246,241,241
Shasta,7,2022-01-31,899,899,669,230,8407,8418,6268,2150,59,14,14,11,490,490,476,476
Siskiyou,7,2022-01-31,120,120,95,25,690,690,544,146,8,2,2,2,70,70,68,68
Solano,7,2022-01-31,3808,3814,2886,928,28757,28794,21789,7005,126,6,6,30,427,427,421,421
Sonoma,7,2022-01-31,3570,3575,2715,860,32146,32187,24483,7704,84,12,12,15,462,462,450,450
Stanislaus,7,2022-01-31,3690,3695,2463,1232,22303,22331,14914,7417,261,33,33,53,1540,1540,1507,1507
Sutter,7,2022-01-31,618,618,465,153,3764,3769,2840,929,0,4,4,0,209,209,205,205
Tehama,7,2022-01-31,378,378,256,122,2019,2021,1368,653,17,2,2,5,180,180,178,178
Trinity,7,2022-01-31,43,43,29,14,226,226,150,76,0,0,0,0,20,20,20,20
Tulare,7,2022-01-31,4685,4690,3100,1590,22914,22942,15201,7741,150,22,22,21,1382,1382,1360,1360
Tuolumne,7,2022-01-31,706,706,500,206,3263,3267,2316,951,12,2,2,4,170,170,168,168
Ventura,7,2022-01-31,4601,4607,3773,834,52324,52390,42955,9435,253,39,39,48,1364,1364,1325,1325
Yolo,7,2022-01-31,1356,1356,1052,304,37501,37547,29136,8411,19,3,3,5,293,293,290,290
Yuba,7,2022-01-31,523,523,400,123,2931,2936,2247,689,78,2,2,11,110,110,108,108
Alameda,8,2022-02-07,5989,5997,4993,1004,115547,115697,96393,19304,254,43,43,62,1743,1743,1700,1700
Amador,8,2022-02-07,205,205,154,51,2907,2912,2189,723,14,4,4,5,78,78,74,74
Butte,8,2022-02-07,783,783,673,110,6391,6400,5511,889,74,8,8,12,394,394,386,386
Calaveras,8,2022-02-07,182,182,142,40,1426,1426,1111,315,2,2,2,1,106,106,104,104
Colusa,8,2022-02-07,72,72,58,14,555,555,449,106,0,0,0,0,21,21,21,21
Contra Costa,8,2022-02-07,4018,4023,3008,1015,54075,54145,40500,13645,149,31,31,52,1221,1221,1190,1190
Del Norte,8,2022-02-07,285,285,228,57,4003,4010,3189,821,5,0,0,0,44,44,44,44
El Dorado,8,2022-02-07,428,428,334,94,5030,5035,3928,1107,20,1,1,5,199,199,198,198
Fresno,8,2022-02-07,6288,6296,4769,1527,42969,43026,32634,10392,450,49,49,87,2621,2621,2572,2572
Glenn,8,2022-02-07,113,113,88,25,620,620,488,132,4,1,1,0,42,42,41,41
Humboldt,8,2022-02-07,468,468,372,96,4877,4882,3880,1002,15,1,1,2,135,135,134,134
Imperial,8,2022-02-07,1095,1095,851,244,8112,8124,6317,1807,46,12,12,26,907,907,895,895
Inyo,8,2022-02-07,38,38,30,8,447,447,361,86,5,0,0,0,56,56,56,56
Kern,8,2022-02-07,3474,3479,2817,662,34658,34703,28125,6578,190,32,32,43,2237,2237,2205,2205
Kings,8,2022-02-07,1350,1350,1050,300,10255,10269,7993,2276,52,14,14,5,419,419,405,405
Lake,8,2022-02-07,351,351,265,86,2626,2631,1990,641,11,1,1,5,128,128,127,127
Lassen,8,2022-02-07,140,140,115,25,3020,3024,2488,536,5,2,2,0,57,57,55,55
Los Angeles,8,2022-02-07,37445,37493,34725,2768,1151381,1152880,1068225,84655,2155,637,637,547,30293,30293,29656,29656
Madera,8,2022-02-07,1058,1058,800,258,8080,8091,6126,1965,38,4,4,9,360,360,356,356
Marin,8,2022-02-07,657,657,501,156,11293,11309,8630,2679,29,8,8,6,281,281,273,273
Mariposa,8,2022-02-07,51,51,38,13,579,579,431,148,0,0,0,0,24,24,24,24
Mendocino,8,2022-02-07,327,327,229,98,2814,2818,1975,843,12,2,2,5,117,117,115,115
Merced,8,2022-02-07,1182,1182,951,231,8052,8062,6491,1571,53,13,13,12,771,771,758,758
Modoc,8,2022-02-07,25,25,20,5,219,219,179,40,3,0,0,0,7,7,7,7
Mono,8,2022-02-07,44,44,29,15,271,271,178,93,0,0,0,0,5,5,5,5
Monterey,8,2022-02-07,2221,2224,1476,748,22430,22460,14938,7522,68,11,11,14,689,689,678,678
Napa,8,2022-02-07,742,742,611,131,7765,7774,6402,1372,16,6,6,2,130,130,124,124
Nevada,8,2022-02-07,356,356,271,85,3188,3193,2434,759,24,3,3,1,122,122,119,119
Orange,8,2022-02-07,6397,6405,5400,1005,152289,152487,128609,23878,494,117,117,125,6732,6732,6615,6615
Placer,8,2022-02-07,1289,1289,957,332,11875,11890,8833,3057,148,22,22,34,587,587,565,565
Plumas,8,2022-02-07,79,79,60,19,521,521,399,122,1,1,1,0,13,13,12,12
Riverside,8,2022-02-07,8129,8140,6509,1631,93390,93512,74841,18671,548,107,107,116,6204,6204,6097,6097
Sacramento,8,2022-02-07,6073,6081,4788,1293,64311,64396,50750,13646,390,70,70,95,2867,2867,2797,2797
San Benito,8,2022-02-07,311,311,255,56,2645,2649,2175,474,3,0,0,4,90,90,90,90
San Bernardino,8,2022-02-07,7054,7063,5875,1188,90012,90128,75022,15106,528,139,139,156,7418,7418,7279,7279
San Diego,8,2022-02-07,13655,13673,12613,1060,151872,152070,140341,11729,773,116,116,169,5049,5049,4933,4933
San Francisco,8,2022-02-07,2408,2411,1554,857,55754,55827,35944,19883,171,24,24,40,790,790,766,766
San Joaquin,8,2022-02-07,3326,3331,2568,763,36398,36446,28145,8301,186,42,42,62,2147,2147,2105,2105
San Luis Obispo,8,2022-02-07,1202,1202,977,225,12351,12368,10064,2304,23,16,16,7,429,429,413,413
San Mateo,8,2022-02-07,2463,2465,2077,388,62097,62178,52392,9786,83,16,16,18,666,666,650,650
Santa Barbara,8,2022-02-07,2282,2284,1815,469,30722,30761,24463,6298,75,15,15,17,651,651,636,636
Santa Clara,8,2022-02-07,7932,7942,7292,650,173402,173628,159450,14178,377,32,32,74,2178,2178,2146,2146
Santa Cruz,8,2022-02-07,1900,1900,1560,340,38672,38724,31799,6925,28,4,4,5,250,250,246,246
Shasta,8,2022-02-07,676,676,533,143,6849,6857,5413,1444,64,15,15,10,505,505,490,490
Siskiyou,8,2022-02-07,91,91,75,16,720,720,595,125,10,2,2,0,72,72,70,70
Solano,8,2022-02-07,2236,2237,1783,454,24255,24286,19408,4878,91,5,5,28,432,432,427,427
Sonoma,8,2022-02-07,2083,2084,1675,409,27051,27086,21761,5325,57,7,7,11,469,469,462,462
Stanislaus,8,2022-02-07,2489,2493,1793,700,18729,18753,13512,5241,243,43,43,43,1583,1583,1540,1540
Sutter,8,2022-02-07,361,361,287,74,3304,3309,2634,675,0,5,5,0,214,214,209,209
Tehama,8,2022-02-07,281,281,204,77,1643,1644,1197,447,17,3,3,6,183,183,180,180
Trinity,8,2022-02-07,18,18,13,5,136,136,98,38,0,0,0,0,20,20,20,20
Tulare,8,2022-02-07,2701,2706,1934,772,17917,17941,12856,5085,130,26,26,21,1408,1408,1382,1382
Tuolumne,8,2022-02-07,347,347,263,84,2577,2581,1957,624,10,2,2,1,172,172,170,170
Ventura,8,2022-02-07,2696,2700,2305,395,42322,42378,36209,6169,207,40,40,45,1404,1404,1364,1364
Yolo,8,2022-02-07,868,868,709,159,30845,30887,25204,5683,12,10,10,6,303,303,293,293
Yuba,8,2022-02-07,333,333,269,64,2408,2412,1947,465,42,4,4,13,114,114,110,110
Alameda,9,2022-02-14,3394,3399,2939,460,98766,98896,85524,13372,190,40,40,48,1783,1783,1743,1743
Amador,9,2022-02-14,109,109,87,22,2343,2346,1867,479,8,3,3,3,81,81,78,78
Butte,9,2022-02-14,470,470,417,53,5316,5322,4725,597,64,10,10,9,404,404,394,394
Calaveras,9,2022-02-14,78,78,64,14,1161,1161,949,212,4,2,2,2,108,108,106,106
Colusa,9,2022-02-14,35,35,29,6,405,405,341,64,5,0,0,0,21,21,21,21
Contra Costa,9,2022-02-14,2377,2379,1884,495,44795,44855,35536,9319,123,23,23,31,1244,1244,1221,1221
Del Norte,9,2022-02-14,209,209,174,35,3337,3342,2778,564,6,0,0,3,44,44,44,44
El Dorado,9,2022-02-14,262,262,215,47,4430,4435,3633,802,21,4,4,3,203,203,199,199
Fresno,9,2022-02-14,3842,3847,3080,767,35238,35285,28258,7027,375,33,33,75,2654,2654,2621,2621
Glenn,9,2022-02-14,58,58,48,10,482,482,398,84,3,0,0,0,42,42,42,42
Humboldt,9,2022-02-14,333,333,277,56,4203,4208,3500,708,23,0,0,2,135,135,135,135
Imperial,9,2022-02-14,587,587,479,108,6030,6037,4932,1105,44,14,14,18,921,921,907,907
Inyo,9,2022-02-14,29,29,24,5,413,413,348,65,3,0,0,0,56,56,56,56
Kern,9,2022-02-14,2014,2016,1703,313,27232,27268,23042,4226,156,28,28,40,2265,2265,2237,2237
Kings,9,2022-02-14,772,772,632,140,8002,8013,6558,1455,43,8,8,5,427,427,419,419
Lake,9,2022-02-14,256,256,205,51,2307,2310,1844,466,6,2,2,5,130,130,128,128
Lassen,9,2022-02-14,154,154,132,22,2783,2787,2381,406,3,2,2,0,59,59,57,57
Los Angeles,9,2022-02-14,21606,21635,20370,1265,1052286,1053691,992272,61419,1572,490,490,423,30783,30783,30293,30293
Madera,9,2022-02-14,620,620,496,124,6464,6473,5173,1300,29,2,2,7,362,362,360,360
Marin,9,2022-02-14,383,383,309,74,10146,10160,8181,1979,23,5,5,4,286,286,281,281
Mariposa,9,2022-02-14,24,24,19,5,434,434,342,92,0,0,0,0,24,24,24,24
Mendocino,9,2022-02-14,207,207,155,52,2445,2449,1837,612,13,1,1,7,118,118,117,117
Merced,9,2022-02-14,735,735,619,116,6823,6831,5744,1087,37,13,13,8,784,784,771,771
Modoc,9,2022-02-14,16,16,13,3,124,124,104,20,0,0,0,0,7,7,7,7
Mono,9,2022-02-14,10,10,7,3,179,179,127,52,0,0,0,0,5,5,5,5
Monterey,9,2022-02-14,1227,1227,880,347,16932,16955,12158,4797,48,12,12,12,701,701,689,689
Napa,9,2022-02-14,401,401,344,57,6577,6586,5643,943,10,1,1,1,131,131,130,130
Nevada,9,2022-02-14,169,169,136,33,2564,2567,2065,502,19,1,1,5,123,123,122,122
Orange,9,2022-02-14,3995,4000,3495,505,132294,132470,115680,16790,354,115,115,77,6847,6847,6732,6732
Placer,9,2022-02-14,593,593,466,127,9953,9968,7845,2123,105,12,12,23,599,599,587,587
Plumas,9,2022-02-14,43,43,35,8,431,431,348,83,1,0,0,0,13,13,13,13
Riverside,9,2022-02-14,4603,4609,3856,753,74698,74798,62604,12194,400,85,85,86,6289,6289,6204,6204
Sacramento,9,2022-02-14,3412,3417,2823,594,53331,53402,44144,9258,349,58,58,66,2925,2925,2867,2867
San Benito,9,2022-02-14,157,157,134,23,2141,2144,1832,312,0,1,1,3,91,91,90,90
San Bernardino,9,2022-02-14,3703,3708,3203,505,72665,72762,62876,9886,338,117,117,128,7535,7535,7418,7418
San Diego,9,2022-02-14,8095,8106,7607,499,126060,126229,118508,7721,589,86,86,135,5135,5135,5049,5049
San Francisco,9,2022-02-14,1609,1609,1123,486,47551,47615,33272,14343,130,24,24,39,814,814,790,790
San Joaquin,9,2022-02-14,1989,1991,1617,374,30530,30571,24842,5729,123,37,37,53,2184,2184,2147,2147
San Luis Obispo,9,2022-02-14,798,798,677,121,10064,10077,8552,1525,24,9,9,7,438,438,429,429
San Mateo,9,2022-02-14,1345,1345,1174,171,54908,54981,47984,6997,63,16,16,11,682,682,666,666
Santa Barbara,9,2022-02-14,1057,1057,881,176,22480,22510,18777,3733,68,8,8,14,659,659,651,651
Santa Clara,9,2022-02-14,4615,4621,4321,300,153199,153404,143444,9960,296,27,27,59,2205,2205,2178,2178
Santa Cruz,9,2022-02-14,979,979,836,143,30355,30395,25942,4453,23,3,3,4,253,253,250,250
Shasta,9,2022-02-14,443,443,366,77,5848,5856,4845,1011,62,13,13,13,518,518,505,505
Siskiyou,9,2022-02-14,66,66,57,9,520,520,447,73,7,1,1,2,73,73,72,72
Solano,9,2022-02-14,1198,1198,1001,197,19025,19052,15929,3123,73,2,2,20,434,434,432,432
Sonoma,9,2022-02-14,1138,1138,955,183,21170,21197,17780,3417,55,8,8,7,477,477,469,469
Stanislaus,9,2022-02-14,1359,1359,1042,317,15068,15087,11577,3510,206,28,28,41,1611,1611,1583,1583
Sutter,9,2022-02-14,229,229,191,38,2863,2868,2391,477,0,3,3,0,217,217,214,214
Tehama,9,2022-02-14,179,179,139,40,1405,1405,1088,317,15,5,5,5,188,188,183,183
Trinity,9,2022-02-14,22,22,17,5,171,171,131,40,0,0,0,0,20,20,20,20
Tulare,9,2022-02-14,1480,1480,1128,352,15055,15075,11518,3557,116,25,25,19,1433,1433,1408,1408
Tuolumne,9,2022-02-14,190,190,152,38,2222,2225,1781,444,12,4,4,1,176,176,172,172
Ventura,9,2022-02-14,1512,1512,1334,178,35518,35567,31382,4185,141,36,36,26,1440,1440,1404,1404
Yolo,9,2022-02-14,480,480,408,72,26800,26834,22800,4034,10,7,7,3,310,310,303,303
Yuba,9,2022-02-14,220,220,185,35,2110,2112,1780,332,19,0,0,11,114,114,114,114
Alameda,10,2022-02-21,1931,1932,1721,211,77363,77468,68912,8556,138,27,27,26,1810,1810,1783,1783
Amador,10,2022-02-21,70,70,58,12,1921,1923,1600,323,7,3,3,3,84,84,81,81
Butte,10,2022-02-21,258,258,235,23,4419,4424,4025,399,63,12,12,4,416,416,404,404
Calaveras,10,2022-02-21,44,44,37,7,839,839,713,126,3,6,6,0,114,114,108,108
Colusa,10,2022-02-21,25,25,22,3,361,361,314,47,4,0,0,0,21,21,21,21
Contra Costa,10,2022-02-21,1307,1307,1083,224,34052,34099,28229,5870,66,17,17,30,1261,1261,1244,1244
Del Norte,10,2022-02-21,128,128,111,17,2702,2706,2331,375,8,0,0,1,44,44,44,44
El Dorado,10,2022-02-21,157,157,134,23,3608,3613,3079,534,8,1,1,5,204,204,203,203
Fresno,10,2022-02-21,2010,2012,1683,329,27180,27218,22770,4448,272,26,26,54,2680,2680,2654,2654
Glenn,10,2022-02-21,28,28,24,4,405,405,348,57,2,0,0,0,42,42,42,42
Humboldt,10,2022-02-21,193,193,166,27,3333,3338,2879,459,22,3,3,1,138,138,135,135
Imperial,10,2022-02-21,392,392,334,58,4807,4812,4094,718,31,6,6,10,927,927,921,921
Inyo,10,2022-02-21,10,10,9,1,326,326,284,42,1,0,0,0,56,56,56,56
Kern,10,2022-02-21,1283,1283,1122,161,24321,24355,21292,3063,95,23,23,25,2288,2288,2265,2265
Kings,10,2022-02-21,454,454,387,67,6544,6553,5585,968,32,4,4,5,431,431,427,427
Lake,10,2022-02-21,184,184,154,30,1935,1937,1615,322,7,2,2,1,132,132,130,130
Lassen,10,2022-02-21,111,111,98,13,2129,2131,1879,252,1,0,0,0,59,59,59,59
Los Angeles,10,2022-02-21,11879,11895,11344,551,832063,833206,794133,39073,997,320,320,279,31103,31103,30783,30783
Madera,10,2022-02-21,316,316,264,52,5176,5183,4321,862,27,2,2,7,364,364,362,362
Marin,10,2022-02-21,198,198,166,32,8842,8854,7433,1421,13,3,3,4,289,289,286,286
Mariposa,10,2022-02-21,23,23,19,4,372,372,307,65,0,1,1,0,25,25,24,24
Mendocino,10,2022-02-21,113,113,90,23,1942,1944,1540,404,9,2,2,3,120,120,118,118
Merced,10,2022-02-21,428,428,373,55,5154,5160,4489,671,26,10,10,7,794,794,784,784
Modoc,10,2022-02-21,9,9,8,1,65,65,57,8,2,0,0,0,7,7,7,7
Mono,10,2022-02-21,7,7,5,2,162,162,123,39,0,1,1,0,6,6,5,5
Monterey,10,2022-02-21,778,778,594,184,12961,12978,9894,3084,47,5,5,7,706,706,701,701
Napa,10,2022-02-21,230,230,203,27,4985,4991,4410,581,6,4,4,3,135,135,131,131
Nevada,10,2022-02-21,101,101,85,16,1982,1984,1664,320,16,2,2,5,125,125,123,123
Orange,10,2022-02-21,2462,2465,2214,251,110369,110520,99116,11404,256,79,79,69,6926,6926,6847,6847
Placer,10,2022-02-21,324,324,267,57,8658,8671,7151,1520,92,9,9,13,608,608,599,599
Plumas,10,2022-02-21,21,21,18,3,328,328,276,52,0,0,0,0,13,13,13,13
Riverside,10,2022-02-21,2430,2434,2111,323,61374,61457,53312,8145,262,53,53,61,6342,6342,6289,6289
Sacramento,10,2022-02-21,1952,1954,1677,277,42909,42968,36853,6115,249,34,34,47,2959,2959,2925,2925
San Benito,10,2022-02-21,105,105,92,13,1680,1681,1481,200,0,0,0,1,91,91,91,91
San Bernardino,10,2022-02-21,1903,1904,1696,208,60189,60272,53648,6624,251,82,82,78,7617,7617,7535,7535
San Diego,10,2022-02-21,4627,4633,4407,226,100559,100697,95791,4906,468,61,61,106,5196,5196,5135,5135
San Francisco,10,2022-02-21,981,981,734,247,40286,40342,30097,10245,98,11,11,24,825,825,814,814
San Joaquin,10,2022-02-21,1049,1049,887,162,23686,23719,20060,3659,91,25,25,31,2209,2209,2184,2184
San Luis Obispo,10,2022-02-21,440,440,385,55,7658,7667,6719,948,16,16,16,3,454,454,438,438
San Mateo,10,2022-02-21,692,692,621,71,42411,42469,38065,4404,47,8,8,8,690,690,682,682
Santa Barbara,10,2022-02-21,608,608,525,83,19191,19216,16596,2620,40,6,6,10,665,665,659,659
Santa Clara,10,2022-02-21,2481,2485,2357,128,118439,118603,112401,6202,224,25,25,53,2230,2230,2205,2205
Santa Cruz,10,2022-02-21,577,577,508,69,24999,25033,22032,3001,21,1,1,4,254,254,253,253
Shasta,10,2022-02-21,259,259,222,37,4974,4980,4279,701,46,9,9,10,527,527,518,518
Siskiyou,10,2022-02-21,47,47,42,5,450,450,398,52,6,4,4,1,77,77,73,73
Solano,10,2022-02-21,696,696,603,93,15143,15165,13141,2024,51,5,5,15,439,439,434,434
Sonoma,10,2022-02-21,629,629,547,82,16811,16833,14612,2221,36,2,2,8,479,479,477,477
Stanislaus,10,2022-02-21,730,730,589,141,11750,11766,9495,2271,168,29,29,30,1640,1640,1611,1611
Sutter,10,2022-02-21,120,120,104,16,2107,2109,1822,287,0,2,2,0,219,219,217,217
Tehama,10,2022-02-21,96,96,78,18,1219,1219,993,226,8,10,10,2,198,198,188,188
Trinity,10,2022-02-21,15,15,12,3,199,199,160,39,0,0,0,0,20,20,20,20
Tulare,10,2022-02-21,778,778,625,153,10928,10944,8799,2145,86,14,14,9,1447,1447,1433,1433
Tuolumne,10,2022-02-21,107,107,90,17,1783,1785,1492,293,2,6,6,2,182,182,176,176
Ventura,10,2022-02-21,887,887,803,84,27533,27572,24953,2619,107,20,20,22,1460,1460,1440,1440
Yolo,10,2022-02-21,284,284,250,34,20957,20986,18406,2580,7,4,4,3,314,314,310,310
Yuba,10,2022-02-21,134,134,117,17,1681,1682,1469,213,22,1,1,8,115,115,114,114
Alameda,11,2022-02-28,1463,1463,1337,126,78542,78657,71840,6817,113,17,17,23,1827,1827,1810,1810
Amador,11,2022-02-28,56,56,48,8,2076,2078,1797,281,7,0,0,2,84,84,84,84
Butte,11,2022-02-28,190,190,176,14,4466,4472,4153,319,45,6,6,4,422,422,416,416
Calaveras,11,2022-02-28,40,40,35,5,1255,1255,1105,150,0,3,3,0,117,117,114,114
Colusa,11,2022-02-28,10,10,9,1,405,405,363,42,5,0,0,0,21,21,21,21
Contra Costa,11,2022-02-28,932,932,803,129,34926,34977,30157,4820,56,15,15,19,1276,1276,1261,1261
Del Norte,11,2022-02-28,84,84,75,9,2874,2878,2559,319,5,3,3,2,47,47,44,44
El Dorado,11,2022-02-28,107,107,94,13,3681,3686,3252,434,5,2,2,3,206,206,204,204
Fresno,11,2022-02-28,1305,1305,1134,171,26630,26668,23169,3499,196,28,28,44,2708,2708,2680,2680
Glenn,11,2022-02-28,18,18,16,2,435,435,386,49,1,0,0,0,42,42,42,42
Humboldt,11,2022-02-28,156,156,139,17,2953,2958,2634,324,6,1,1,1,139,139,138,138
Imperial,11,2022-02-28,264,264,233,31,4825,4831,4252,579,13,6,6,10,933,933,927,927
Inyo,11,2022-02-28,10,10,9,1,379,379,341,38,0,0,0,0,56,56,56,56
Kern,11,2022-02-28,791,791,712,79,24597,24633,22177,2456,77,16,16,16,2304,2304,2288,2288
Kings,11,2022-02-28,246,246,216,30,6079,6087,5363,724,19,7,7,3,438,438,431,431
Lake,11,2022-02-28,110,110,95,15,1956,1959,1697,262,0,4,4,1,136,136,132,132
Lassen,11,2022-02-28,44,44,40,4,2093,2096,1898,198,1,2,2,0,61,61,59,59
Los Angeles,11,2022-02-28,8251,8264,7965,299,1057168,1058708,1020119,38589,753,222,222,174,31325,31325,31103,31103
Madera,11,2022-02-28,188,188,163,25,4623,4629,4018,611,20,2,2,6,366,366,364,364
Marin,11,2022-02-28,160,160,140,20,7660,7671,6687,984,13,3,3,3,292,292,289,289
Mariposa,11,2022-02-28,29,29,25,4,347,347,298,49,0,1,1,0,26,26,25,25
Mendocino,11,2022-02-28,82,82,68,14,1888,1890,1572,318,11,2,2,2,122,122,120,120
Merced,11,2022-02-28,285,285,256,29,5024,5031,4510,521,25,7,7,5,801,801,794,794
Modoc,11,2022-02-28,6,6,5,1,57,57,51,6,1,0,0,0,7,7,7,7
Mono,11,2022-02-28,5,5,4,1,169,169,136,33,0,0,0,0,6,6,6,6
Monterey,11,2022-02-28,355,355,286,69,14327,14349,11571,2778,28,9,9,5,715,715,706,706
Napa,11,2022-02-28,194,194,176,18,5592,5599,5084,515,8,3,3,2,138,138,135,135
Nevada,11,2022-02-28,71,71,62,9,2015,2018,1755,263,9,0,0,1,125,125,125,125
Orange,11,2022-02-28,1683,1684,1548,136,126286,126471,116199,10272,198,39,39,35,6965,6965,6926,6926
Placer,11,2022-02-28,250,250,215,35,8410,8424,7236,1188,65,4,4,13,612,612,608,608
Plumas,11,2022-02-28,23,23,20,3,370,370,323,47,0,0,0,0,13,13,13,13
Riverside,11,2022-02-28,1685,1686,1507,179,63194,63287,56588,6699,185,37,37,35,6379,6379,6342,6342
Sacramento,11,2022-02-28,1163,1163,1032,131,45930,45997,40781,5216,163,24,24,35,2983,2983,2959,2959
San Benito,11,2022-02-28,55,55,50,5,1786,1787,1618,169,0,0,0,1,91,91,91,91
San Bernardino,11,2022-02-28,1174,1174,1072,102,61027,61116,55794,5322,157,60,60,45,7677,7677,7617,7617
San Diego,11,2022-02-28,3036,3041,2925,116,99992,100138,96330,3808,341,37,37,83,5233,5233,5196,5196
San Francisco,11,2022-02-28,832,832,659,173,39993,40050,31729,8321,74,15,15,19,840,840,825,825
San Joaquin,11,2022-02-28,664,664,582,82,25938,25976,22767,3209,58,10,10,24,2219,2219,2209,2209
San Luis Obispo,11,2022-02-28,378,378,341,37,8518,8531,7696,835,9,5,5,2,459,459,454,454
San Mateo,11,2022-02-28,599,599,551,48,41287,41348,38002,3346,33,4,4,7,694,694,690,690
Santa Barbara,11,2022-02-28,369,369,329,40,21379,21410,19085,2325,36,5,5,10,670,670,665,665
Santa Clara,11,2022-02-28,1723,1723,1654,69,101378,101527,97470,4057,191,20,20,46,2250,2250,2230,2230
Santa Cruz,11,2022-02-28,459,459,416,43,27962,28004,25371,2633,20,2,2,4,256,256,254,254
Shasta,11,2022-02-28,167,167,148,19,4924,4931,4378,553,36,11,11,8,538,538,527,527
Siskiyou,11,2022-02-28,26,26,24,2,475,475,432,43,4,2,2,1,79,79,77,77
Solano,11,2022-02-28,476,476,425,51,15362,15383,13749,1634,47,3,3,17,442,442,439,439
Sonoma,11,2022-02-28,455,455,408,47,16941,16966,15200,1766,28,3,3,5,482,482,479,479
Stanislaus,11,2022-02-28,477,477,402,75,13357,13376,11288,2088,124,11,11,21,1651,1651,1640,1640
Sutter,11,2022-02-28,107,107,95,12,2333,2337,2083,254,0,2,2,0,221,221,219,219
Tehama,11,2022-02-28,60,60,51,9,1221,1222,1040,182,7,1,1,2,199,199,198,198
Trinity,11,2022-02-28,5,5,4,1,118,118,99,19,0,0,0,0,20,20,20,20
Tulare,11,2022-02-28,462,462,389,73,11880,11898,10009,1889,67,14,14,9,1461,1461,1447,1447
Tuolumne,11,2022-02-28,67,67,58,9,1485,1485,1290,195,6,3,3,1,185,185,182,182
Ventura,11,2022-02-28,548,548,507,41,29876,29920,27677,2243,75,10,10,11,1470,1470,1460,1460
Yolo,11,2022-02-28,207,207,187,20,26235,26273,23725,2548,4,3,3,6,317,317,314,314
Yuba,11,2022-02-28,75,75,67,8,1713,1714,1539,175,12,1,1,6,116,116,115,115
Alameda,12,2022-03-07,1081,1081,1007,74,72091,72200,67229,4971,77,12,12,16,1839,1839,1827,1827
Amador,12,2022-03-07,75,75,67,8,1428,1428,1274,154,6,2,2,1,86,86,84,84
Butte,12,2022-03-07,98,98,92,6,3639,3644,3439,205,33,4,4,3,426,426,422,422
Calaveras,12,2022-03-07,25,25,23,2,1048,1048,948,100,1,1,1,0,118,118,117,117
Colusa,12,2022-03-07,9,9,8,1,355,355,326,29,6,0,0,0,21,21,21,21
Contra Costa,12,2022-03-07,629,629,560,69,30840,30887,27472,3415,47,8,8,13,1284,1284,1276,1276
Del Norte,12,2022-03-07,50,50,46,4,1779,1782,1627,155,7,0,0,1,47,47,47,47
El Dorado,12,2022-03-07,76,76,69,7,3193,3198,2898,300,5,3,3,2,209,209,206,206
Fresno,12,2022-03-07,858,858,768,90,22496,22531,20172,2359,145,18,18,27,2726,2726,2708,2708
Glenn,12,2022-03-07,18,18,16,2,395,395,359,36,2,0,0,0,42,42,42,42
Humboldt,12,2022-03-07,81,81,74,7,3045,3050,2784,266,10,3,3,4,142,142,139,139
Imperial,12,2022-03-07,122,122,110,12,4523,4528,4096,432,16,5,5,10,938,938,933,933
Inyo,12,2022-03-07,10,10,9,1,269,269,247,22,0,0,0,0,56,56,56,56
Kern,12,2022-03-07,431,431,397,34,20813,20843,19193,1650,67,12,12,16,2316,2316,2304,2304
Kings,12,2022-03-07,201,201,182,19,4984,4991,4518,473,13,4,4,2,442,442,438,438
Lake,12,2022-03-07,64,64,57,7,1760,1763,1574,189,2,2,2,1,138,138,136,136
Lassen,12,2022-03-07,95,95,88,7,1883,1885,1744,141,0,1,1,0,62,62,61,61
Los Angeles,12,2022-03-07,5551,5559,5401,158,875811,877141,852187,24954,573,170,170,133,31495,31495,31325,31325
Madera,12,2022-03-07,133,133,119,14,3914,3919,3505,414,15,1,1,2,367,367,366,366
Marin,12,2022-03-07,155,155,139,16,7558,7570,6788,782,10,1,1,2,293,293,292,292
Mariposa,12,2022-03-07,11,11,10,1,296,296,263,33,0,1,1,0,27,27,26,26
Mendocino,12,2022-03-07,65,65,56,9,1643,1644,1419,225,6,0,0,2,122,122,122,122
Merced,12,2022-03-07,174,174,160,14,4529,4535,4160,375,17,7,7,5,808,808,801,801
Modoc,12,2022-03-07,0,0,0,0,54,54,50,4,0,0,0,0,7,7,7,7
Mono,12,2022-03-07,2,2,2,0,128,128,108,20,0,0,0,1,6,6,6,6
Monterey,12,2022-03-07,245,245,206,39,11039,11056,9327,1729,19,5,5,2,720,720,715,715
Napa,12,2022-03-07,199,199,185,14,4874,4880,4524,356,2,1,1,2,139,139,138,138
Nevada,12,2022-03-07,50,50,45,5,1747,1749,1567,182,0,1,1,0,126,126,125,125
Orange,12,2022-03-07,1251,1251,1171,80,107234,107396,100495,6901,138,29,29,28,6994,6994,6965,6965
Placer,12,2022-03-07,162,162,144,18,7779,7792,6911,881,54,3,3,11,615,615,612,612
Plumas,12,2022-03-07,7,7,6,1,266,266,239,27,0,0,0,0,13,13,13,13
Riverside,12,2022-03-07,982,982,899,83,53539,53620,49107,4513,125,26,26,30,6405,6405,6379,6379
Sacramento,12,2022-03-07,770,770,701,69,40316,40378,36743,3635,124,18,18,28,3001,3001,2983,2983
San Benito,12,2022-03-07,40,40,37,3,1495,1495,1383,112,0,2,2,1,93,93,91,91
San Bernardino,12,2022-03-07,786,786,732,54,53161,53243,49571,3672,95,43,43,38,7720,7720,7677,7677
San Diego,12,2022-03-07,2344,2349,2279,70,96612,96757,93870,2887,237,30,30,57,5263,5263,5233,5233
San Francisco,12,2022-03-07,698,698,580,118,37315,37371,31022,6349,62,5,5,11,845,845,840,840
San Joaquin,12,2022-03-07,439,439,396,43,21022,21054,18989,2065,33,9,9,19,2228,2228,2219,2219
San Luis Obispo,12,2022-03-07,245,245,226,19,7303,7314,6748,566,7,5,5,1,464,464,459,459
San Mateo,12,2022-03-07,534,534,500,34,39917,39977,37394,2583,30,2,2,3,696,696,694,694
Santa Barbara,12,2022-03-07,202,202,185,17,17711,17738,16208,1530,15,4,4,8,674,674,670,670
Santa Clara,12,2022-03-07,1445,1445,1399,46,110106,110272,106761,3511,128,12,12,38,2262,2262,2250,2250
Santa Cruz,12,2022-03-07,334,334,309,25,24962,25000,23139,1861,11,0,0,7,256,256,256,256
Shasta,12,2022-03-07,140,140,127,13,4937,4943,4500,443,24,8,8,3,546,546,538,538
Siskiyou,12,2022-03-07,19,19,18,1,399,399,370,29,2,1,1,0,80,80,79,79
Solano,12,2022-03-07,353,353,323,30,14110,14131,12934,1197,46,2,2,10,444,444,442,442
Sonoma,12,2022-03-07,320,320,293,27,14912,14935,13697,1238,26,3,3,6,485,485,482,482
Stanislaus,12,2022-03-07,276,276,241,35,10831,10847,9490,1357,94,10,10,13,1661,1661,1651,1651
Sutter,12,2022-03-07,79,79,72,7,1908,1911,1745,166,0,1,1,0,222,222,221,221
Tehama,12,2022-03-07,41,41,36,5,1115,1115,980,135,5,2,2,1,201,201,199,199
Trinity,12,2022-03-07,4,4,3,1,114,114,100,14,0,0,0,0,20,20,20,20
Tulare,12,2022-03-07,303,303,264,39,10281,10298,8988,1310,37,13,13,3,1474,1474,1461,1461
Tuolumne,12,2022-03-07,48,48,43,5,1252,1252,1121,131,2,0,0,1,185,185,185,185
Ventura,12,2022-03-07,416,416,391,25,26700,26741,25159,1582,45,4,4,11,1474,1474,1470,1470
Yolo,12,2022-03-07,160,160,148,12,22139,22174,20469,1705,3,0,0,2,317,317,317,317
Yuba,12,2022-03-07,59,59,54,5,1554,1555,1428,127,13,0,0,6,116,116,116,116
Alameda,13,2022-03-14,848,848,802,46,68613,68721,64982,3739,64,9,9,6,1848,1848,1839,1839
Amador,13,2022-03-14,32,32,29,3,1439,1439,1315,124,4,0,0,0,86,86,86,86
Butte,13,2022-03-14,82,82,78,4,3592,3597,3437,160,24,1,1,0,427,427,426,426
Calaveras,13,2022-03-14,17,17,16,1,991,991,915,76,1,1,1,1,119,119,118,118
Colusa,13,2022-03-14,4,4,4,0,256,256,239,17,4,0,0,0,21,21,21,21
Contra Costa,13,2022-03-14,552,552,503,49,29041,29086,26522,2564,19,5,5,9,1289,1289,1284,1284
Del Norte,13,2022-03-14,31,31,29,2,1415,1415,1317,98,1,2,2,1,49,49,47,47
El Dorado,13,2022-03-14,46,46,43,3,2973,2978,2756,222,4,1,1,0,210,210,209,209
Fresno,13,2022-03-14,516,516,473,43,21402,21437,19646,1791,120,11,11,20,2737,2737,2726,2726
Glenn,13,2022-03-14,12,12,11,1,342,342,318,24,1,0,0,0,42,42,42,42
Humboldt,13,2022-03-14,57,57,53,4,2653,2658,2473,185,3,1,1,2,143,143,142,142
Imperial,13,2022-03-14,74,74,68,6,4591,4597,4246,351,5,2,2,7,940,940,938,938
Inyo,13,2022-03-14,6,6,6,0,165,165,154,11,0,0,0,0,56,56,56,56
Kern,13,2022-03-14,300,300,281,19,20254,20286,19015,1271,42,14,14,12,2330,2330,2316,2316
Kings,13,2022-03-14,156,156,144,12,4695,4700,4346,354,17,1,1,2,443,443,442,442
Lake,13,2022-03-14,48,48,44,4,1570,1572,1437,135,1,1,1,0,139,139,138,138
Lassen,13,2022-03-14,5,5,5,0,1513,1514,1426,88,0,0,0,0,62,62,62,62
Los Angeles,13,2022-03-14,4083,4090,3999,91,845428,846750,827871,18879,412,117,117,91,31612,31612,31495,31495
Madera,13,2022-03-14,51,51,47,4,3572,3577,3274,303,12,0,0,2,367,367,367,367
Marin,13,2022-03-14,170,170,156,14,6533,6544,6008,536,7,1,1,0,294,294,293,293
Mariposa,13,2022-03-14,9,9,8,1,222,222,202,20,0,0,0,0,27,27,27,27
Mendocino,13,2022-03-14,34,34,30,4,1433,1434,1276,158,4,2,2,1,124,124,122,122
Merced,13,2022-03-14,132,132,123,9,4159,4164,3892,272,17,2,2,4,810,810,808,808
Modoc,13,2022-03-14,3,3,3,0,52,52,49,3,1,0,0,0,7,7,7,7
Mono,13,2022-03-14,2,2,2,0,118,118,103,15,0,0,0,0,6,6,6,6
Monterey,13,2022-03-14,155,155,135,20,10098,10115,8836,1279,14,4,4,2,724,724,720,720
Napa,13,2022-03-14,120,120,113,7,4103,4108,3870,238,6,1,1,3,140,140,139,139
Nevada,13,2022-03-14,50,50,46,4,1571,1572,1442,130,2,0,0,0,126,126,126,126
Orange,13,2022-03-14,820,820,778,42,101435,101594,96438,5156,109,30,30,31,7024,7024,6994,6994
Placer,13,2022-03-14,146,146,133,13,7302,7314,6653,661,45,3,3,5,618,618,615,615
Plumas,13,2022-03-14,4,4,4,0,317,317,291,26,0,0,0,0,13,13,13,13
Riverside,13,2022-03-14,721,721,673,48,52615,52698,49184,3514,87,15,15,16,6420,6420,6405,6405
Sacramento,13,2022-03-14,564,564,524,40,35120,35176,32650,2526,122,16,16,22,3017,3017,3001,3001
San Benito,13,2022-03-14,22,22,21,1,1427,1427,1342,85,0,0,0,1,93,93,93,93
San Bernardino,13,2022-03-14,554,554,524,30,51483,51563,48749,2814,68,26,26,32,7746,7746,7720,7720
San Diego,13,2022-03-14,1844,1847,1804,43,96001,96151,93894,2257,174,16,16,47,5279,5279,5263,5263
San Francisco,13,2022-03-14,596,596,515,81,34145,34198,29494,4704,28,7,7,7,852,852,845,845
San Joaquin,13,2022-03-14,255,255,235,20,18675,18705,17233,1472,28,7,7,11,2235,2235,2228,2228
San Luis Obispo,13,2022-03-14,160,160,150,10,6662,6672,6262,410,7,7,7,1,471,471,464,464
San Mateo,13,2022-03-14,441,441,419,22,35690,35746,33916,1830,27,0,0,3,696,696,696,696
Santa Barbara,13,2022-03-14,195,195,182,13,16853,16878,15717,1161,16,7,7,2,681,681,674,674
Santa Clara,13,2022-03-14,1028,1028,1002,26,98123,98276,95818,2458,108,12,12,28,2274,2274,2262,2262
Santa Cruz,13,2022-03-14,239,239,225,14,22164,22200,20891,1309,10,3,3,3,259,259,256,256
Shasta,13,2022-03-14,97,97,90,7,4835,4844,4497,347,16,5,5,2,551,551,546,546
Siskiyou,13,2022-03-14,12,12,11,1,370,370,349,21,0,3,3,0,83,83,80,80
Solano,13,2022-03-14,220,220,205,15,12333,12353,11521,832,34,1,1,6,445,445,444,444
Sonoma,13,2022-03-14,228,228,213,15,13391,13411,12525,886,14,1,1,4,486,486,485,485
Stanislaus,13,2022-03-14,215,215,193,22,9385,9400,8453,947,82,11,11,17,1672,1672,1661,1661
Sutter,13,2022-03-14,41,41,38,3,1810,1812,1687,125,0,0,0,0,222,222,222,222
Tehama,13,2022-03-14,17,17,15,2,981,981,886,95,2,3,3,0,204,204,201,201
Trinity,13,2022-03-14,3,3,3,0,96,96,86,10,0,0,0,0,20,20,20,20
Tulare,13,2022-03-14,172,172,154,18,9305,9320,8365,955,33,0,0,6,1474,1474,1474,1474
Tuolumne,13,2022-03-14,22,22,20,2,1245,1245,1141,104,1,0,0,0,185,185,185,185
Ventura,13,2022-03-14,325,325,310,15,24570,24609,23457,1152,37,6,6,7,1480,1480,1474,1474
Yolo,13,2022-03-14,118,118,111,7,21605,21639,20320,1319,1,2,2,2,319,319,317,317
Yuba,13,2022-03-14,35,35,33,2,1418,1419,1327,92,10,0,0,3,116,116,116,116
Alameda,14,2022-03-21,712,712,682,30,65498,65603,62780,2823,58,6,6,3,1854,1854,1848,1848
Amador,14,2022-03-21,29,29,27,2,1356,1356,1263,93,2,0,0,0,86,86,86,86
Butte,14,2022-03-21,81,81,78,3,3158,3163,3053,110,17,0,0,2,427,427,427,427
Calaveras,14,2022-03-21,8,8,8,0,657,657,618,39,0,0,0,0,119,119,119,119
Colusa,14,2022-03-21,3,3,3,0,231,231,219,12,2,0,0,0,21,21,21,21
Contra Costa,14,2022-03-21,466,466,434,32,26816,26859,24972,1887,27,7,7,9,1296,1296,1289,1289
Del Norte,14,2022-03-21,19,19,18,1,1190,1190,1125,65,0,0,0,0,49,49,49,49
El Dorado,14,2022-03-21,44,44,41,3,2808,2813,2647,166,1,2,2,0,212,212,210,210
Fresno,14,2022-03-21,348,348,325,23,19602,19633,18331,1302,97,11,11,12,2748,2748,2737,2737
Glenn,14,2022-03-21,7,7,7,0,366,366,345,21,1,0,0,0,42,42,42,42
Humboldt,14,2022-03-21,31,31,29,2,2457,2462,2327,135,5,1,1,2,144,144,143,143
Imperial,14,2022-03-21,58,58,54,4,3995,4000,3760,240,4,3,3,4,943,943,940,940
Inyo,14,2022-03-21,1,1,1,0,148,148,140,8,0,0,0,0,56,56,56,56
Kern,14,2022-03-21,205,205,195,10,19455,19487,18522,965,34,4,4,9,2334,2334,2330,2330
Kings,14,2022-03-21,79,79,74,5,4408,4414,4150,264,7,1,1,1,444,444,443,443
Lake,14,2022-03-21,18,18,17,1,1365,1365,1272,93,0,0,0,0,139,139,139,139
Lassen,14,2022-03-21,10,10,10,0,1385,1386,1321,65,0,0,0,0,62,62,62,62
Los Angeles,14,2022-03-21,4130,4137,4066,71,822648,823978,809586,14392,338,77,77,66,31689,31689,31612,31612
Madera,14,2022-03-21,40,40,37,3,3390,3395,3167,228,9,1,1,1,368,368,367,367
Marin,14,2022-03-21,133,133,124,9,6226,6237,5830,407,6,1,1,0,295,295,294,294
Mariposa,14,2022-03-21,7,7,6,1,236,236,219,17,0,0,0,0,27,27,27,27
Mendocino,14,2022-03-21,28,28,26,2,1505,1507,1375,132,4,0,0,1,124,124,124,124
Merced,14,2022-03-21,88,88,83,5,3766,3771,3576,195,13,5,5,1,815,815,810,810
Modoc,14,2022-03-21,2,2,2,0,60,60,57,3,0,0,0,0,7,7,7,7
Mono,14,2022-03-21,4,4,4,0,134,134,120,14,1,0,0,0,6,6,6,6
Monterey,14,2022-03-21,152,152,137,15,10067,10084,9060,1024,22,0,0,1,724,724,724,724
Napa,14,2022-03-21,54,54,52,2,3450,3456,3299,157,6,1,1,2,141,141,140,140
Nevada,14,2022-03-21,18,18,17,1,1526,1527,1427,100,2,0,0,0,126,126,126,126
Orange,14,2022-03-21,754,754,724,30,96007,96162,92308,3854,100,12,12,25,7036,7036,7024,7024
Placer,14,2022-03-21,110,110,102,8,6460,6472,6008,464,40,2,2,6,620,620,618,618
Plumas,14,2022-03-21,2,2,2,0,228,228,213,15,0,0,0,0,13,13,13,13
Riverside,14,2022-03-21,616,616,583,33,51719,51803,49051,2752,69,13,13,18,6433,6433,6420,6420
Sacramento,14,2022-03-21,453,453,427,26,32963,33017,31144,1873,89,11,11,13,3028,3028,3017,3017
San Benito,14,2022-03-21,18,18,17,1,1360,1360,1296,64,0,1,1,0,94,94,93,93
San Bernardino,14,2022-03-21,474,474,454,20,49138,49218,47091,2127,49,20,20,31,7766,7766,7746,7746
San Diego,14,2022-03-21,1371,1371,1346,25,84545,84681,83123,1558,146,13,13,39,5292,5292,5279,5279
San Francisco,14,2022-03-21,688,688,613,75,33452,33505,29800,3705,34,3,3,3,855,855,852,852
San Joaquin,14,2022-03-21,222,222,208,14,15519,15544,14581,963,23,6,6,6,2241,2241,2235,2235
San Luis Obispo,14,2022-03-21,107,107,102,5,6423,6432,6118,314,3,5,5,0,476,476,471,471
San Mateo,14,2022-03-21,367,367,352,15,34804,34861,33459,1402,30,1,1,1,697,697,696,696
Santa Barbara,14,2022-03-21,160,160,151,9,14290,14313,13523,790,17,5,5,4,686,686,681,681
Santa Clara,14,2022-03-21,1084,1084,1063,21,93523,93674,91839,1835,101,5,5,20,2279,2279,2274,2274
Santa Cruz,14,2022-03-21,183,183,174,9,20019,20051,19115,936,8,0,0,3,259,259,259,259
Shasta,14,2022-03-21,42,42,40,2,4136,4142,3907,235,10,6,6,2,557,557,551,551
Siskiyou,14,2022-03-21,11,11,10,1,370,370,353,17,1,0,0,0,83,83,83,83
Solano,14,2022-03-21,187,187,177,10,11775,11794,11167,627,17,1,1,5,446,446,445,445
Sonoma,14,2022-03-21,228,228,216,12,12373,12393,11741,652,15,2,2,2,488,488,486,486
Stanislaus,14,2022-03-21,142,142,131,11,8424,8438,7762,676,59,12,12,8,1684,1684,1672,1672
Sutter,14,2022-03-21,35,35,33,2,1477,1477,1397,80,0,1,1,0,223,223,222,222
Tehama,14,2022-03-21,10,10,9,1,926,926,854,72,2,0,0,0,204,204,204,204
Trinity,14,2022-03-21,0,0,0,0,111,111,102,9,0,0,0,0,20,20,20,20
Tulare,14,2022-03-21,112,112,103,9,8167,8181,7513,668,27,5,5,4,1479,1479,1474,1474
Tuolumne,14,2022-03-21,19,19,18,1,1129,1129,1054,75,2,0,0,0,185,185,185,185
Ventura,14,2022-03-21,289,289,278,11,23265,23303,22443,860,30,5,5,6,1485,1485,1480,1480
Yolo,14,2022-03-21,109,109,104,5,21370,21406,20369,1037,1,0,0,1,319,319,319,319
Yuba,14,2022-03-21,42,42,40,2,1317,1317,1250,67,8,0,0,2,116,116,116,116
Alameda,15,2022-03-28,930,930,899,31,59062,59160,57165,1995,35,4,4,5,1858,1858,1854,1854
Amador,15,2022-03-28,8,8,8,0,1374,1374,1300,74,3,0,0,0,86,86,86,86
Butte,15,2022-03-28,64,64,62,2,2853,2858,2780,78,11,0,0,1,427,427,427,427
Calaveras,15,2022-03-28,15,15,14,1,581,581,554,27,0,0,0,0,119,119,119,119
Colusa,15,2022-03-28,4,4,4,0,207,207,199,8,0,0,0,0,21,21,21,21
Contra Costa,15,2022-03-28,532,532,503,29,24776,24818,23442,1376,29,1,1,6,1297,1297,1296,1296
Del Norte,15,2022-03-28,16,16,15,1,1038,1038,993,45,1,0,0,0,49,49,49,49
El Dorado,15,2022-03-28,60,60,57,3,2798,2803,2672,131,0,0,0,0,212,212,212,212
Fresno,15,2022-03-28,274,274,260,14,18147,18177,17223,954,71,5,5,18,2753,2753,2748,2748
Glenn,15,2022-03-28,8,8,8,0,333,333,318,15,0,0,0,0,42,42,42,42
Humboldt,15,2022-03-28,27,27,26,1,2611,2616,2503,113,4,0,0,3,144,144,144,144
Imperial,15,2022-03-28,62,62,59,3,3572,3577,3407,170,4,1,1,3,944,944,943,943
Inyo,15,2022-03-28,4,4,4,0,186,186,178,8,1,0,0,0,56,56,56,56
Kern,15,2022-03-28,145,145,139,6,18174,18204,17493,711,17,4,4,8,2338,2338,2334,2334
Kings,15,2022-03-28,57,57,54,3,4273,4279,4077,202,6,2,2,0,446,446,444,444
Lake,15,2022-03-28,10,10,9,1,1065,1065,1007,58,0,0,0,0,139,139,139,139
Lassen,15,2022-03-28,4,4,4,0,1282,1284,1236,48,0,0,0,0,62,62,62,62
Los Angeles,15,2022-03-28,4472,4479,4418,61,703672,704838,695097,9741,264,51,51,57,31740,31740,31689,31689
Madera,15,2022-03-28,24,24,23,1,3451,3456,3273,183,4,0,0,2,368,368,368,368
Marin,15,2022-03-28,179,179,170,9,6003,6014,5705,309,3,0,0,0,295,295,295,295
Mariposa,15,2022-03-28,5,5,5,0,179,179,169,10,0,1,1,0,28,28,27,27
Mendocino,15,2022-03-28,31,31,29,2,1314,1315,1224,91,0,1,1,0,125,125,124,124
Merced,15,2022-03-28,65,65,62,3,3356,3361,3225,136,5,1,1,3,816,816,815,815
Modoc,15,2022-03-28,3,3,3,0,45,45,43,2,0,0,0,0,7,7,7,7
Mono,15,2022-03-28,1,1,1,0,134,134,123,11,0,0,0,0,6,6,6,6
Monterey,15,2022-03-28,148,148,136,12,8777,8792,8078,714,14,1,1,0,725,725,724,724
Napa,15,2022-03-28,67,67,65,2,3328,3333,3214,119,1,2,2,1,143,143,141,141
Nevada,15,2022-03-28,27,27,26,1,1430,1432,1358,74,1,1,1,0,127,127,126,126
Orange,15,2022-03-28,813,813,788,25,90124,90274,87436,2838,81,12,12,17,7048,7048,7036,7036
Placer,15,2022-03-28,107,107,101,6,6210,6221,5869,352,26,4,4,6,624,624,620,620
Plumas,15,2022-03-28,3,3,3,0,267,267,253,14,0,0,0,0,13,13,13,13
Riverside,15,2022-03-28,521,521,500,21,43905,43977,42144,1833,47,7,7,10,6440,6440,6433,6433
Sacramento,15,2022-03-28,454,454,434,20,32626,32680,31221,1459,68,6,6,19,3034,3034,3028,3028
San Benito,15,2022-03-28,14,14,13,1,1343,1344,1295,49,0,0,0,0,94,94,94,94
San Bernardino,15,2022-03-28,540,540,522,18,41201,41270,39874,1396,40,18,18,24,7784,7784,7766,7766
San Diego,15,2022-03-28,1330,1330,1311,19,72101,72221,71184,1037,114,8,8,26,5300,5300,5292,5292
San Francisco,15,2022-03-28,843,843,770,73,32734,32789,29896,2893,23,5,5,5,860,860,855,855
San Joaquin,15,2022-03-28,189,189,180,9,17445,17473,16620,853,20,4,4,4,2245,2245,2241,2241
San Luis Obispo,15,2022-03-28,96,96,92,4,5712,5722,5504,218,5,1,1,1,477,477,476,476
San Mateo,15,2022-03-28,580,580,562,18,33824,33881,32808,1073,26,3,3,3,700,700,697,697
Santa Barbara,15,2022-03-28,135,135,129,6,10211,10229,9797,432,15,1,1,4,687,687,686,686
Santa Clara,15,2022-03-28,1259,1259,1240,19,93671,93826,92395,1431,88,10,10,18,2289,2289,2279,2279
Santa Cruz,15,2022-03-28,145,145,140,5,19666,19700,18983,717,3,0,0,2,259,259,259,259
Shasta,15,2022-03-28,33,33,32,1,3878,3884,3711,173,7,2,2,3,559,559,557,557
Siskiyou,15,2022-03-28,7,7,7,0,292,292,282,10,0,0,0,0,83,83,83,83
Solano,15,2022-03-28,169,169,162,7,10960,10977,10519,458,18,0,0,6,446,446,446,446
Sonoma,15,2022-03-28,256,256,246,10,8548,8562,8215,347,13,0,0,1,488,488,488,488
Stanislaus,15,2022-03-28,116,116,109,7,8184,8199,7679,520,28,2,2,3,1686,1686,1684,1684
Sutter,15,2022-03-28,25,25,24,1,1490,1491,1427,64,0,1,1,0,224,224,223,223
Tehama,15,2022-03-28,13,13,12,1,798,798,749,49,3,1,1,0,205,205,204,204
Trinity,15,2022-03-28,0,0,0,0,79,79,74,5,0,0,0,0,20,20,20,20
Tulare,15,2022-03-28,80,80,75,5,7838,7852,7344,508,20,6,6,1,1485,1485,1479,1479
Tuolumne,15,2022-03-28,7,7,7,0,1082,1082,1025,57,3,0,0,0,185,185,185,185
Ventura,15,2022-03-28,334,334,324,10,21199,21233,20618,615,23,5,5,3,1490,1490,1485,1485
Yolo,15,2022-03-28,104,104,100,4,20452,20485,19723,762,3,2,2,0,321,321,319,319
Yuba,15,2022-03-28,26,26,25,1,1214,1214,1165,49,2,2,2,1,118,118,116,116
Alameda,16,2022-04-04,1060,1060,1032,28,55945,56040,54550,1490,40,3,3,3,1861,1861,1858,1858
Amador,16,2022-04-04,2,2,2,0,1107,1107,1060,47,1,0,0,0,86,86,86,86
Butte,16,2022-04-04,44,44,43,1,2582,2587,2531,56,8,2,2,1,429,429,427,427
Calaveras,16,2022-04-04,8,8,8,0,589,589,567,22,0,0,0,0,119,119,119,119
Colusa,16,2022-04-04,2,2,2,0,201,201,195,6,0,0,0,0,21,21,21,21
Contra Costa,16,2022-04-04,544,544,520,24,23473,23513,22480,1033,13,1,1,4,1298,1298,1297,1297
Del Norte,16,2022-04-04,8,8,8,0,1118,1119,1081,38,0,0,0,1,49,49,49,49
El Dorado,16,2022-04-04,48,48,46,2,2712,2717,2617,100,0,1,1,1,213,213,212,212
Fresno,16,2022-04-04,188,188,180,8,17016,17045,16341,704,62,4,4,12,2757,2757,2753,2753
Glenn,16,2022-04-04,3,3,3,0,287,287,277,10,0,0,0,0,42,42,42,42
Humboldt,16,2022-04-04,22,22,21,1,2386,2391,2309,82,5,0,0,2,144,144,144,144
Imperial,16,2022-04-04,38,38,37,1,3481,3486,3356,130,3,0,0,2,944,944,944,944
Inyo,16,2022-04-04,9,9,9,0,182,182,176,6,0,0,0,0,56,56,56,56
Kern,16,2022-04-04,153,153,148,5,16736,16764,16249,515,16,2,2,7,2340,2340,2338,2338
Kings,16,2022-04-04,47,47,45,2,4175,4181,4025,156,2,0,0,1,446,446,446,446
Lake,16,2022-04-04,14,14,13,1,973,973,931,42,0,0,0,0,139,139,139,139
Lassen,16,2022-04-04,5,5,5,0,1284,1286,1249,37,0,0,0,0,62,62,62,62
Los Angeles,16,2022-04-04,5482,5490,5432,58,803078,804446,795826,8620,255,47,47,42,31787,31787,31740,31740
Madera,16,2022-04-04,27,27,26,1,3190,3195,3062,133,3,0,0,1,368,368,368,368
Marin,16,2022-04-04,167,167,160,7,6342,6354,6096,258,3,0,0,1,295,295,295,295
Mariposa,16,2022-04-04,7,7,7,0,235,235,225,10,0,0,0,0,28,28,28,28
Mendocino,16,2022-04-04,25,25,24,1,1196,1197,1131,66,2,0,0,0,125,125,125,125
Merced,16,2022-04-04,58,58,56,2,3348,3353,3246,107,2,2,2,0,818,818,816,816
Modoc,16,2022-04-04,4,4,4,0,43,43,42,1,0,0,0,0,7,7,7,7
Mono,16,2022-04-04,1,1,1,0,142,142,133,9,0,0,0,0,6,6,6,6
Monterey,16,2022-04-04,128,128,120,8,7485,7498,7018,480,8,3,3,0,728,728,725,725
Napa,16,2022-04-04,75,75,73,2,3141,3146,3058,88,1,0,0,1,143,143,143,143
Nevada,16,2022-04-04,30,30,29,1,1447,1448,1389,59,1,1,1,0,128,128,127,127
Orange,16,2022-04-04,986,986,962,24,81444,81583,79550,2033,56,17,17,14,7065,7065,7048,7048
Placer,16,2022-04-04,129,129,123,6,6688,6700,6401,299,19,1,1,5,625,625,624,624
Plumas,16,2022-04-04,4,4,4,0,235,235,225,10,0,0,0,0,13,13,13,13
Riverside,16,2022-04-04,688,688,666,22,38844,38909,37636,1273,36,5,5,8,6445,6445,6440,6440
Sacramento,16,2022-04-04,431,431,416,15,33029,33085,31923,1162,50,6,6,11,3040,3040,3034,3034
San Benito,16,2022-04-04,13,13,13,0,1182,1182,1148,34,0,0,0,0,94,94,94,94
San Bernardino,16,2022-04-04,613,613,597,16,41940,42012,40895,1117,32,11,11,13,7795,7795,7784,7784
San Diego,16,2022-04-04,1552,1553,1536,17,66634,66747,66003,744,88,6,6,29,5306,5306,5300,5300
San Francisco,16,2022-04-04,999,999,930,69,28644,28693,26689,2004,20,1,1,3,861,861,860,860
San Joaquin,16,2022-04-04,228,228,219,9,15637,15664,15061,603,9,2,2,8,2247,2247,2245,2245
San Luis Obispo,16,2022-04-04,99,99,96,3,5388,5397,5234,163,2,1,1,1,478,478,477,477
San Mateo,16,2022-04-04,715,715,698,17,29218,29268,28544,724,14,2,2,1,702,702,700,700
Santa Barbara,16,2022-04-04,187,187,181,6,15269,15294,14777,517,7,2,2,1,689,689,687,687
Santa Clara,16,2022-04-04,1493,1494,1476,18,87099,87247,86201,1046,89,2,2,18,2291,2291,2289,2289
Santa Cruz,16,2022-04-04,210,210,204,6,16673,16702,16212,490,4,0,0,2,259,259,259,259
Shasta,16,2022-04-04,29,29,28,1,3319,3324,3207,117,4,1,1,2,560,560,559,559
Siskiyou,16,2022-04-04,4,4,4,0,294,294,286,8,0,0,0,0,83,83,83,83
Solano,16,2022-04-04,169,169,164,5,10246,10263,9925,338,21,1,1,4,447,447,446,446
Sonoma,16,2022-04-04,329,329,319,10,10651,10670,10326,344,9,1,1,1,489,489,488,488
Stanislaus,16,2022-04-04,113,113,107,6,7964,7979,7580,399,21,3,3,5,1689,1689,1686,1686
Sutter,16,2022-04-04,24,24,23,1,1324,1325,1281,44,0,0,0,0,224,224,224,224
Tehama,16,2022-04-04,6,6,6,0,765,765,728,37,0,1,1,0,206,206,205,205
Trinity,16,2022-04-04,1,1,1,0,87,87,83,4,0,0,0,0,20,20,20,20
Tulare,16,2022-04-04,49,49,46,3,7735,7749,7353,396,13,3,3,0,1488,1488,1485,1485
Tuolumne,16,2022-04-04,9,9,9,0,1033,1033,990,43,1,1,1,0,186,186,185,185
Ventura,16,2022-04-04,300,300,293,7,20328,20363,19899,464,19,5,5,5,1495,1495,1490,1490
Yolo,16,2022-04-04,104,104,101,3,26189,26233,25447,786,0,0,0,0,321,321,321,321
Yuba,16,2022-04-04,11,11,11,0,1072,1072,1038,34,4,0,0,1,118,118,118,118
Alameda,17,2022-04-11,1489,1490,1460,30,49531,49618,48594,1024,51,6,6,2,1867,1867,1861,1861
Amador,17,2022-04-11,9,9,9,0,1068,1068,1032,36,1,0,0,0,86,86,86,86
Butte,17,2022-04-11,33,33,32,1,2262,2267,2229,38,3,0,0,1,429,429,429,429
Calaveras,17,2022-04-11,14,14,14,0,649,649,630,19,0,0,0,0,119,119,119,119
Colusa,17,2022-04-11,6,6,6,0,203,203,198,5,0,0,0,0,21,21,21,21
Contra Costa,17,2022-04-11,713,713,689,24,20772,20810,20101,709,15,1,1,5,1299,1299,1298,1298
Del Norte,17,2022-04-11,9,9,9,0,1012,1012,985,27,0,0,0,0,49,49,49,49
El Dorado,17,2022-04-11,48,48,47,1,2507,2512,2439,73,1,0,0,0,213,213,213,213
Fresno,17,2022-04-11,194,194,188,6,15983,16012,15490,522,54,3,3,6,2760,2760,2757,2757
Glenn,17,2022-04-11,2,2,2,0,258,258,251,7,0,0,0,0,42,42,42,42
Humboldt,17,2022-04-11,46,46,45,1,2350,2355,2292,63,5,1,1,2,145,145,144,144
Imperial,17,2022-04-11,28,28,27,1,3484,3489,3386,103,2,1,1,1,945,945,944,944
Inyo,17,2022-04-11,4,4,4,0,188,188,183,5,0,0,0,0,56,56,56,56
Kern,17,2022-04-11,135,135,132,3,16356,16385,15987,398,20,2,2,6,2342,2342,2340,2340
Kings,17,2022-04-11,31,31,30,1,4156,4162,4040,122,3,0,0,0,446,446,446,446
Lake,17,2022-04-11,22,22,21,1,868,868,839,29,0,0,0,0,139,139,139,139
Lassen,17,2022-04-11,1,1,1,0,1290,1292,1263,29,1,0,0,0,62,62,62,62
Los Angeles,17,2022-04-11,6767,6779,6723,56,675384,676565,670852,5713,234,46,46,36,31833,31833,31787,31787
Madera,17,2022-04-11,29,29,28,1,3076,3081,2980,101,4,0,0,2,368,368,368,368
Marin,17,2022-04-11,204,204,198,6,5550,5561,5385,176,6,0,0,1,295,295,295,295
Mariposa,17,2022-04-11,7,7,7,0,246,246,237,9,0,0,0,0,28,28,28,28
Mendocino,17,2022-04-11,32,32,31,1,1158,1159,1109,50,0,0,0,0,125,125,125,125
Merced,17,2022-04-11,68,68,66,2,3220,3225,3144,81,6,2,2,0,820,820,818,818
Modoc,17,2022-04-11,0,0,0,0,40,40,39,1,0,0,0,0,7,7,7,7
Mono,17,2022-04-11,9,9,9,0,170,170,161,9,0,0,0,0,6,6,6,6
Monterey,17,2022-04-11,109,109,103,6,6881,6893,6543,350,9,2,2,0,730,730,728,728
Napa,17,2022-04-11,120,120,117,3,2799,2804,2742,62,1,0,0,0,143,143,143,143
Nevada,17,2022-04-11,45,45,44,1,1431,1433,1387,46,2,0,0,0,128,128,128,128
Orange,17,2022-04-11,1161,1161,1139,22,61943,62052,60873,1179,70,8,8,16,7073,7073,7065,7065
Placer,17,2022-04-11,126,126,122,4,5625,5637,5438,199,18,2,2,2,627,627,625,625
Plumas,17,2022-04-11,6,6,6,0,247,247,239,8,0,0,0,0,13,13,13,13
Riverside,17,2022-04-11,727,727,709,18,37679,37745,36776,969,35,5,5,9,6450,6450,6445,6445
Sacramento,17,2022-04-11,506,506,492,14,30264,30318,29480,838,47,11,11,5,3051,3051,3040,3040
San Benito,17,2022-04-11,16,16,16,0,1179,1179,1152,27,0,0,0,0,94,94,94,94
San Bernardino,17,2022-04-11,911,911,892,19,41756,41829,40957,872,33,5,5,7,7800,7800,7795,7795
San Diego,17,2022-04-11,1837,1841,1825,16,74046,74176,73527,649,91,4,4,22,5310,5310,5306,5306
San Francisco,17,2022-04-11,1176,1176,1111,65,29762,29815,28163,1652,19,6,6,4,867,867,861,861
San Joaquin,17,2022-04-11,223,223,216,7,15168,15195,14735,460,10,0,0,1,2247,2247,2247,2247
San Luis Obispo,17,2022-04-11,119,119,116,3,4911,4919,4803,116,2,1,1,0,479,479,478,478
San Mateo,17,2022-04-11,846,846,830,16,30230,30282,29693,589,8,2,2,1,704,704,702,702
Santa Barbara,17,2022-04-11,303,303,295,8,15106,15132,14730,402,6,2,2,1,691,691,689,689
Santa Clara,17,2022-04-11,1658,1659,1644,15,80201,80341,79593,748,61,4,4,13,2295,2295,2291,2291
Santa Cruz,17,2022-04-11,326,326,319,7,10985,11003,10762,241,7,1,1,0,260,260,259,259
Shasta,17,2022-04-11,18,18,18,0,3122,3127,3040,87,2,1,1,1,561,561,560,560
Siskiyou,17,2022-04-11,1,1,1,0,340,340,332,8,0,0,0,0,83,83,83,83
Solano,17,2022-04-11,249,249,243,6,9433,9450,9206,244,16,0,0,1,447,447,447,447
Sonoma,17,2022-04-11,416,416,406,10,10679,10697,10426,271,8,1,1,0,490,490,489,489
Stanislaus,17,2022-04-11,124,124,119,5,7641,7655,7353,302,22,1,1,1,1690,1690,1689,1689
Sutter,17,2022-04-11,20,20,19,1,1237,1237,1204,33,0,1,1,0,225,225,224,224
Tehama,17,2022-04-11,9,9,9,0,753,753,724,29,1,0,0,0,206,206,206,206
Trinity,17,2022-04-11,0,0,0,0,77,77,74,3,0,0,0,0,20,20,20,20
Tulare,17,2022-04-11,54,54,52,2,7834,7849,7532,317,11,3,3,0,1491,1491,1488,1488
Tuolumne,17,2022-04-11,22,22,21,1,1060,1060,1025,35,1,0,0,0,186,186,186,186
Ventura,17,2022-04-11,323,323,317,6,17579,17610,17296,314,16,2,2,2,1497,1497,1495,1495
Yolo,17,2022-04-11,131,131,128,3,18027,18058,17639,419,1,0,0,0,321,321,321,321
Yuba,17,2022-04-11,15,15,15,0,1021,1021,996,25,2,0,0,0,118,118,118,118
Alameda,18,2022-04-18,1779,1781,1752,29,54003,54101,53220,881,42,4,4,4,1871,1871,1867,1867
Amador,18,2022-04-18,12,12,12,0,1194,1195,1163,32,2,0,0,0,86,86,86,86
Butte,18,2022-04-18,48,48,47,1,2268,2273,2243,30,5,2,2,0,431,431,429,429
Calaveras,18,2022-04-18,16,16,16,0,576,576,563,13,0,1,1,0,120,120,119,119
Colusa,18,2022-04-18,3,3,3,0,157,157,154,3,0,0,0,0,21,21,21,21
Contra Costa,18,2022-04-18,1046,1046,1018,28,24705,24750,24081,669,26,1,1,5,1300,1300,1299,1299
Del Norte,18,2022-04-18,14,14,14,0,1010,1010,989,21,0,0,0,0,49,49,49,49
El Dorado,18,2022-04-18,69,69,67,2,2451,2456,2401,55,0,0,0,0,213,213,213,213
Fresno,18,2022-04-18,246,246,240,6,14195,14221,13861,360,42,4,4,5,2764,2764,2760,2760
Glenn,18,2022-04-18,4,4,4,0,278,278,272,6,0,0,0,0,42,42,42,42
Humboldt,18,2022-04-18,106,106,104,2,2052,2057,2014,43,4,1,1,2,146,146,145,145
Imperial,18,2022-04-18,49,49,48,1,3254,3259,3184,75,2,0,0,1,945,945,945,945
Inyo,18,2022-04-18,2,2,2,0,164,164,161,3,0,0,0,0,56,56,56,56
Kern,18,2022-04-18,149,149,146,3,13614,13638,13381,257,9,1,1,5,2343,2343,2342,2342
Kings,18,2022-04-18,44,44,43,1,3579,3584,3502,82,3,1,1,1,447,447,446,446
Lake,18,2022-04-18,16,16,16,0,781,781,761,20,2,1,1,1,140,140,139,139
Lassen,18,2022-04-18,1,1,1,0,1337,1339,1315,24,0,0,0,0,62,62,62,62
Los Angeles,18,2022-04-18,8333,8347,8294,53,468953,469800,466825,2975,200,34,34,26,31867,31867,31833,31833
Madera,18,2022-04-18,23,23,22,1,2520,2525,2460,65,2,0,0,2,368,368,368,368
Marin,18,2022-04-18,312,312,304,8,5982,5992,5842,150,6,0,0,0,295,295,295,295
Mariposa,18,2022-04-18,18,18,18,0,248,248,241,7,0,0,0,0,28,28,28,28
Mendocino,18,2022-04-18,53,53,51,2,1285,1286,1242,44,0,1,1,0,126,126,125,125
Merced,18,2022-04-18,65,65,64,1,3042,3047,2987,60,3,2,2,0,822,822,820,820
Modoc,18,2022-04-18,1,1,1,0,40,40,39,1,0,0,0,0,7,7,7,7
Mono,18,2022-04-18,9,9,9,0,122,122,117,5,0,0,0,0,6,6,6,6
Monterey,18,2022-04-18,157,157,151,6,6517,6530,6270,260,2,1,1,0,731,731,730,730
Napa,18,2022-04-18,163,163,160,3,2852,2857,2808,49,1,0,0,0,143,143,143,143
Nevada,18,2022-04-18,41,41,40,1,1260,1261,1229,32,1,0,0,0,128,128,128,128
Orange,18,2022-04-18,1440,1441,1420,21,79722,79866,78656,1210,50,5,5,10,7078,7078,7073,7073
Placer,18,2022-04-18,161,161,157,4,4791,4799,4667,132,30,0,0,3,627,627,627,627
Plumas,18,2022-04-18,6,6,6,0,225,225,219,6,0,0,0,0,13,13,13,13
Riverside,18,2022-04-18,930,930,912,18,36637,36703,35963,740,36,7,7,7,6457,6457,6450,6450
Sacramento,18,2022-04-18,711,711,696,15,27968,28017,27413,604,47,9,9,8,3060,3060,3051,3051
San Benito,18,2022-04-18,24,24,24,0,1165,1165,1144,21,0,0,0,0,94,94,94,94
San Bernardino,18,2022-04-18,1062,1062,1045,17,39851,39923,39272,651,35,7,7,8,7807,7807,7800,7800
San Diego,18,2022-04-18,2054,2059,2045,14,67060,67182,66723,459,78,9,9,17,5319,5319,5310,5310
San Francisco,18,2022-04-18,1438,1439,1377,62,30456,30513,29178,1335,27,2,2,2,869,869,867,867
San Joaquin,18,2022-04-18,248,248,242,6,14650,14677,14328,349,8,1,1,4,2248,2248,2247,2247
San Luis Obispo,18,2022-04-18,180,180,177,3,4963,4971,4879,92,2,2,2,0,481,481,479,479
San Mateo,18,2022-04-18,1112,1112,1095,17,30550,30605,30142,463,15,2,2,2,706,706,704,704
Santa Barbara,18,2022-04-18,299,299,293,6,14679,14705,14399,306,8,0,0,0,691,691,691,691
Santa Clara,18,2022-04-18,2227,2232,2216,16,70306,70433,69918,515,67,4,4,16,2299,2299,2295,2295
Santa Cruz,18,2022-04-18,437,437,429,8,12224,12245,12030,215,3,0,0,1,260,260,260,260
Shasta,18,2022-04-18,33,33,32,1,2849,2854,2792,62,2,1,1,2,562,562,561,561
Siskiyou,18,2022-04-18,8,8,8,0,318,318,312,6,0,0,0,0,83,83,83,83
Solano,18,2022-04-18,253,253,248,5,9311,9328,9139,189,6,1,1,1,448,448,447,447
Sonoma,18,2022-04-18,502,502,492,10,11183,11203,10980,223,16,1,1,4,491,491,490,490
Stanislaus,18,2022-04-18,162,162,157,5,7668,7682,7443,239,15,0,0,3,1690,1690,1690,1690
Sutter,18,2022-04-18,24,24,24,0,1173,1173,1149,24,0,0,0,0,225,225,225,225
Tehama,18,2022-04-18,7,7,7,0,685,685,664,21,1,0,0,0,206,206,206,206
Trinity,18,2022-04-18,1,1,1,0,72,72,70,2,0,0,0,0,20,20,20,20
Tulare,18,2022-04-18,78,78,76,2,6658,6670,6459,211,13,0,0,0,1491,1491,1491,1491
Tuolumne,18,2022-04-18,25,25,24,1,1024,1024,998,26,1,1,1,0,187,187,186,186
Ventura,18,2022-04-18,367,367,362,5,16408,16437,16209,228,8,3,3,0,1500,1500,1497,1497
Yolo,18,2022-04-18,218,218,214,4,17887,17918,17589,329,2,1,1,0,322,322,321,321
Yuba,18,2022-04-18,28,28,27,1,996,996,977,19,1,0,0,1,118,118,118,118
Alameda,19,2022-04-25,2526,2531,2499,32,60690,60803,60037,766,44,6,6,4,1877,1877,1871,1871
Amador,19,2022-04-25,26,26,25,1,1316,1317,1290,27,0,0,0,0,86,86,86,86
Butte,19,2022-04-25,66,66,65,1,2596,2601,2574,27,5,1,1,1,432,432,431,431
Calaveras,19,2022-04-25,34,34,33,1,687,687,675,12,0,0,0,0,120,120,120,120
Colusa,19,2022-04-25,3,3,3,0,199,199,196,3,0,0,0,0,21,21,21,21
Contra Costa,19,2022-04-25,1510,1511,1479,32,27216,27268,26694,574,25,3,3,3,1303,1303,1300,1300
Del Norte,19,2022-04-25,25,25,25,0,1104,1104,1086,18,0,0,0,0,49,49,49,49
El Dorado,19,2022-04-25,104,104,102,2,2646,2651,2604,47,1,0,0,0,213,213,213,213
Fresno,19,2022-04-25,331,331,324,7,16199,16229,15906,323,34,3,3,2,2767,2767,2764,2764
Glenn,19,2022-04-25,4,4,4,0,287,287,282,5,0,0,0,0,42,42,42,42
Humboldt,19,2022-04-25,168,168,165,3,2852,2857,2810,47,2,0,0,2,146,146,146,146
Imperial,19,2022-04-25,65,65,64,1,3544,3550,3486,64,4,0,0,1,945,945,945,945
Inyo,19,2022-04-25,7,7,7,0,194,194,191,3,0,0,0,0,56,56,56,56
Kern,19,2022-04-25,248,248,244,4,18279,18315,18044,271,14,2,2,4,2345,2345,2343,2343
Kings,19,2022-04-25,54,54,53,1,4515,4524,4443,81,3,0,0,1,447,447,447,447
Lake,19,2022-04-25,21,21,21,0,887,887,869,18,0,0,0,0,140,140,140,140
Lassen,19,2022-04-25,1,1,1,0,1555,1557,1535,22,0,0,0,0,62,62,62,62
Los Angeles,19,2022-04-25,11405,11426,11369,57,884750,886414,881921,4493,207,29,29,25,31896,31896,31867,31867
Madera,19,2022-04-25,44,44,43,1,2916,2921,2862,59,2,0,0,0,368,368,368,368
Marin,19,2022-04-25,329,329,323,6,6439,6452,6326,126,7,0,0,0,295,295,295,295
Mariposa,19,2022-04-25,9,9,9,0,205,205,201,4,0,0,0,0,28,28,28,28
Mendocino,19,2022-04-25,55,55,54,1,1254,1255,1221,34,0,1,1,0,127,127,126,126
Merced,19,2022-04-25,100,100,98,2,3028,3033,2987,46,5,0,0,0,822,822,822,822
Modoc,19,2022-04-25,1,1,1,0,41,41,40,1,0,0,0,0,7,7,7,7
Mono,19,2022-04-25,4,4,4,0,94,94,91,3,0,0,0,0,6,6,6,6
Monterey,19,2022-04-25,322,322,312,10,8001,8016,7766,250,5,1,1,0,732,732,731,731
Napa,19,2022-04-25,199,199,196,3,3375,3380,3334,46,2,0,0,0,143,143,143,143
Nevada,19,2022-04-25,52,52,51,1,1399,1400,1372,28,1,0,0,1,128,128,128,128
Orange,19,2022-04-25,1971,1975,1952,23,86584,86747,85723,1024,53,7,7,13,7085,7085,7078,7078
Placer,19,2022-04-25,237,237,232,5,6079,6092,5960,132,18,0,0,4,627,627,627,627
Plumas,19,2022-04-25,2,2,2,0,228,228,223,5,0,0,0,0,13,13,13,13
Riverside,19,2022-04-25,1302,1303,1283,20,40446,40523,39884,639,33,4,4,5,6461,6461,6457,6457
Sacramento,19,2022-04-25,1015,1015,998,17,31977,32037,31495,542,44,4,4,4,3064,3064,3060,3060
San Benito,19,2022-04-25,35,35,35,0,1118,1119,1103,16,0,0,0,0,94,94,94,94
San Bernardino,19,2022-04-25,1291,1291,1275,16,42767,42847,42301,546,21,10,10,7,7817,7817,7807,7807
San Diego,19,2022-04-25,3018,3025,3009,16,74297,74437,74040,397,86,5,5,10,5324,5324,5319,5319
San Francisco,19,2022-04-25,1993,1997,1929,68,32452,32514,31398,1116,23,1,1,3,870,870,869,869
San Joaquin,19,2022-04-25,394,394,387,7,15389,15418,15130,288,12,0,0,1,2248,2248,2248,2248
San Luis Obispo,19,2022-04-25,209,209,206,3,5038,5047,4974,73,6,0,0,0,481,481,481,481
San Mateo,19,2022-04-25,1511,1512,1494,18,32786,32847,32459,388,14,1,1,3,707,707,706,706
Santa Barbara,19,2022-04-25,372,372,366,6,15228,15256,15008,248,7,2,2,1,693,693,691,691
Santa Clara,19,2022-04-25,3135,3142,3124,18,76065,76209,75780,429,73,4,4,9,2303,2303,2299,2299
Santa Cruz,19,2022-04-25,473,473,467,6,20459,20498,20216,282,4,1,1,0,261,261,260,260
Shasta,19,2022-04-25,49,49,48,1,3316,3322,3266,56,3,0,0,1,562,562,562,562
Siskiyou,19,2022-04-25,7,7,7,0,322,322,318,4,0,0,0,0,83,83,83,83
Solano,19,2022-04-25,474,474,467,7,10596,10616,10448,168,11,0,0,2,448,448,448,448
Sonoma,19,2022-04-25,672,672,662,10,12063,12086,11898,188,19,0,0,2,491,491,491,491
Stanislaus,19,2022-04-25,240,240,234,6,7897,7912,7720,192,25,3,3,0,1693,1693,1690,1690
Sutter,19,2022-04-25,39,39,38,1,1399,1400,1377,23,0,1,1,0,226,226,225,225
Tehama,19,2022-04-25,17,17,17,0,711,711,694,17,1,0,0,0,206,206,206,206
Trinity,19,2022-04-25,1,1,1,0,72,72,70,2,0,0,0,0,20,20,20,20
Tulare,19,2022-04-25,90,90,88,2,6913,6927,6755,172,11,1,1,0,1492,1492,1491,1491
Tuolumne,19,2022-04-25,43,43,42,1,1122,1122,1099,23,2,0,0,0,187,187,187,187
Ventura,19,2022-04-25,604,604,597,7,18898,18933,18728,205,10,1,1,3,1501,1501,1500,1500
Yolo,19,2022-04-25,271,271,267,4,19346,19381,19103,278,1,0,0,0,322,322,322,322
Yuba,19,2022-04-25,31,31,31,0,1106,1106,1089,17,0,0,0,0,118,118,118,118
Alameda,20,2022-05-02,3362,3369,3336,33,67821,67957,67281,676,42,1,1,5,1878,1878,1877,1877
Amador,20,2022-05-02,19,19,19,0,1335,1337,1315,22,0,0,0,0,86,86,86,86
Butte,20,2022-05-02,90,90,89,1,2385,2390,2371,19,4,2,2,0,434,434,432,432
Calaveras,20,2022-05-02,23,23,23,0,726,726,716,10,0,0,0,0,120,120,120,120
Colusa,20,2022-05-02,2,2,2,0,203,203,201,2,0,0,0,0,21,21,21,21
Contra Costa,20,2022-05-02,1878,1883,1852,31,29197,29255,28772,483,40,2,2,5,1305,1305,1303,1303
Del Norte,20,2022-05-02,40,40,39,1,1202,1202,1187,15,1,0,0,0,49,49,49,49
El Dorado,20,2022-05-02,137,137,135,2,2753,2758,2720,38,1,1,1,0,214,214,213,213
Fresno,20,2022-05-02,497,497,489,8,17013,17047,16781,266,42,3,3,4,2770,2770,2767,2767
Glenn,20,2022-05-02,4,4,4,0,252,252,249,3,0,0,0,0,42,42,42,42
Humboldt,20,2022-05-02,268,268,265,3,2941,2946,2908,38,6,0,0,2,146,146,146,146
Imperial,20,2022-05-02,122,122,120,2,3667,3674,3622,52,1,0,0,1,945,945,945,945
Inyo,20,2022-05-02,2,2,2,0,179,179,177,2,0,0,0,0,56,56,56,56
Kern,20,2022-05-02,292,292,289,3,17925,17960,17752,208,10,0,0,5,2345,2345,2345,2345
Kings,20,2022-05-02,58,58,57,1,4846,4855,4787,68,3,0,0,1,447,447,447,447
Lake,20,2022-05-02,29,29,29,0,1003,1003,987,16,1,0,0,0,140,140,140,140
Lassen,20,2022-05-02,8,8,8,0,1608,1610,1592,18,0,0,0,0,62,62,62,62
Los Angeles,20,2022-05-02,14868,14899,14841,58,917304,919122,915474,3648,214,22,22,22,31918,31918,31896,31896
Madera,20,2022-05-02,75,75,74,1,3306,3313,3261,52,5,0,0,0,368,368,368,368
Marin,20,2022-05-02,427,427,421,6,6517,6530,6430,100,10,0,0,0,295,295,295,295
Mariposa,20,2022-05-02,7,7,7,0,244,244,240,4,0,0,0,0,28,28,28,28
Mendocino,20,2022-05-02,60,60,59,1,1223,1223,1197,26,0,0,0,0,127,127,127,127
Merced,20,2022-05-02,128,128,126,2,3281,3286,3247,39,8,4,4,0,826,826,822,822
Modoc,20,2022-05-02,0,0,0,0,36,37,36,1,0,0,0,0,7,7,7,7
Mono,20,2022-05-02,6,6,6,0,105,105,102,3,0,0,0,0,6,6,6,6
Monterey,20,2022-05-02,354,354,345,9,8380,8396,8190,206,8,1,1,0,733,733,732,732
Napa,20,2022-05-02,228,228,226,2,3545,3550,3512,38,4,0,0,0,143,143,143,143
Nevada,20,2022-05-02,80,80,79,1,1535,1538,1514,24,2,0,0,0,128,128,128,128
Orange,20,2022-05-02,2633,2640,2616,24,87442,87616,86806,810,61,5,5,13,7090,7090,7085,7085
Placer,20,2022-05-02,303,303,298,5,6364,6377,6269,108,20,0,0,4,627,627,627,627
Plumas,20,2022-05-02,9,9,9,0,256,256,252,4,0,0,0,0,13,13,13,13
Riverside,20,2022-05-02,2039,2044,2019,25,42816,42901,42372,529,37,3,3,5,6464,6464,6461,6461
Sacramento,20,2022-05-02,1384,1385,1367,18,33760,33827,33381,446,43,5,5,9,3069,3069,3064,3064
San Benito,20,2022-05-02,50,50,49,1,1281,1283,1269,14,0,0,0,0,94,94,94,94
San Bernardino,20,2022-05-02,1492,1493,1478,15,43308,43395,42963,432,30,7,7,6,7824,7824,7817,7817
San Diego,20,2022-05-02,4131,4139,4122,17,72899,73043,72740,303,79,3,3,13,5327,5327,5324,5324
San Francisco,20,2022-05-02,2411,2417,2352,65,35407,35477,34520,957,39,3,3,13,873,873,870,870
San Joaquin,20,2022-05-02,545,545,537,8,15102,15132,14912,220,14,1,1,1,2249,2249,2248,2248
San Luis Obispo,20,2022-05-02,249,249,246,3,5115,5126,5068,58,5,2,2,0,483,483,481,481
San Mateo,20,2022-05-02,1798,1801,1785,16,35865,35936,35602,334,22,2,2,5,709,709,707,707
Santa Barbara,20,2022-05-02,439,439,434,5,15309,15339,15144,195,10,0,0,2,693,693,693,693
Santa Clara,20,2022-05-02,4327,4335,4316,19,95335,95524,95100,424,88,4,4,15,2307,2307,2303,2303
Santa Cruz,20,2022-05-02,678,678,671,7,22013,22057,21818,239,2,1,1,0,262,262,261,261
Shasta,20,2022-05-02,67,67,66,1,3450,3456,3410,46,7,0,0,1,562,562,562,562
Siskiyou,20,2022-05-02,9,9,9,0,329,329,326,3,0,0,0,0,83,83,83,83
Solano,20,2022-05-02,622,622,614,8,11758,11781,11635,146,20,0,0,2,448,448,448,448
Sonoma,20,2022-05-02,898,898,887,11,12796,12821,12666,155,16,1,1,4,492,492,491,491
Stanislaus,20,2022-05-02,269,269,264,5,8081,8096,7941,155,22,0,0,3,1693,1693,1693,1693
Sutter,20,2022-05-02,47,47,46,1,1263,1264,1248,16,0,1,1,0,227,227,226,226
Tehama,20,2022-05-02,17,17,17,0,699,699,686,13,0,0,0,0,206,206,206,206
Trinity,20,2022-05-02,1,1,1,0,84,84,82,2,0,0,0,0,20,20,20,20
Tulare,20,2022-05-02,163,163,160,3,7288,7303,7161,142,10,3,3,0,1495,1495,1492,1492
Tuolumne,20,2022-05-02,92,92,91,1,1295,1296,1276,20,5,0,0,0,187,187,187,187
Ventura,20,2022-05-02,743,743,737,6,19915,19953,19784,169,15,3,3,1,1504,1504,1501,1501
Yolo,20,2022-05-02,353,353,349,4,18770,18807,18596,211,1,1,1,0,323,323,322,322
Yuba,20,2022-05-02,47,47,46,1,1054,1054,1042,12,2,0,0,1,118,118,118,118
Alameda,21,2022-05-09,4148,4156,4124,32,71250,71398,70845,553,44,6,6,6,1884,1884,1878,1878
Amador,21,2022-05-09,25,25,25,0,1518,1520,1501,19,0,0,0,0,86,86,86,86
Butte,21,2022-05-09,114,114,113,1,2412,2417,2402,15,5,0,0,0,434,434,434,434
Calaveras,21,2022-05-09,33,33,33,0,688,688,680,8,1,0,0,0,120,120,120,120
Colusa,21,2022-05-09,3,3,3,0,215,215,213,2,0,0,0,0,21,21,21,21
Contra Costa,21,2022-05-09,2517,2523,2491,32,30483,30548,30153,395,48,4,4,12,1309,1309,1305,1305
Del Norte,21,2022-05-09,49,49,49,0,1355,1356,1343,13,0,0,0,0,49,49,49,49
El Dorado,21,2022-05-09,176,176,174,2,2888,2893,2862,31,3,0,0,1,214,214,214,214
Fresno,21,2022-05-09,739,739,730,9,18158,18195,17973,222,29,1,1,1,2771,2771,2770,2770
Glenn,21,2022-05-09,8,8,8,0,228,228,226,2,0,0,0,0,42,42,42,42
Humboldt,21,2022-05-09,273,273,270,3,3150,3155,3123,32,5,0,0,2,146,146,146,146
Imperial,21,2022-05-09,130,130,129,1,3847,3854,3811,43,0,0,0,1,945,945,945,945
Inyo,21,2022-05-09,26,26,26,0,236,236,234,2,0,0,0,0,56,56,56,56
Kern,21,2022-05-09,466,466,462,4,18686,18725,18556,169,18,2,2,2,2347,2347,2345,2345
Kings,21,2022-05-09,91,91,90,1,4937,4947,4893,54,1,0,0,1,447,447,447,447
Lake,21,2022-05-09,30,30,30,0,1027,1028,1015,13,1,0,0,0,140,140,140,140
Lassen,21,2022-05-09,6,6,6,0,1687,1690,1676,14,0,0,0,0,62,62,62,62
Los Angeles,21,2022-05-09,18480,18518,18461,57,926550,928475,925606,2869,225,29,29,27,31947,31947,31918,31918
Madera,21,2022-05-09,132,132,130,2,3725,3731,3685,46,3,0,0,0,368,368,368,368
Marin,21,2022-05-09,708,708,700,8,7750,7765,7672,93,12,0,0,0,295,295,295,295
Mariposa,21,2022-05-09,32,32,32,0,287,287,283,4,0,0,0,0,28,28,28,28
Mendocino,21,2022-05-09,92,92,91,1,1264,1266,1245,21,0,1,1,0,128,128,127,127
Merced,21,2022-05-09,199,199,197,2,3427,3433,3401,32,4,1,1,0,827,827,826,826
Modoc,21,2022-05-09,2,2,2,0,41,42,41,1,0,0,0,0,7,7,7,7
Mono,21,2022-05-09,9,9,9,0,113,113,111,2,0,0,0,0,6,6,6,6
Monterey,21,2022-05-09,439,439,431,8,9374,9394,9213,181,11,0,0,0,733,733,733,733
Napa,21,2022-05-09,232,232,230,2,3119,3124,3098,26,2,0,0,0,143,143,143,143
Nevada,21,2022-05-09,101,101,100,1,1655,1659,1639,20,5,0,0,0,128,128,128,128
Orange,21,2022-05-09,3504,3511,3486,25,91741,91931,91268,663,84,8,8,17,7098,7098,7090,7090
Placer,21,2022-05-09,537,537,530,7,6741,6754,6664,90,25,0,0,2,627,627,627,627
Plumas,21,2022-05-09,13,13,13,0,274,274,271,3,0,0,0,0,13,13,13,13
Riverside,21,2022-05-09,2399,2405,2382,23,44980,45073,44638,435,42,4,4,8,6468,6468,6464,6464
Sacramento,21,2022-05-09,2240,2246,2223,23,36213,36288,35913,375,62,4,4,10,3073,3073,3069,3069
San Benito,21,2022-05-09,73,73,72,1,1431,1435,1423,12,0,0,0,0,94,94,94,94
San Bernardino,21,2022-05-09,1931,1936,1921,15,46290,46387,46026,361,31,5,5,4,7829,7829,7824,7824
San Diego,21,2022-05-09,5225,5237,5220,17,87097,87279,86995,284,98,2,2,11,5329,5329,5327,5327
San Francisco,21,2022-05-09,3039,3046,2982,64,38020,38099,37293,806,52,6,6,9,879,879,873,873
San Joaquin,21,2022-05-09,775,775,766,9,15914,15948,15767,181,11,0,0,3,2249,2249,2249,2249
San Luis Obispo,21,2022-05-09,289,289,286,3,5228,5241,5195,46,0,0,0,0,483,483,483,483
San Mateo,21,2022-05-09,2298,2304,2288,16,37586,37666,37394,272,26,3,3,1,712,712,709,709
Santa Barbara,21,2022-05-09,638,638,632,6,15589,15621,15466,155,10,0,0,3,693,693,693,693
Santa Clara,21,2022-05-09,5602,5614,5595,19,105122,105341,104976,365,87,3,3,23,2310,2310,2307,2307
Santa Cruz,21,2022-05-09,729,729,723,6,23963,24014,23812,202,2,0,0,0,262,262,262,262
Shasta,21,2022-05-09,106,106,105,1,3300,3306,3272,34,7,0,0,0,562,562,562,562
Siskiyou,21,2022-05-09,17,17,17,0,285,285,283,2,0,0,0,0,83,83,83,83
Solano,21,2022-05-09,914,914,905,9,12270,12296,12177,119,20,0,0,1,448,448,448,448
Sonoma,21,2022-05-09,1179,1179,1168,11,13966,13995,13862,133,18,1,1,2,493,493,492,492
Stanislaus,21,2022-05-09,460,460,453,7,8943,8962,8828,134,27,0,0,2,1693,1693,1693,1693
Sutter,21,2022-05-09,61,61,60,1,1565,1568,1552,16,0,0,0,0,227,227,227,227
Tehama,21,2022-05-09,28,28,28,0,691,691,681,10,1,0,0,0,206,206,206,206
Trinity,21,2022-05-09,4,4,4,0,69,69,68,1,0,0,0,0,20,20,20,20
Tulare,21,2022-05-09,182,182,179,3,7634,7650,7533,117,11,1,1,1,1496,1496,1495,1495
Tuolumne,21,2022-05-09,71,71,70,1,1427,1429,1412,17,1,1,1,0,188,188,187,187
Ventura,21,2022-05-09,1151,1152,1144,8,20945,20989,20850,139,15,0,0,2,1504,1504,1504,1504
Yolo,21,2022-05-09,493,493,489,4,19642,19683,19510,173,1,0,0,1,323,323,323,323
Yuba,21,2022-05-09,77,77,76,1,1243,1245,1233,12,2,0,0,0,118,118,118,118
Alameda,22,2022-05-16,4976,4988,4958,30,74750,74912,74458,454,73,7,7,6,1891,1891,1884,1884
Amador,22,2022-05-16,54,54,53,1,1671,1675,1658,17,0,0,0,0,86,86,86,86
Butte,22,2022-05-16,206,206,205,1,2665,2670,2657,13,7,2,2,0,436,436,434,434
Calaveras,22,2022-05-16,43,43,43,0,766,766,759,7,0,1,1,1,121,121,120,120
Colusa,22,2022-05-16,7,7,7,0,217,217,215,2,0,0,0,0,21,21,21,21
Contra Costa,22,2022-05-16,3478,3486,3451,35,33477,33551,33212,339,50,5,5,7,1314,1314,1309,1309
Del Norte,22,2022-05-16,173,173,172,1,1860,1865,1850,15,0,0,0,0,49,49,49,49
El Dorado,22,2022-05-16,267,267,265,2,3038,3043,3017,26,5,0,0,1,214,214,214,214
Fresno,22,2022-05-16,1135,1136,1125,11,19341,19383,19199,184,46,2,2,6,2773,2773,2771,2771
Glenn,22,2022-05-16,15,15,15,0,259,259,257,2,0,0,0,0,42,42,42,42
Humboldt,22,2022-05-16,274,274,272,2,3253,3258,3232,26,9,1,1,2,147,147,146,146
Imperial,22,2022-05-16,207,207,205,2,4307,4317,4280,37,1,0,0,1,945,945,945,945
Inyo,22,2022-05-16,19,19,19,0,228,228,226,2,1,0,0,0,56,56,56,56
Kern,22,2022-05-16,680,680,675,5,19931,19976,19835,141,22,3,3,3,2350,2350,2347,2347
Kings,22,2022-05-16,222,222,220,2,5418,5430,5383,47,0,0,0,0,447,447,447,447
Lake,22,2022-05-16,74,74,73,1,1118,1119,1108,11,2,0,0,0,140,140,140,140
Lassen,22,2022-05-16,20,20,20,0,1703,1707,1696,11,1,0,0,0,62,62,62,62
Los Angeles,22,2022-05-16,21480,21526,21475,51,937760,939801,937536,2265,283,38,38,44,31985,31985,31947,31947
Madera,22,2022-05-16,199,199,197,2,3632,3640,3605,35,2,0,0,0,368,368,368,368
Marin,22,2022-05-16,812,812,805,7,8375,8392,8314,78,12,0,0,0,295,295,295,295
Mariposa,22,2022-05-16,23,23,23,0,340,340,336,4,0,0,0,0,28,28,28,28
Mendocino,22,2022-05-16,98,98,97,1,1325,1326,1309,17,0,1,1,1,129,129,128,128
Merced,22,2022-05-16,317,317,315,2,4007,4016,3987,29,8,1,1,1,828,828,827,827
Modoc,22,2022-05-16,4,4,4,0,43,44,43,1,0,0,0,0,7,7,7,7
Mono,22,2022-05-16,11,11,11,0,112,112,110,2,0,0,0,0,6,6,6,6
Monterey,22,2022-05-16,508,508,500,8,9594,9614,9469,145,6,1,1,0,734,734,733,733
Napa,22,2022-05-16,300,300,298,2,3736,3742,3718,24,3,0,0,0,143,143,143,143
Nevada,22,2022-05-16,146,146,145,1,1834,1839,1822,17,2,0,0,0,128,128,128,128
Orange,22,2022-05-16,4548,4557,4532,25,94601,94805,94272,533,74,7,7,15,7105,7105,7098,7098
Placer,22,2022-05-16,737,737,729,8,7764,7782,7701,81,43,2,2,3,629,629,627,627
Plumas,22,2022-05-16,48,48,48,0,242,242,240,2,1,0,0,0,13,13,13,13
Riverside,22,2022-05-16,3327,3335,3310,25,47872,47978,47617,361,65,1,1,6,6469,6469,6468,6468
Sacramento,22,2022-05-16,3121,3129,3104,25,39930,40016,39693,323,89,8,8,12,3081,3081,3073,3073
San Benito,22,2022-05-16,111,111,110,1,1522,1526,1516,10,1,0,0,0,94,94,94,94
San Bernardino,22,2022-05-16,2470,2477,2462,15,48834,48941,48644,297,44,8,8,5,7837,7837,7829,7829
San Diego,22,2022-05-16,6677,6690,6673,17,94767,94972,94732,240,91,5,5,25,5334,5334,5329,5329
San Francisco,22,2022-05-16,3400,3408,3352,56,39243,39329,38677,652,68,5,5,8,884,884,879,879
San Joaquin,22,2022-05-16,1198,1199,1188,11,18907,18948,18779,169,16,1,1,1,2250,2250,2249,2249
San Luis Obispo,22,2022-05-16,425,425,422,3,6059,6072,6030,42,3,0,0,0,483,483,483,483
San Mateo,22,2022-05-16,2752,2759,2744,15,39862,39948,39723,225,39,1,1,1,713,713,712,712
Santa Barbara,22,2022-05-16,912,913,906,7,17034,17072,16940,132,13,0,0,2,693,693,693,693
Santa Clara,22,2022-05-16,7162,7177,7158,19,112063,112306,112003,303,111,9,9,15,2319,2319,2310,2310
Santa Cruz,22,2022-05-16,808,808,803,5,20735,20780,20640,140,5,0,0,0,262,262,262,262
Shasta,22,2022-05-16,128,128,127,1,3813,3821,3790,31,6,0,0,1,562,562,562,562
Siskiyou,22,2022-05-16,19,19,19,0,372,372,370,2,0,0,0,0,83,83,83,83
Solano,22,2022-05-16,1269,1270,1261,9,14161,14191,14084,107,29,0,0,2,448,448,448,448
Sonoma,22,2022-05-16,1567,1570,1559,11,15542,15575,15460,115,28,0,0,4,493,493,493,493
Stanislaus,22,2022-05-16,741,741,732,9,9943,9964,9848,116,33,2,2,5,1695,1695,1693,1693
Sutter,22,2022-05-16,109,109,108,1,1828,1833,1819,14,0,0,0,0,227,227,227,227
Tehama,22,2022-05-16,37,37,37,0,840,840,831,9,0,1,1,1,207,207,206,206
Trinity,22,2022-05-16,5,5,5,0,69,69,68,1,0,0,0,0,20,20,20,20
Tulare,22,2022-05-16,390,390,385,5,8322,8340,8241,99,14,1,1,0,1497,1497,1496,1496
Tuolumne,22,2022-05-16,139,139,138,1,1447,1449,1435,14,1,1,1,0,189,189,188,188
Ventura,22,2022-05-16,1551,1553,1545,8,23854,23906,23782,124,34,2,2,2,1506,1506,1504,1504
Yolo,22,2022-05-16,689,689,684,5,22144,22192,22040,152,0,0,0,1,323,323,323,323
Yuba,22,2022-05-16,119,119,118,1,1335,1336,1326,10,4,0,0,0,118,118,118,118
Alameda,23,2022-05-23,5601,5614,5588,26,77661,77839,77472,367,76,4,4,4,1895,1895,1891,1891
Amador,23,2022-05-23,80,80,79,1,1440,1444,1433,11,0,0,0,0,86,86,86,86
Butte,23,2022-05-23,284,284,283,1,2767,2773,2762,11,5,1,1,1,437,437,436,436
Calaveras,23,2022-05-23,52,52,52,0,743,743,738,5,0,1,1,0,122,122,121,121
Colusa,23,2022-05-23,7,7,7,0,232,232,231,1,0,0,0,0,21,21,21,21
Contra Costa,23,2022-05-23,3833,3841,3811,30,35329,35409,35129,280,71,9,9,7,1323,1323,1314,1314
Del Norte,23,2022-05-23,64,64,64,0,1346,1349,1341,8,0,1,1,0,50,50,49,49
El Dorado,23,2022-05-23,360,360,358,2,3413,3420,3397,23,6,2,2,0,216,216,214,214
Fresno,23,2022-05-23,1628,1633,1621,12,21579,21628,21467,161,63,2,2,8,2775,2775,2773,2773
Glenn,23,2022-05-23,26,26,26,0,273,273,271,2,0,0,0,0,42,42,42,42
Humboldt,23,2022-05-23,245,245,244,1,2911,2916,2898,18,14,1,1,3,148,148,147,147
Imperial,23,2022-05-23,341,341,339,2,4771,4782,4750,32,2,0,0,1,945,945,945,945
Inyo,23,2022-05-23,27,27,27,0,221,221,220,1,0,0,0,0,56,56,56,56
Kern,23,2022-05-23,1004,1005,1000,5,21266,21316,21199,117,34,0,0,7,2350,2350,2350,2350
Kings,23,2022-05-23,249,249,247,2,5643,5657,5619,38,1,0,0,0,447,447,447,447
Lake,23,2022-05-23,96,96,95,1,1237,1240,1230,10,1,0,0,1,140,140,140,140
Lassen,23,2022-05-23,42,42,42,0,1762,1767,1758,9,0,0,0,0,62,62,62,62
Los Angeles,23,2022-05-23,27832,27895,27843,52,945943,948102,946321,1781,366,31,31,53,32016,32016,31985,31985
Madera,23,2022-05-23,214,214,212,2,3763,3772,3743,29,1,0,0,2,368,368,368,368
Marin,23,2022-05-23,799,799,793,6,8779,8799,8735,64,15,0,0,1,295,295,295,295
Mariposa,23,2022-05-23,32,32,32,0,340,340,337,3,0,0,0,0,28,28,28,28
Mendocino,23,2022-05-23,150,150,149,1,1658,1662,1645,17,3,1,1,1,130,130,129,129
Merced,23,2022-05-23,407,407,405,2,4198,4210,4186,24,4,0,0,0,828,828,828,828
Modoc,23,2022-05-23,2,2,2,0,40,41,40,1,0,0,0,0,7,7,7,7
Mono,23,2022-05-23,14,14,14,0,163,163,161,2,0,0,0,0,6,6,6,6
Monterey,23,2022-05-23,697,697,689,8,9598,9619,9506,113,17,1,1,1,735,735,734,734
Napa,23,2022-05-23,331,331,329,2,3936,3947,3927,20,5,0,0,0,143,143,143,143
Nevada,23,2022-05-23,150,150,149,1,1903,1907,1893,14,2,0,0,0,128,128,128,128
Orange,23,2022-05-23,5565,5578,5554,24,94536,94752,94335,417,111,11,11,20,7116,7116,7105,7105
Placer,23,2022-05-23,878,878,871,7,7814,7832,7768,64,49,2,2,4,631,631,629,629
Plumas,23,2022-05-23,46,46,46,0,279,279,277,2,0,0,0,0,13,13,13,13
Riverside,23,2022-05-23,4419,4429,4403,26,52183,52302,51995,307,73,6,6,10,6475,6475,6469,6469
Sacramento,23,2022-05-23,3871,3879,3855,24,41117,41211,40951,260,122,7,7,10,3088,3088,3081,3081
San Benito,23,2022-05-23,167,167,166,1,1660,1665,1656,9,0,0,0,0,94,94,94,94
San Bernardino,23,2022-05-23,3328,3336,3320,16,50062,50177,49940,237,53,3,3,10,7840,7840,7837,7837
San Diego,23,2022-05-23,8847,8867,8849,18,103239,103474,103269,205,138,4,4,20,5338,5338,5334,5334
San Francisco,23,2022-05-23,3599,3608,3561,47,41566,41661,41121,540,85,6,6,9,890,890,884,884
San Joaquin,23,2022-05-23,1543,1548,1537,11,20854,20901,20756,145,20,3,3,7,2253,2253,2250,2250
San Luis Obispo,23,2022-05-23,668,668,664,4,7273,7289,7250,39,10,3,3,0,486,486,483,483
San Mateo,23,2022-05-23,3121,3128,3114,14,40748,40842,40662,180,35,0,0,0,713,713,713,713
Santa Barbara,23,2022-05-23,1065,1066,1060,6,17774,17815,17707,108,20,0,0,3,693,693,693,693
Santa Clara,23,2022-05-23,7784,7802,7786,16,110371,110624,110391,233,126,7,7,18,2326,2326,2319,2319
Santa Cruz,23,2022-05-23,507,507,504,3,7812,7830,7790,40,16,0,0,0,262,262,262,262
Shasta,23,2022-05-23,196,196,195,1,3608,3616,3593,23,4,1,1,3,563,563,562,562
Siskiyou,23,2022-05-23,29,29,29,0,364,364,362,2,1,0,0,0,83,83,83,83
Solano,23,2022-05-23,1501,1505,1496,9,14886,14919,14831,88,24,1,1,3,449,449,448,448
Sonoma,23,2022-05-23,1486,1489,1480,9,16329,16366,16271,95,34,2,2,3,495,495,493,493
Stanislaus,23,2022-05-23,867,867,859,8,10690,10713,10615,98,37,2,2,3,1697,1697,1695,1695
Sutter,23,2022-05-23,140,140,139,1,1911,1916,1905,11,0,1,1,0,228,228,227,227
Tehama,23,2022-05-23,49,49,49,0,811,811,804,7,1,0,0,1,207,207,207,207
Trinity,23,2022-05-23,3,3,3,0,90,90,89,1,0,0,0,0,20,20,20,20
Tulare,23,2022-05-23,551,551,546,5,9071,9092,9007,85,26,0,0,0,1497,1497,1497,1497
Tuolumne,23,2022-05-23,137,137,136,1,1577,1580,1568,12,0,1,1,0,190,190,189,189
Ventura,23,2022-05-23,1917,1922,1914,8,24013,24068,23971,97,36,1,1,1,1507,1507,1506,1506
Yolo,23,2022-05-23,734,734,730,4,22661,22712,22590,122,1,0,0,1,323,323,323,323
Yuba,23,2022-05-23,150,150,149,1,1454,1457,1449,8,6,0,0,1,118,118,118,118
Alameda,24,2022-05-30,4891,4902,4884,18,60577,60723,60494,229,95,4,4,7,1899,1899,1895,1895
Amador,24,2022-05-30,88,88,87,1,1191,1192,1185,7,0,1,1,0,87,87,86,86
Butte,24,2022-05-30,275,275,274,1,2709,2714,2706,8,20,0,0,1,437,437,437,437
Calaveras,24,2022-05-30,54,54,54,0,617,617,614,3,0,0,0,0,122,122,122,122
Colusa,24,2022-05-30,13,13,13,0,170,170,169,1,0,0,0,0,21,21,21,21
Contra Costa,24,2022-05-30,3313,3322,3301,21,28946,29015,28833,182,65,7,7,9,1330,1330,1323,1323
Del Norte,24,2022-05-30,36,36,36,0,975,976,971,5,2,1,1,0,51,51,50,50
El Dorado,24,2022-05-30,333,333,331,2,2938,2944,2928,16,6,2,2,2,218,218,216,216
Fresno,24,2022-05-30,1665,1669,1659,10,19661,19707,19590,117,71,6,6,7,2781,2781,2775,2775
Glenn,24,2022-05-30,27,27,27,0,290,290,289,1,2,0,0,0,42,42,42,42
Humboldt,24,2022-05-30,182,182,181,1,2297,2301,2290,11,10,0,0,5,148,148,148,148
Imperial,24,2022-05-30,333,333,331,2,4166,4177,4155,22,2,1,1,2,946,946,945,945
Inyo,24,2022-05-30,18,18,18,0,151,151,150,1,0,0,0,0,56,56,56,56
Kern,24,2022-05-30,1077,1078,1073,5,17952,17995,17916,79,36,0,0,6,2350,2350,2350,2350
Kings,24,2022-05-30,290,290,288,2,4663,4675,4650,25,2,0,0,1,447,447,447,447
Lake,24,2022-05-30,89,89,88,1,993,995,989,6,1,0,0,0,140,140,140,140
Lassen,24,2022-05-30,50,50,50,0,1614,1618,1611,7,1,0,0,0,62,62,62,62
Los Angeles,24,2022-05-30,26043,26106,26067,39,746241,748025,746898,1127,425,47,47,54,32063,32063,32016,32016
Madera,24,2022-05-30,235,235,234,1,3310,3320,3300,20,4,0,0,1,368,368,368,368
Marin,24,2022-05-30,647,647,643,4,7142,7158,7116,42,16,3,3,1,298,298,295,295
Mariposa,24,2022-05-30,39,39,39,0,303,303,301,2,0,0,0,0,28,28,28,28
Mendocino,24,2022-05-30,137,137,136,1,1263,1266,1256,10,4,0,0,1,130,130,130,130
Merced,24,2022-05-30,372,372,370,2,3403,3413,3397,16,6,0,0,2,828,828,828,828
Modoc,24,2022-05-30,4,4,4,0,38,39,38,1,0,0,0,0,7,7,7,7
Mono,24,2022-05-30,6,6,6,0,81,81,80,1,0,0,0,0,6,6,6,6
Monterey,24,2022-05-30,526,526,521,5,7132,7149,7082,67,19,1,1,1,736,736,735,735
Napa,24,2022-05-30,314,314,313,1,3179,3187,3174,13,4,0,0,0,143,143,143,143
Nevada,24,2022-05-30,181,181,180,1,1595,1599,1590,9,3,2,2,1,130,130,128,128
Orange,24,2022-05-30,5588,5599,5580,19,81916,82112,81824,288,122,9,9,18,7125,7125,7116,7116
Placer,24,2022-05-30,746,746,741,5,6124,6138,6098,40,52,0,0,8,631,631,631,631
Plumas,24,2022-05-30,35,35,35,0,200,200,199,1,1,0,0,0,13,13,13,13
Riverside,24,2022-05-30,3836,3846,3828,18,43667,43771,43566,205,82,3,3,10,6478,6478,6475,6475
Sacramento,24,2022-05-30,3835,3846,3827,19,33240,33319,33152,167,130,8,8,20,3096,3096,3088,3088
San Benito,24,2022-05-30,153,153,152,1,1269,1272,1267,5,0,0,0,0,94,94,94,94
San Bernardino,24,2022-05-30,3345,3353,3341,12,42538,42639,42479,160,49,4,4,10,7844,7844,7840,7840
San Diego,24,2022-05-30,8418,8439,8426,13,85823,86029,85894,135,153,9,9,26,5347,5347,5338,5338
San Francisco,24,2022-05-30,3115,3122,3090,32,33321,33400,33056,344,88,11,11,14,901,901,890,890
San Joaquin,24,2022-05-30,1388,1392,1384,8,16888,16929,16835,94,25,1,1,9,2254,2254,2253,2253
San Luis Obispo,24,2022-05-30,646,646,643,3,5441,5454,5431,23,12,1,1,0,487,487,486,486
San Mateo,24,2022-05-30,2723,2730,2721,9,31108,31183,31073,110,33,3,3,2,716,716,713,713
Santa Barbara,24,2022-05-30,1029,1030,1025,5,14446,14481,14411,70,23,2,2,5,695,695,693,693
Santa Clara,24,2022-05-30,6991,7008,6996,12,84287,84489,84347,142,154,9,9,22,2335,2335,2326,2326
Santa Cruz,24,2022-05-30,527,527,525,2,6238,6253,6227,26,7,1,1,1,263,263,262,262
Shasta,24,2022-05-30,133,133,132,1,2837,2844,2830,14,4,3,3,4,566,566,563,563
Siskiyou,24,2022-05-30,55,55,55,0,340,340,339,1,3,0,0,0,83,83,83,83
Solano,24,2022-05-30,1170,1173,1167,6,11534,11562,11507,55,28,0,0,7,449,449,449,449
Sonoma,24,2022-05-30,1198,1199,1194,5,13237,13267,13206,61,38,2,2,5,497,497,495,495
Stanislaus,24,2022-05-30,800,800,794,6,8578,8599,8537,62,55,2,2,3,1699,1699,1697,1697
Sutter,24,2022-05-30,157,157,156,1,1701,1706,1698,8,0,0,0,0,228,228,228,228
Tehama,24,2022-05-30,62,62,62,0,757,757,752,5,2,0,0,0,207,207,207,207
Trinity,24,2022-05-30,8,8,8,0,96,96,95,1,0,0,0,0,20,20,20,20
Tulare,24,2022-05-30,598,598,594,4,7485,7504,7448,56,19,0,0,0,1497,1497,1497,1497
Tuolumne,24,2022-05-30,121,121,120,1,1304,1307,1299,8,3,0,0,0,190,190,190,190
Ventura,24,2022-05-30,1685,1689,1684,5,19538,19585,19522,63,30,1,1,4,1508,1508,1507,1507
Yolo,24,2022-05-30,612,612,609,3,17616,17659,17584,75,4,0,0,1,323,323,323,323
Yuba,24,2022-05-30,144,144,143,1,1278,1281,1275,6,7,0,0,2,118,118,118,118
Alameda,25,2022-06-06,6468,6484,6465,19,72957,73141,72929,212,112,5,5,12,1904,1904,1899,1899
Amador,25,2022-06-06,115,115,114,1,1724,1729,1721,8,1,0,0,1,87,87,87,87
Butte,25,2022-06-06,452,452,451,1,3617,3627,3619,8,24,1,1,1,438,438,437,437
Calaveras,25,2022-06-06,73,73,73,0,736,736,733,3,0,2,2,0,124,124,122,122
Colusa,25,2022-06-06,22,22,22,0,275,275,274,1,3,0,0,0,21,21,21,21
Contra Costa,25,2022-06-06,4231,4242,4222,20,35616,35706,35533,173,107,9,9,7,1339,1339,1330,1330
Del Norte,25,2022-06-06,63,63,63,0,1133,1134,1130,4,2,0,0,0,51,51,51,51
El Dorado,25,2022-06-06,411,411,409,2,3635,3645,3630,15,5,0,0,5,218,218,218,218
Fresno,25,2022-06-06,2440,2446,2435,11,22977,23035,22930,105,94,2,2,6,2783,2783,2781,2781
Glenn,25,2022-06-06,41,41,41,0,323,323,322,1,3,0,0,0,42,42,42,42
Humboldt,25,2022-06-06,260,260,259,1,3054,3061,3050,11,14,1,1,3,149,149,148,148
Imperial,25,2022-06-06,464,464,462,2,4894,4908,4888,20,2,0,0,0,946,946,946,946
Inyo,25,2022-06-06,20,20,20,0,213,213,212,1,1,0,0,0,56,56,56,56
Kern,25,2022-06-06,1608,1613,1608,5,22965,23023,22945,78,35,1,1,6,2351,2351,2350,2350
Kings,25,2022-06-06,398,398,396,2,5504,5519,5496,23,10,0,0,1,447,447,447,447
Lake,25,2022-06-06,136,136,135,1,1179,1181,1175,6,5,0,0,2,140,140,140,140
Lassen,25,2022-06-06,69,69,69,0,2397,2402,2394,8,2,0,0,0,62,62,62,62
Los Angeles,25,2022-06-06,35133,35222,35182,40,1041155,1043787,1042583,1204,496,38,38,61,32101,32101,32063,32063
Madera,25,2022-06-06,351,351,349,2,4126,4136,4117,19,7,0,0,1,368,368,368,368
Marin,25,2022-06-06,735,735,732,3,7636,7656,7622,34,10,2,2,5,300,300,298,298
Mariposa,25,2022-06-06,58,58,58,0,404,404,402,2,0,0,0,0,28,28,28,28
Mendocino,25,2022-06-06,209,209,208,1,1711,1716,1705,11,9,1,1,2,131,131,130,130
Merced,25,2022-06-06,534,534,532,2,4524,4538,4522,16,16,0,0,0,828,828,828,828
Modoc,25,2022-06-06,11,11,11,0,37,38,37,1,0,0,0,0,7,7,7,7
Mono,25,2022-06-06,15,15,15,0,120,120,119,1,0,0,0,0,6,6,6,6
Monterey,25,2022-06-06,1000,1000,993,7,10208,10235,10161,74,17,2,2,1,738,738,736,736
Napa,25,2022-06-06,543,543,541,2,4203,4214,4201,13,8,1,1,0,144,144,143,143
Nevada,25,2022-06-06,248,248,247,1,2150,2155,2145,10,5,0,0,0,130,130,130,130
Orange,25,2022-06-06,7558,7578,7558,20,73491,73676,73479,197,140,12,12,18,7137,7137,7125,7125
Placer,25,2022-06-06,869,869,865,4,7586,7604,7566,38,65,0,0,11,631,631,631,631
Plumas,25,2022-06-06,40,40,40,0,321,321,320,1,0,0,0,0,13,13,13,13
Riverside,25,2022-06-06,5333,5345,5326,19,55730,55871,55670,201,88,6,6,10,6484,6484,6478,6478
Sacramento,25,2022-06-06,4937,4949,4930,19,42543,42650,42485,165,149,14,14,20,3110,3110,3096,3096
San Benito,25,2022-06-06,272,272,271,1,2013,2018,2012,6,0,0,0,1,94,94,94,94
San Bernardino,25,2022-06-06,5172,5185,5170,15,55157,55296,55136,160,77,6,6,14,7850,7850,7844,7844
San Diego,25,2022-06-06,10801,10829,10816,13,100410,100664,100542,122,185,8,8,22,5355,5355,5347,5347
San Francisco,25,2022-06-06,3520,3530,3502,28,38164,38260,37955,305,77,0,0,11,901,901,901,901
San Joaquin,25,2022-06-06,2121,2126,2117,9,22011,22067,21973,94,40,4,4,9,2258,2258,2254,2254
San Luis Obispo,25,2022-06-06,897,898,895,3,7536,7556,7531,25,16,1,1,1,488,488,487,487
San Mateo,25,2022-06-06,3196,3204,3195,9,36936,37030,36930,100,36,2,2,4,718,718,716,716
Santa Barbara,25,2022-06-06,1246,1249,1244,5,15066,15104,15048,56,22,1,1,5,696,696,695,695
Santa Clara,25,2022-06-06,8495,8517,8506,11,101181,101437,101306,131,176,6,6,22,2341,2341,2335,2335
Santa Cruz,25,2022-06-06,896,897,894,3,9697,9722,9692,30,24,1,1,3,264,264,263,263
Shasta,25,2022-06-06,209,209,208,1,4424,4433,4416,17,10,2,2,2,568,568,566,566
Siskiyou,25,2022-06-06,40,40,40,0,431,431,430,1,1,0,0,0,83,83,83,83
Solano,25,2022-06-06,1727,1732,1726,6,15130,15168,15113,55,29,2,2,1,451,451,449,449
Sonoma,25,2022-06-06,1632,1637,1631,6,13984,14019,13970,49,38,1,1,1,498,498,497,497
Stanislaus,25,2022-06-06,1187,1189,1182,7,10910,10937,10876,61,60,1,1,2,1700,1700,1699,1699
Sutter,25,2022-06-06,206,206,205,1,1941,1946,1939,7,0,0,0,0,228,228,228,228
Tehama,25,2022-06-06,83,83,83,0,1051,1053,1047,6,2,0,0,0,207,207,207,207
Trinity,25,2022-06-06,7,7,7,0,110,110,109,1,0,0,0,0,20,20,20,20
Tulare,25,2022-06-06,862,862,857,5,10773,10801,10740,61,24,0,0,0,1497,1497,1497,1497
Tuolumne,25,2022-06-06,123,123,122,1,1721,1726,1718,8,4,0,0,1,190,190,190,190
Ventura,25,2022-06-06,1972,1977,1972,5,24753,24816,24754,62,43,3,3,3,1511,1511,1508,1508
Yolo,25,2022-06-06,831,831,828,3,21419,21472,21402,70,2,1,1,0,324,324,323,323
Yuba,25,2022-06-06,186,186,185,1,1558,1563,1558,5,9,0,0,1,118,118,118,118
Alameda,26,2022-06-13,5072,5084,5073,11,55664,55814,55689,125,106,4,4,18,1908,1908,1904,1904
Amador,26,2022-06-13,130,130,130,0,1413,1417,1412,5,1,0,0,0,87,87,87,87
Butte,26,2022-06-13,394,394,393,1,3461,3471,3465,6,31,4,4,0,442,442,438,438
Calaveras,26,2022-06-13,69,69,69,0,654,654,652,2,0,0,0,0,124,124,124,124
Colusa,26,2022-06-13,12,12,12,0,327,327,326,1,17,0,0,0,21,21,21,21
Contra Costa,26,2022-06-13,3405,3414,3401,13,27918,27994,27888,106,89,8,8,12,1347,1347,1339,1339
Del Norte,26,2022-06-13,79,79,79,0,658,658,656,2,4,0,0,0,51,51,51,51
El Dorado,26,2022-06-13,332,332,331,1,3196,3205,3195,10,7,3,3,1,221,221,218,218
Fresno,26,2022-06-13,2384,2391,2383,8,20948,21004,20930,74,103,4,4,13,2787,2787,2783,2783
Glenn,26,2022-06-13,32,32,32,0,329,329,328,1,2,0,0,0,42,42,42,42
Humboldt,26,2022-06-13,262,262,261,1,2325,2330,2323,7,11,0,0,3,149,149,149,149
Imperial,26,2022-06-13,446,446,445,1,4567,4580,4565,15,6,1,1,0,947,947,946,946
Inyo,26,2022-06-13,13,13,13,0,189,189,188,1,0,0,0,0,56,56,56,56
Kern,26,2022-06-13,1559,1564,1560,4,21408,21466,21410,56,38,1,1,5,2352,2352,2351,2351
Kings,26,2022-06-13,359,359,358,1,5156,5170,5154,16,4,1,1,0,448,448,447,447
Lake,26,2022-06-13,138,138,137,1,1226,1230,1226,4,1,0,0,0,140,140,140,140
Lassen,26,2022-06-13,77,77,77,0,1993,1998,1993,5,2,0,0,0,62,62,62,62
Los Angeles,26,2022-06-13,29993,30073,30046,27,659868,661646,661047,599,519,53,53,60,32154,32154,32101,32101
Madera,26,2022-06-13,380,380,379,1,4230,4242,4227,15,7,0,0,2,368,368,368,368
Marin,26,2022-06-13,685,685,683,2,7021,7040,7015,25,16,2,2,2,302,302,300,300
Mariposa,26,2022-06-13,45,45,45,0,372,372,371,1,0,0,0,0,28,28,28,28
Mendocino,26,2022-06-13,161,161,160,1,1566,1571,1563,8,9,0,0,1,131,131,131,131
Merced,26,2022-06-13,563,563,561,2,4167,4180,4169,11,13,0,0,2,828,828,828,828
Modoc,26,2022-06-13,7,7,7,0,34,35,34,1,1,1,1,0,8,8,7,7
Mono,26,2022-06-13,19,19,19,0,92,92,91,1,0,0,0,0,6,6,6,6
Monterey,26,2022-06-13,834,834,829,5,8631,8655,8606,49,25,3,3,1,741,741,738,738
Napa,26,2022-06-13,431,431,430,1,3926,3938,3929,9,2,1,1,1,145,145,144,144
Nevada,26,2022-06-13,186,186,185,1,1874,1879,1872,7,8,0,0,0,130,130,130,130
Orange,26,2022-06-13,6992,7012,6998,14,65016,65192,65056,136,175,14,14,19,7151,7151,7137,7137
Placer,26,2022-06-13,790,790,787,3,6778,6796,6770,26,79,2,2,7,633,633,631,631
Plumas,26,2022-06-13,34,34,34,0,271,271,270,1,0,0,0,0,13,13,13,13
Riverside,26,2022-06-13,5045,5058,5044,14,47622,47751,47618,133,105,3,3,11,6487,6487,6484,6484
Sacramento,26,2022-06-13,4162,4174,4161,13,37594,37697,37584,113,190,12,12,20,3122,3122,3110,3110
San Benito,26,2022-06-13,199,199,199,0,1773,1778,1774,4,1,0,0,1,94,94,94,94
San Bernardino,26,2022-06-13,4656,4669,4659,10,48072,48203,48095,108,96,6,6,15,7856,7856,7850,7850
San Diego,26,2022-06-13,9626,9653,9644,9,84845,85075,84995,80,192,9,9,27,5364,5364,5355,5355
San Francisco,26,2022-06-13,3040,3048,3029,19,31043,31126,30933,193,72,11,11,13,912,912,901,901
San Joaquin,26,2022-06-13,1905,1910,1904,6,18844,18894,18832,62,32,5,5,3,2263,2263,2258,2258
San Luis Obispo,26,2022-06-13,661,661,659,2,6047,6063,6048,15,21,0,0,0,488,488,488,488
San Mateo,26,2022-06-13,2627,2634,2629,5,29025,29103,29042,61,44,3,3,3,721,721,718,718
Santa Barbara,26,2022-06-13,931,931,928,3,9467,9493,9466,27,15,1,1,5,697,697,696,696
Santa Clara,26,2022-06-13,7010,7029,7022,7,75496,75700,75624,76,182,11,11,23,2352,2352,2341,2341
Santa Cruz,26,2022-06-13,842,842,840,2,9937,9964,9940,24,23,0,0,1,264,264,264,264
Shasta,26,2022-06-13,219,219,218,1,3389,3396,3386,10,8,1,1,0,569,569,568,568
Siskiyou,26,2022-06-13,50,50,50,0,372,372,371,1,1,0,0,0,83,83,83,83
Solano,26,2022-06-13,1672,1677,1672,5,12857,12892,12856,36,33,0,0,2,451,451,451,451
Sonoma,26,2022-06-13,1337,1340,1336,4,11643,11675,11643,32,36,2,2,6,500,500,498,498
Stanislaus,26,2022-06-13,1132,1133,1128,5,9449,9474,9433,41,63,1,1,7,1701,1701,1700,1700
Sutter,26,2022-06-13,194,194,193,1,1722,1727,1722,5,0,0,0,0,228,228,228,228
Tehama,26,2022-06-13,87,87,87,0,967,970,966,4,3,0,0,0,207,207,207,207
Trinity,26,2022-06-13,11,11,11,0,84,85,84,1,0,0,0,0,20,20,20,20
Tulare,26,2022-06-13,816,817,813,4,9453,9478,9436,42,26,2,2,1,1499,1499,1497,1497
Tuolumne,26,2022-06-13,147,147,146,1,1442,1446,1441,5,2,0,0,0,190,190,190,190
Ventura,26,2022-06-13,1934,1940,1936,4,20973,21031,20991,40,38,3,3,5,1514,1514,1511,1511
Yolo,26,2022-06-13,769,769,767,2,14231,14270,14233,37,4,0,0,0,324,324,324,324
Yuba,26,2022-06-13,188,188,187,1,1423,1428,1424,4,8,0,0,1,118,118,118,118
Alameda,27,2022-06-20,4945,4958,4949,9,48398,48540,48455,85,105,12,12,14,1920,1920,1908,1908
Amador,27,2022-06-20,104,104,104,0,1247,1251,1247,4,2,0,0,0,87,87,87,87
Butte,27,2022-06-20,414,414,413,1,3558,3570,3565,5,28,3,3,1,445,445,442,442
Calaveras,27,2022-06-20,82,82,82,0,621,621,619,2,0,0,0,0,124,124,124,124
Colusa,27,2022-06-20,17,17,17,0,176,177,176,1,15,1,1,0,22,22,21,21
Contra Costa,27,2022-06-20,3331,3341,3331,10,25963,26039,25962,77,81,7,7,8,1354,1354,1347,1347
Del Norte,27,2022-06-20,82,82,82,0,611,611,610,1,3,1,1,1,52,52,51,51
El Dorado,27,2022-06-20,351,351,350,1,3073,3081,3073,8,5,1,1,1,222,222,221,221
Fresno,27,2022-06-20,2457,2464,2457,7,19759,19817,19762,55,100,3,3,16,2790,2790,2787,2787
Glenn,27,2022-06-20,40,40,40,0,314,314,313,1,3,0,0,0,42,42,42,42
Humboldt,27,2022-06-20,272,272,271,1,2273,2278,2273,5,11,0,0,3,149,149,149,149
Imperial,27,2022-06-20,602,602,601,1,3706,3718,3709,9,5,0,0,0,947,947,947,947
Inyo,27,2022-06-20,18,18,18,0,187,188,187,1,0,0,0,0,56,56,56,56
Kern,27,2022-06-20,1647,1652,1649,3,20098,20156,20115,41,39,5,5,9,2357,2357,2352,2352
Kings,27,2022-06-20,413,413,412,1,4865,4880,4868,12,6,1,1,0,449,449,448,448
Lake,27,2022-06-20,120,120,120,0,1233,1238,1234,4,1,0,0,2,140,140,140,140
Lassen,27,2022-06-20,43,43,43,0,1221,1223,1221,2,1,0,0,0,62,62,62,62
Los Angeles,27,2022-06-20,27546,27627,27608,19,350901,351926,351682,244,596,57,57,68,32211,32211,32154,32154
Madera,27,2022-06-20,335,335,334,1,4163,4175,4163,12,4,0,0,1,368,368,368,368
Marin,27,2022-06-20,691,691,689,2,6317,6335,6318,17,21,0,0,1,302,302,302,302
Mariposa,27,2022-06-20,53,53,53,0,335,335,334,1,0,0,0,0,28,28,28,28
Mendocino,27,2022-06-20,178,178,177,1,1576,1581,1575,6,3,0,0,0,131,131,131,131
Merced,27,2022-06-20,539,539,538,1,3951,3964,3956,8,7,3,3,1,831,831,828,828
Modoc,27,2022-06-20,5,5,5,0,37,38,37,1,0,0,0,0,8,8,8,8
Mono,27,2022-06-20,6,6,6,0,82,83,82,1,1,1,1,0,7,7,6,6
Monterey,27,2022-06-20,894,894,890,4,8895,8920,8881,39,38,1,1,2,742,742,741,741
Napa,27,2022-06-20,362,362,361,1,3129,3139,3133,6,3,1,1,0,146,146,145,145
Nevada,27,2022-06-20,170,170,170,0,1617,1622,1618,4,6,1,1,0,131,131,130,130
Orange,27,2022-06-20,6974,6995,6984,11,60315,60490,60392,98,152,10,10,23,7161,7161,7151,7151
Placer,27,2022-06-20,671,671,669,2,6037,6055,6037,18,69,1,1,7,634,634,633,633
Plumas,27,2022-06-20,39,39,39,0,239,239,238,1,0,0,0,0,13,13,13,13
Riverside,27,2022-06-20,4953,4968,4957,11,43032,43158,43064,94,112,5,5,14,6492,6492,6487,6487
Sacramento,27,2022-06-20,3913,3925,3916,9,34781,34882,34800,82,171,12,12,21,3134,3134,3122,3122
San Benito,27,2022-06-20,172,172,172,0,1591,1596,1593,3,0,1,1,2,95,95,94,94
San Bernardino,27,2022-06-20,4502,4514,4506,8,45584,45717,45637,80,105,12,12,17,7868,7868,7856,7856
San Diego,27,2022-06-20,9693,9721,9714,7,77427,77654,77597,57,203,8,8,17,5372,5372,5364,5364
San Francisco,27,2022-06-20,3058,3067,3052,15,28221,28302,28165,137,72,12,12,14,924,924,912,912
San Joaquin,27,2022-06-20,1662,1667,1663,4,17758,17810,17764,46,38,5,5,6,2268,2268,2263,2263
San Luis Obispo,27,2022-06-20,595,595,594,1,5811,5828,5816,12,27,10,10,0,498,498,488,488
San Mateo,27,2022-06-20,2609,2616,2612,4,25815,25890,25848,42,42,2,2,1,723,723,721,721
Santa Barbara,27,2022-06-20,933,934,932,2,8160,8184,8166,18,33,2,2,6,699,699,697,697
Santa Clara,27,2022-06-20,6777,6797,6792,5,62299,62481,62432,49,170,8,8,21,2360,2360,2352,2352
Santa Cruz,27,2022-06-20,818,818,816,2,9107,9135,9118,17,19,1,1,2,265,265,264,264
Shasta,27,2022-06-20,241,241,240,1,3372,3381,3373,8,9,1,1,1,570,570,569,569
Siskiyou,27,2022-06-20,61,61,61,0,394,394,393,1,5,1,1,0,84,84,83,83
Solano,27,2022-06-20,1404,1409,1406,3,11433,11466,11441,25,41,0,0,5,451,451,451,451
Sonoma,27,2022-06-20,1397,1402,1399,3,10786,10818,10795,23,28,1,1,3,501,501,500,500
Stanislaus,27,2022-06-20,1039,1041,1037,4,8824,8850,8820,30,70,6,6,7,1707,1707,1701,1701
Sutter,27,2022-06-20,196,196,196,0,1856,1862,1858,4,0,0,0,0,228,228,228,228
Tehama,27,2022-06-20,98,98,98,0,889,891,888,3,3,0,0,0,207,207,207,207
Trinity,27,2022-06-20,10,10,10,0,106,107,106,1,0,0,0,0,20,20,20,20
Tulare,27,2022-06-20,871,872,869,3,8727,8752,8722,30,32,8,8,0,1507,1507,1499,1499
Tuolumne,27,2022-06-20,141,141,141,0,1553,1558,1554,4,3,0,0,1,190,190,190,190
Ventura,27,2022-06-20,1835,1842,1839,3,18654,18707,18679,28,50,1,1,7,1515,1515,1514,1514
Yolo,27,2022-06-20,683,683,682,1,10543,10573,10552,21,1,2,2,2,326,326,324,324
Yuba,27,2022-06-20,148,148,148,0,1340,1345,1342,3,13,0,0,5,118,118,118,118
Alameda,28,2022-06-27,5458,5477,5470,7,48040,48191,48125,66,124,8,8,16,1928,1928,1920,1920
Amador,28,2022-06-27,88,88,88,0,1149,1153,1150,3,3,0,0,1,87,87,87,87
Butte,28,2022-06-27,409,409,409,0,3468,3479,3475,4,30,2,2,0,447,447,445,445
Calaveras,28,2022-06-27,68,68,68,0,569,569,568,1,1,2,2,0,126,126,124,124
Colusa,28,2022-06-27,28,28,28,0,282,283,282,1,6,0,0,0,22,22,22,22
Contra Costa,28,2022-06-27,3520,3532,3524,8,25860,25942,25883,59,82,11,11,7,1365,1365,1354,1354
Del Norte,28,2022-06-27,140,140,140,0,669,669,668,1,5,1,1,2,53,53,52,52
El Dorado,28,2022-06-27,432,432,431,1,3357,3368,3362,6,5,0,0,1,222,222,222,222
Fresno,28,2022-06-27,2805,2813,2807,6,20027,20090,20047,43,136,2,2,17,2792,2792,2790,2790
Glenn,28,2022-06-27,29,29,29,0,296,296,295,1,1,0,0,0,42,42,42,42
Humboldt,28,2022-06-27,261,261,261,0,2188,2193,2189,4,10,0,0,2,149,149,149,149
Imperial,28,2022-06-27,701,701,700,1,4021,4035,4027,8,7,0,0,4,947,947,947,947
Inyo,28,2022-06-27,32,32,32,0,311,311,310,1,1,0,0,0,56,56,56,56
Kern,28,2022-06-27,1810,1817,1814,3,17247,17301,17273,28,52,7,7,8,2364,2364,2357,2357
Kings,28,2022-06-27,468,468,467,1,3931,3943,3935,8,9,0,0,0,449,449,449,449
Lake,28,2022-06-27,121,121,121,0,1138,1141,1138,3,2,0,0,0,140,140,140,140
Lassen,28,2022-06-27,51,51,51,0,847,848,847,1,1,0,0,0,62,62,62,62
Los Angeles,28,2022-06-27,32724,32828,32810,18,363896,365041,364844,197,679,73,73,68,32284,32284,32211,32211
Madera,28,2022-06-27,412,412,411,1,4285,4299,4290,9,8,0,0,0,368,368,368,368
Marin,28,2022-06-27,659,659,658,1,6225,6245,6232,13,20,1,1,2,303,303,302,302
Mariposa,28,2022-06-27,55,55,55,0,310,310,309,1,0,0,0,0,28,28,28,28
Mendocino,28,2022-06-27,153,153,153,0,1447,1452,1448,4,5,1,1,1,132,132,131,131
Merced,28,2022-06-27,614,614,613,1,4031,4044,4037,7,14,2,2,0,833,833,831,831
Modoc,28,2022-06-27,7,7,7,0,32,33,32,1,0,0,0,0,8,8,8,8
Mono,28,2022-06-27,24,24,24,0,109,110,109,1,1,0,0,0,7,7,7,7
Monterey,28,2022-06-27,932,933,930,3,8253,8278,8250,28,44,2,2,3,744,744,742,742
Napa,28,2022-06-27,392,392,391,1,3309,3319,3314,5,3,2,2,1,148,148,146,146
Nevada,28,2022-06-27,189,189,189,0,1618,1623,1620,3,4,0,0,3,131,131,131,131
Orange,28,2022-06-27,7534,7558,7549,9,59174,59360,59285,75,183,16,16,26,7177,7177,7161,7161
Placer,28,2022-06-27,805,805,803,2,6158,6177,6162,15,79,6,6,6,640,640,634,634
Plumas,28,2022-06-27,50,50,50,0,257,257,256,1,1,0,0,0,13,13,13,13
Riverside,28,2022-06-27,6184,6204,6194,10,44669,44810,44734,76,141,11,11,17,6503,6503,6492,6492
Sacramento,28,2022-06-27,4149,4162,4154,8,35256,35365,35300,65,173,9,9,25,3143,3143,3134,3134
San Benito,28,2022-06-27,221,221,221,0,1645,1650,1648,2,0,0,0,1,95,95,95,95
San Bernardino,28,2022-06-27,5704,5724,5716,8,48094,48245,48179,66,130,12,12,24,7880,7880,7868,7868
San Diego,28,2022-06-27,10866,10900,10894,6,80552,80806,80760,46,264,7,7,28,5379,5379,5372,5372
San Francisco,28,2022-06-27,3281,3290,3278,12,29199,29291,29181,110,92,5,5,23,929,929,924,924
San Joaquin,28,2022-06-27,1883,1889,1885,4,17798,17853,17817,36,46,2,2,5,2270,2270,2268,2268
San Luis Obispo,28,2022-06-27,645,645,644,1,5638,5655,5646,9,25,3,3,0,501,501,498,498
San Mateo,28,2022-06-27,2868,2878,2874,4,26786,26871,26837,34,36,1,1,2,724,724,723,723
Santa Barbara,28,2022-06-27,1145,1149,1147,2,9772,9803,9786,17,26,2,2,2,701,701,699,699
Santa Clara,28,2022-06-27,7492,7516,7512,4,60088,60278,60242,36,213,10,10,19,2370,2370,2360,2360
Santa Cruz,28,2022-06-27,861,863,862,1,9142,9171,9157,14,26,2,2,1,267,267,265,265
Shasta,28,2022-06-27,340,340,339,1,3308,3317,3311,6,21,0,0,4,570,570,570,570
Siskiyou,28,2022-06-27,63,63,63,0,355,355,354,1,2,1,1,0,85,85,84,84
Solano,28,2022-06-27,1593,1598,1595,3,12980,13022,13000,22,47,0,0,4,451,451,451,451
Sonoma,28,2022-06-27,1368,1373,1371,2,10092,10125,10108,17,33,2,2,3,503,503,501,501
Stanislaus,28,2022-06-27,1211,1216,1213,3,8578,8605,8582,23,96,2,2,6,1709,1709,1707,1707
Sutter,28,2022-06-27,197,197,197,0,1843,1849,1846,3,0,0,0,0,228,228,228,228
Tehama,28,2022-06-27,91,91,91,0,888,891,889,2,3,0,0,0,207,207,207,207
Trinity,28,2022-06-27,24,24,24,0,142,143,142,1,1,0,0,0,20,20,20,20
Tulare,28,2022-06-27,903,904,902,2,7884,7910,7889,21,35,0,0,2,1507,1507,1507,1507
Tuolumne,28,2022-06-27,171,171,171,0,1401,1406,1403,3,1,3,3,1,193,193,190,190
Ventura,28,2022-06-27,2090,2097,2095,2,18524,18583,18561,22,61,3,3,1,1518,1518,1515,1515
Yolo,28,2022-06-27,792,792,791,1,11202,11238,11221,17,8,0,0,1,326,326,326,326
Yuba,28,2022-06-27,171,171,171,0,1434,1439,1437,2,10,2,2,2,120,120,118,118
Alameda,29,2022-07-04,4817,4834,4829,5,38453,38585,38543,42,128,11,11,10,1939,1939,1928,1928
Amador,29,2022-07-04,66,66,66,0,1534,1539,1536,3,3,1,1,1,88,88,87,87
Butte,29,2022-07-04,283,283,283,0,2490,2500,2498,2,28,2,2,1,449,449,447,447
Calaveras,29,2022-07-04,82,82,82,0,487,487,486,1,0,2,2,0,128,128,126,126
Colusa,29,2022-07-04,21,21,21,0,150,151,150,1,4,0,0,0,22,22,22,22
Contra Costa,29,2022-07-04,3321,3332,3326,6,20776,20846,20808,38,76,9,9,12,1374,1374,1365,1365
Del Norte,29,2022-07-04,138,138,138,0,587,587,586,1,3,0,0,0,53,53,53,53
El Dorado,29,2022-07-04,307,307,307,0,2389,2398,2394,4,10,1,1,0,223,223,222,222
Fresno,29,2022-07-04,2457,2465,2461,4,15711,15764,15737,27,158,6,6,17,2798,2798,2792,2792
Glenn,29,2022-07-04,24,24,24,0,157,158,157,1,1,0,0,0,42,42,42,42
Humboldt,29,2022-07-04,188,188,188,0,1582,1586,1584,2,12,2,2,3,151,151,149,149
Imperial,29,2022-07-04,698,698,697,1,3254,3266,3261,5,8,1,1,3,948,948,947,947
Inyo,29,2022-07-04,41,41,41,0,292,293,292,1,1,0,0,0,56,56,56,56
Kern,29,2022-07-04,1756,1763,1761,2,14134,14183,14165,18,63,4,4,9,2368,2368,2364,2364
Kings,29,2022-07-04,437,437,436,1,3446,3459,3454,5,5,0,0,0,449,449,449,449
Lake,29,2022-07-04,107,107,107,0,785,788,787,1,3,2,2,0,142,142,140,140
Lassen,29,2022-07-04,31,31,31,0,639,640,639,1,2,0,0,0,62,62,62,62
Los Angeles,29,2022-07-04,32081,32192,32178,14,285431,286411,286288,123,801,88,88,85,32372,32372,32284,32284
Madera,29,2022-07-04,341,341,340,1,3179,3191,3185,6,9,0,0,1,368,368,368,368
Marin,29,2022-07-04,607,607,606,1,5153,5171,5162,9,25,1,1,2,304,304,303,303
Mariposa,29,2022-07-04,36,36,36,0,222,223,222,1,0,0,0,0,28,28,28,28
Mendocino,29,2022-07-04,163,163,163,0,1118,1122,1119,3,6,2,2,1,134,134,132,132
Merced,29,2022-07-04,597,597,596,1,2917,2928,2924,4,14,2,2,1,835,835,833,833
Modoc,29,2022-07-04,10,10,10,0,31,32,31,1,0,0,0,0,8,8,8,8
Mono,29,2022-07-04,22,22,22,0,81,82,81,1,1,0,0,0,7,7,7,7
Monterey,29,2022-07-04,839,840,838,2,6302,6324,6307,17,39,2,2,4,746,746,744,744
Napa,29,2022-07-04,340,340,340,0,2551,2560,2557,3,13,0,0,1,148,148,148,148
Nevada,29,2022-07-04,177,177,177,0,1266,1270,1268,2,5,0,0,1,131,131,131,131
Orange,29,2022-07-04,6940,6963,6956,7,50556,50731,50680,51,203,24,24,34,7201,7201,7177,7177
Placer,29,2022-07-04,807,809,808,1,5033,5050,5041,9,72,3,3,6,643,643,640,640
Plumas,29,2022-07-04,31,31,31,0,172,173,172,1,0,0,0,0,13,13,13,13
Riverside,29,2022-07-04,6383,6406,6397,9,38165,38297,38245,52,137,3,3,8,6506,6506,6503,6503
Sacramento,29,2022-07-04,3556,3567,3562,5,26434,26526,26487,39,163,19,19,22,3162,3162,3143,3143
San Benito,29,2022-07-04,210,210,210,0,1266,1270,1268,2,3,0,0,0,95,95,95,95
San Bernardino,29,2022-07-04,6069,6090,6083,7,40818,40959,40915,44,147,12,12,26,7892,7892,7880,7880
San Diego,29,2022-07-04,9606,9639,9635,4,65399,65624,65594,30,262,9,9,43,5388,5388,5379,5379
San Francisco,29,2022-07-04,2854,2865,2857,8,23445,23527,23457,70,100,11,11,18,940,940,929,929
San Joaquin,29,2022-07-04,1670,1676,1673,3,14501,14552,14529,23,41,5,5,4,2275,2275,2270,2270
San Luis Obispo,29,2022-07-04,614,614,613,1,4160,4174,4169,5,24,0,0,0,501,501,501,501
San Mateo,29,2022-07-04,2546,2555,2552,3,20797,20868,20847,21,39,1,1,3,725,725,724,724
Santa Barbara,29,2022-07-04,1057,1061,1060,1,7649,7676,7665,11,26,4,4,4,705,705,701,701
Santa Clara,29,2022-07-04,6787,6812,6809,3,49341,49511,49487,24,191,16,16,34,2386,2386,2370,2370
Santa Cruz,29,2022-07-04,732,733,732,1,7116,7140,7132,8,22,0,0,0,267,267,267,267
Shasta,29,2022-07-04,279,279,279,0,2396,2404,2400,4,15,5,5,3,575,575,570,570
Siskiyou,29,2022-07-04,48,48,48,0,326,327,326,1,1,0,0,1,85,85,85,85
Solano,29,2022-07-04,1318,1323,1321,2,9735,9769,9756,13,50,0,0,5,451,451,451,451
Sonoma,29,2022-07-04,1085,1089,1088,1,8084,8112,8101,11,35,2,2,1,505,505,503,503
Stanislaus,29,2022-07-04,1168,1172,1170,2,6989,7013,6998,15,84,6,6,16,1715,1715,1709,1709
Sutter,29,2022-07-04,231,231,231,0,1672,1677,1675,2,0,0,0,0,228,228,228,228
Tehama,29,2022-07-04,132,132,132,0,821,824,822,2,3,1,1,0,208,208,207,207
Trinity,29,2022-07-04,17,17,17,0,143,144,143,1,2,0,0,0,20,20,20,20
Tulare,29,2022-07-04,944,947,945,2,6099,6120,6107,13,40,4,4,1,1511,1511,1507,1507
Tuolumne,29,2022-07-04,164,164,164,0,937,939,937,2,8,0,0,1,193,193,193,193
Ventura,29,2022-07-04,1948,1955,1953,2,15397,15450,15436,14,66,2,2,8,1520,1520,1518,1518
Yolo,29,2022-07-04,535,535,534,1,7175,7200,7191,9,6,1,1,2,327,327,326,326
Yuba,29,2022-07-04,167,167,167,0,1078,1082,1081,1,9,0,0,1,120,120,120,120
Alameda,30,2022-07-11,5788,5810,5805,5,48042,48232,48192,40,119,8,8,16,1947,1947,1939,1939
Amador,30,2022-07-11,91,91,91,0,1502,1508,1506,2,2,0,0,0,88,88,88,88
Butte,30,2022-07-11,496,496,496,0,3297,3312,3310,2,27,1,1,4,450,450,449,449
Calaveras,30,2022-07-11,78,78,78,0,566,566,565,1,0,1,1,1,129,129,128,128
Colusa,30,2022-07-11,26,26,26,0,483,486,485,1,0,0,0,0,22,22,22,22
Contra Costa,30,2022-07-11,3677,3691,3686,5,26456,26560,26523,37,91,11,11,11,1385,1385,1374,1374
Del Norte,30,2022-07-11,174,174,174,0,676,678,677,1,5,0,0,1,53,53,53,53
El Dorado,30,2022-07-11,381,381,381,0,3138,3151,3147,4,12,1,1,3,224,224,223,223
Fresno,30,2022-07-11,3653,3666,3661,5,21637,21722,21693,29,161,7,7,14,2805,2805,2798,2798
Glenn,30,2022-07-11,45,45,45,0,382,383,382,1,0,0,0,0,42,42,42,42
Humboldt,30,2022-07-11,291,291,291,0,2190,2197,2195,2,11,1,1,2,152,152,151,151
Imperial,30,2022-07-11,1115,1120,1119,1,4764,4783,4777,6,14,1,1,1,949,949,948,948
Inyo,30,2022-07-11,38,38,38,0,389,390,389,1,0,1,1,0,57,57,56,56
Kern,30,2022-07-11,2450,2460,2458,2,16925,16991,16975,16,77,2,2,9,2370,2370,2368,2368
Kings,30,2022-07-11,729,731,730,1,4340,4357,4352,5,11,3,3,0,452,452,449,449
Lake,30,2022-07-11,126,126,126,0,1109,1114,1112,2,0,0,0,0,142,142,142,142
Lassen,30,2022-07-11,59,59,59,0,820,823,822,1,2,1,1,0,63,63,62,62
Los Angeles,30,2022-07-11,43217,43387,43373,14,380812,382315,382189,126,1038,88,88,115,32460,32460,32372,32372
Madera,30,2022-07-11,531,531,530,1,4122,4139,4133,6,15,0,0,3,368,368,368,368
Marin,30,2022-07-11,603,603,602,1,5913,5936,5928,8,17,1,1,1,305,305,304,304
Mariposa,30,2022-07-11,52,52,52,0,283,284,283,1,0,0,0,0,28,28,28,28
Mendocino,30,2022-07-11,190,190,190,0,1387,1393,1391,2,4,0,0,0,134,134,134,134
Merced,30,2022-07-11,759,760,759,1,4268,4286,4282,4,16,5,5,1,840,840,835,835
Modoc,30,2022-07-11,28,28,28,0,57,58,57,1,0,0,0,0,8,8,8,8
Mono,30,2022-07-11,11,11,11,0,105,106,105,1,0,0,0,0,7,7,7,7
Monterey,30,2022-07-11,1075,1080,1078,2,7791,7820,7804,16,47,4,4,3,750,750,746,746
Napa,30,2022-07-11,365,365,365,0,3655,3670,3667,3,13,1,1,1,149,149,148,148
Nevada,30,2022-07-11,221,221,221,0,1824,1831,1829,2,7,0,0,1,131,131,131,131
Orange,30,2022-07-11,9710,9749,9742,7,64029,64282,64232,50,257,20,20,30,7221,7221,7201,7201
Placer,30,2022-07-11,785,786,785,1,5938,5962,5953,9,76,2,2,8,645,645,643,643
Plumas,30,2022-07-11,71,71,71,0,282,283,282,1,0,0,0,0,13,13,13,13
Riverside,30,2022-07-11,9190,9227,9218,9,51674,51879,51825,54,225,13,13,12,6519,6519,6506,6506
Sacramento,30,2022-07-11,4176,4194,4189,5,35517,35657,35617,40,184,19,19,24,3181,3181,3162,3162
San Benito,30,2022-07-11,235,235,235,0,1654,1661,1659,2,1,0,0,0,95,95,95,95
San Bernardino,30,2022-07-11,8417,8450,8443,7,56430,56653,56606,47,188,14,14,20,7906,7906,7892,7892
San Diego,30,2022-07-11,13676,13730,13725,5,85496,85834,85804,30,332,9,9,41,5397,5397,5388,5388
San Francisco,30,2022-07-11,2943,2955,2948,7,26874,26981,26919,62,105,11,11,23,951,951,940,940
San Joaquin,30,2022-07-11,2120,2129,2126,3,19171,19246,19222,24,55,7,7,11,2282,2282,2275,2275
San Luis Obispo,30,2022-07-11,752,754,753,1,5263,5284,5279,5,22,3,3,1,504,504,501,501
San Mateo,30,2022-07-11,2724,2735,2733,2,24780,24878,24859,19,42,4,4,4,729,729,725,725
Santa Barbara,30,2022-07-11,1326,1333,1332,1,9694,9732,9722,10,46,5,5,9,710,710,705,705
Santa Clara,30,2022-07-11,7369,7399,7396,3,58959,59191,59169,22,211,12,12,38,2398,2398,2386,2386
Santa Cruz,30,2022-07-11,1026,1031,1030,1,9493,9530,9521,9,16,0,0,0,267,267,267,267
Shasta,30,2022-07-11,327,327,327,0,3559,3573,3569,4,21,2,2,6,577,577,575,575
Siskiyou,30,2022-07-11,42,42,42,0,362,363,362,1,1,1,1,1,86,86,85,85
Solano,30,2022-07-11,1582,1587,1585,2,11506,11551,11539,12,40,1,1,6,452,452,451,451
Sonoma,30,2022-07-11,1297,1303,1302,1,9936,9974,9964,10,50,0,0,7,505,505,505,505
Stanislaus,30,2022-07-11,1495,1502,1500,2,8683,8718,8704,14,103,7,7,11,1722,1722,1715,1715
Sutter,30,2022-07-11,288,288,288,0,1778,1784,1782,2,0,0,0,0,228,228,228,228
Tehama,30,2022-07-11,134,134,134,0,925,929,928,1,5,0,0,1,208,208,208,208
Trinity,30,2022-07-11,35,35,35,0,120,121,120,1,0,0,0,0,20,20,20,20
Tulare,30,2022-07-11,1382,1387,1385,2,9556,9593,9577,16,47,4,4,2,1515,1515,1511,1511
Tuolumne,30,2022-07-11,250,250,250,0,1299,1304,1302,2,6,0,0,0,193,193,193,193
Ventura,30,2022-07-11,2548,2559,2557,2,19706,19784,19770,14,89,5,5,6,1525,1525,1520,1520
Yolo,30,2022-07-11,499,499,499,0,5396,5417,5412,5,4,2,2,4,329,329,327,327
Yuba,30,2022-07-11,218,218,218,0,1404,1409,1408,1,9,0,0,1,120,120,120,120
Alameda,31,2022-07-18,4924,4945,4942,3,42615,42802,42774,28,149,9,9,25,1956,1956,1947,1947
Amador,31,2022-07-18,85,85,85,0,1346,1352,1351,1,6,0,0,1,88,88,88,88
Butte,31,2022-07-18,334,334,334,0,2792,2804,2803,1,25,1,1,3,451,451,450,450
Calaveras,31,2022-07-18,79,79,79,0,545,547,546,1,0,0,0,0,129,129,129,129
Colusa,31,2022-07-18,23,23,23,0,349,351,350,1,2,0,0,0,22,22,22,22
Contra Costa,31,2022-07-18,3047,3060,3057,3,22636,22734,22709,25,88,4,4,16,1389,1389,1385,1385
Del Norte,31,2022-07-18,167,167,167,0,705,708,707,1,7,0,0,0,53,53,53,53
El Dorado,31,2022-07-18,279,279,279,0,2632,2645,2643,2,11,1,1,1,225,225,224,224
Fresno,31,2022-07-18,3673,3688,3684,4,21162,21254,21232,22,199,9,9,15,2814,2814,2805,2805
Glenn,31,2022-07-18,34,34,34,0,263,265,264,1,0,0,0,0,42,42,42,42
Humboldt,31,2022-07-18,292,292,292,0,2023,2031,2029,2,10,0,0,4,152,152,152,152
Imperial,31,2022-07-18,1023,1028,1027,1,4439,4457,4453,4,18,2,2,3,951,951,949,949
Inyo,31,2022-07-18,30,30,30,0,331,333,332,1,0,0,0,0,57,57,57,57
Kern,31,2022-07-18,2291,2300,2298,2,16447,16519,16507,12,72,9,9,14,2379,2379,2370,2370
Kings,31,2022-07-18,705,707,706,1,4155,4174,4170,4,16,1,1,0,453,453,452,452
Lake,31,2022-07-18,132,132,132,0,990,995,994,1,3,0,0,0,142,142,142,142
Lassen,31,2022-07-18,77,77,77,0,1236,1242,1241,1,1,0,0,0,63,63,63,63
Los Angeles,31,2022-07-18,41722,41904,41893,11,351834,353371,353281,90,1162,114,114,137,32574,32574,32460,32460
Madera,31,2022-07-18,528,529,528,1,3630,3645,3641,4,5,0,0,3,368,368,368,368
Marin,31,2022-07-18,514,514,513,1,5487,5512,5506,6,12,1,1,5,306,306,305,305
Mariposa,31,2022-07-18,42,42,42,0,242,243,242,1,0,1,1,0,29,29,28,28
Mendocino,31,2022-07-18,184,184,184,0,1490,1495,1493,2,6,0,0,2,134,134,134,134
Merced,31,2022-07-18,748,751,750,1,3981,3999,3996,3,15,1,1,1,841,841,840,840
Modoc,31,2022-07-18,13,13,13,0,34,35,34,1,1,0,0,0,8,8,8,8
Mono,31,2022-07-18,10,10,10,0,86,87,86,1,1,0,0,0,7,7,7,7
Monterey,31,2022-07-18,981,986,984,2,7169,7200,7188,12,46,6,6,4,756,756,750,750
Napa,31,2022-07-18,318,318,318,0,2952,2966,2964,2,10,2,2,2,151,151,149,149
Nevada,31,2022-07-18,135,135,135,0,1328,1334,1333,1,8,0,0,3,131,131,131,131
Orange,31,2022-07-18,8764,8802,8797,5,59708,59969,59933,36,253,24,24,45,7245,7245,7221,7221
Placer,31,2022-07-18,682,682,681,1,5219,5242,5236,6,89,1,1,5,646,646,645,645
Plumas,31,2022-07-18,60,60,60,0,279,280,279,1,0,0,0,0,13,13,13,13
Riverside,31,2022-07-18,8253,8289,8282,7,47706,47913,47875,38,222,14,14,17,6533,6533,6519,6519
Sacramento,31,2022-07-18,3521,3536,3533,3,30374,30507,30481,26,180,12,12,26,3193,3193,3181,3181
San Benito,31,2022-07-18,197,197,197,0,1579,1585,1584,1,1,1,1,0,96,96,95,95
San Bernardino,31,2022-07-18,7929,7964,7959,5,52597,52826,52792,34,214,13,13,35,7919,7919,7906,7906
San Diego,31,2022-07-18,13092,13149,13145,4,79805,80154,80132,22,402,15,15,52,5412,5412,5397,5397
San Francisco,31,2022-07-18,2459,2470,2466,4,24887,24997,24953,44,111,10,10,24,961,961,951,951
San Joaquin,31,2022-07-18,2036,2045,2043,2,17857,17935,17918,17,66,2,2,11,2284,2284,2282,2282
San Luis Obispo,31,2022-07-18,559,560,560,0,4618,4638,4635,3,17,3,3,1,507,507,504,504
San Mateo,31,2022-07-18,2269,2279,2278,1,22526,22624,22610,14,33,0,0,4,729,729,729,729
Santa Barbara,31,2022-07-18,1296,1303,1302,1,9265,9305,9297,8,47,1,1,6,711,711,710,710
Santa Clara,31,2022-07-18,6176,6203,6201,2,53409,53642,53627,15,199,11,11,30,2409,2409,2398,2398
Santa Cruz,31,2022-07-18,874,878,877,1,7431,7464,7459,5,24,1,1,2,268,268,267,267
Shasta,31,2022-07-18,321,321,321,0,3212,3226,3223,3,40,2,2,3,579,579,577,577
Siskiyou,31,2022-07-18,46,46,46,0,345,346,345,1,3,1,1,0,87,87,86,86
Solano,31,2022-07-18,1228,1234,1233,1,9494,9535,9527,8,49,1,1,6,453,453,452,452
Sonoma,31,2022-07-18,1051,1057,1056,1,8734,8772,8765,7,44,0,0,5,505,505,505,505
Stanislaus,31,2022-07-18,1401,1408,1406,2,8387,8423,8412,11,109,5,5,9,1727,1727,1722,1722
Sutter,31,2022-07-18,251,251,251,0,1673,1679,1678,1,0,0,0,0,228,228,228,228
Tehama,31,2022-07-18,110,110,110,0,896,900,899,1,7,1,1,0,209,209,208,208
Trinity,31,2022-07-18,20,20,20,0,111,112,111,1,1,0,0,0,20,20,20,20
Tulare,31,2022-07-18,1183,1189,1187,2,8083,8119,8109,10,45,0,0,0,1515,1515,1515,1515
Tuolumne,31,2022-07-18,238,238,238,0,1141,1146,1145,1,7,0,0,0,193,193,193,193
Ventura,31,2022-07-18,2325,2335,2334,1,19557,19643,19632,11,92,3,3,7,1528,1528,1525,1525
Yolo,31,2022-07-18,433,433,433,0,4626,4647,4644,3,2,2,2,1,331,331,329,329
Yuba,31,2022-07-18,213,213,213,0,1291,1296,1295,1,18,0,0,0,120,120,120,120
Alameda,32,2022-07-25,4399,4419,4417,2,40254,40450,40430,20,143,12,12,19,1968,1968,1956,1956
Amador,32,2022-07-25,89,89,89,0,1204,1209,1208,1,3,0,0,1,88,88,88,88
Butte,32,2022-07-25,360,360,360,0,2944,2959,2958,1,30,1,1,2,452,452,451,451
Calaveras,32,2022-07-25,82,82,82,0,557,559,558,1,0,2,2,1,131,131,129,129
Colusa,32,2022-07-25,26,26,26,0,373,375,374,1,1,0,0,0,22,22,22,22
Contra Costa,32,2022-07-25,2817,2830,2828,2,21924,22031,22012,19,102,6,6,18,1395,1395,1389,1389
Del Norte,32,2022-07-25,66,66,66,0,534,537,536,1,6,0,0,0,53,53,53,53
El Dorado,32,2022-07-25,272,272,272,0,2484,2497,2495,2,9,1,1,0,226,226,225,225
Fresno,32,2022-07-25,3350,3365,3362,3,20428,20527,20511,16,195,6,6,29,2820,2820,2814,2814
Glenn,32,2022-07-25,32,32,32,0,271,273,272,1,0,0,0,0,42,42,42,42
Humboldt,32,2022-07-25,230,230,230,0,1923,1935,1934,1,13,2,2,4,154,154,152,152
Imperial,32,2022-07-25,872,877,876,1,4358,4379,4376,3,18,1,1,6,952,952,951,951
Inyo,32,2022-07-25,18,18,18,0,284,285,284,1,2,1,1,0,58,58,57,57
Kern,32,2022-07-25,1895,1903,1902,1,14956,15028,15019,9,82,3,3,12,2382,2382,2379,2379
Kings,32,2022-07-25,573,575,575,0,3884,3903,3900,3,15,1,1,0,454,454,453,453
Lake,32,2022-07-25,128,128,128,0,1039,1044,1043,1,5,1,1,2,143,143,142,142
Lassen,32,2022-07-25,52,52,52,0,1069,1074,1073,1,1,0,0,0,63,63,63,63
Los Angeles,32,2022-07-25,37019,37199,37192,7,333864,335491,335424,67,1152,119,119,134,32693,32693,32574,32574
Madera,32,2022-07-25,533,534,534,0,3827,3846,3843,3,11,0,0,5,368,368,368,368
Marin,32,2022-07-25,488,488,488,0,5407,5433,5429,4,26,2,2,2,308,308,306,306
Mariposa,32,2022-07-25,40,40,40,0,232,233,232,1,0,0,0,0,29,29,29,29
Mendocino,32,2022-07-25,196,196,196,0,1426,1432,1430,2,6,0,0,0,134,134,134,134
Merced,32,2022-07-25,723,726,726,0,3896,3915,3913,2,22,2,2,2,843,843,841,841
Modoc,32,2022-07-25,5,5,5,0,28,29,28,1,0,1,1,0,9,9,8,8
Mono,32,2022-07-25,15,15,15,0,84,85,84,1,0,0,0,0,7,7,7,7
Monterey,32,2022-07-25,930,935,934,1,7113,7149,7140,9,39,1,1,3,757,757,756,756
Napa,32,2022-07-25,295,295,295,0,2927,2941,2939,2,6,3,3,0,154,154,151,151
Nevada,32,2022-07-25,116,116,116,0,1315,1321,1320,1,3,1,1,0,132,132,131,131
Orange,32,2022-07-25,7983,8021,8017,4,58051,58335,58308,27,306,37,37,35,7282,7282,7245,7245
Placer,32,2022-07-25,605,607,606,1,5074,5100,5096,4,77,5,5,11,651,651,646,646
Plumas,32,2022-07-25,25,25,25,0,188,189,188,1,0,0,0,0,13,13,13,13
Riverside,32,2022-07-25,7497,7534,7529,5,45542,45764,45735,29,259,16,16,27,6549,6549,6533,6533
Sacramento,32,2022-07-25,3624,3642,3640,2,29897,30043,30023,20,207,18,18,32,3211,3211,3193,3193
San Benito,32,2022-07-25,196,196,196,0,1303,1310,1309,1,0,1,1,0,97,97,96,96
San Bernardino,32,2022-07-25,7098,7132,7128,4,51003,51252,51226,26,214,30,30,23,7949,7949,7919,7919
San Diego,32,2022-07-25,11906,11963,11960,3,76124,76494,76478,16,393,16,16,41,5428,5428,5412,5412
San Francisco,32,2022-07-25,2288,2300,2297,3,24050,24167,24133,34,126,9,9,24,970,970,961,961
San Joaquin,32,2022-07-25,1827,1836,1835,1,16377,16456,16444,12,73,5,5,9,2289,2289,2284,2284
San Luis Obispo,32,2022-07-25,537,538,538,0,4378,4399,4396,3,16,4,4,1,511,511,507,507
San Mateo,32,2022-07-25,1995,2004,2003,1,21491,21595,21585,10,57,1,1,7,730,730,729,729
Santa Barbara,32,2022-07-25,1176,1182,1181,1,8768,8810,8804,6,37,3,3,3,714,714,711,711
Santa Clara,32,2022-07-25,5763,5792,5791,1,49872,50115,50104,11,238,15,15,26,2424,2424,2409,2409
Santa Cruz,32,2022-07-25,832,838,838,0,7645,7682,7678,4,23,0,0,0,268,268,268,268
Shasta,32,2022-07-25,307,307,307,0,3081,3097,3095,2,38,2,2,6,581,581,579,579
Siskiyou,32,2022-07-25,52,52,52,0,333,334,333,1,1,0,0,0,87,87,87,87
Solano,32,2022-07-25,1186,1192,1191,1,9448,9495,9489,6,56,0,0,5,453,453,453,453
Sonoma,32,2022-07-25,1065,1071,1070,1,8645,8686,8681,5,48,1,1,4,506,506,505,505
Stanislaus,32,2022-07-25,1379,1386,1385,1,8145,8185,8177,8,104,8,8,11,1735,1735,1727,1727
Sutter,32,2022-07-25,221,221,221,0,1720,1728,1727,1,0,0,0,0,228,228,228,228
Tehama,32,2022-07-25,102,102,102,0,920,924,923,1,5,2,2,0,211,211,209,209
Trinity,32,2022-07-25,12,12,12,0,102,103,102,1,0,0,0,0,20,20,20,20
Tulare,32,2022-07-25,1119,1126,1125,1,8012,8050,8042,8,42,2,2,2,1517,1517,1515,1515
Tuolumne,32,2022-07-25,200,200,200,0,1147,1152,1151,1,5,0,0,0,193,193,193,193
Ventura,32,2022-07-25,2154,2166,2165,1,18379,18467,18459,8,76,4,4,8,1532,1532,1528,1528
Yolo,32,2022-07-25,411,411,411,0,4377,4399,4397,2,4,2,2,1,333,333,331,331
Yuba,32,2022-07-25,174,174,174,0,1281,1286,1285,1,15,0,0,0,120,120,120,120
Alameda,33,2022-08-01,3817,3838,3837,1,36993,37188,37173,15,176,7,7,21,1975,1975,1968,1968
Amador,33,2022-08-01,53,53,53,0,1129,1135,1134,1,3,1,1,0,89,89,88,88
Butte,33,2022-08-01,368,368,368,0,2845,2860,2859,1,33,1,1,3,453,453,452,452
Calaveras,33,2022-08-01,68,68,68,0,573,576,575,1,2,1,1,2,132,132,131,131
Colusa,33,2022-08-01,26,26,26,0,362,364,363,1,7,0,0,0,22,22,22,22
Contra Costa,33,2022-08-01,2607,2620,2618,2,20967,21077,21063,14,86,13,13,15,1408,1408,1395,1395
Del Norte,33,2022-08-01,52,52,52,0,475,478,477,1,4,0,0,2,53,53,53,53
El Dorado,33,2022-08-01,234,234,234,0,2451,2464,2463,1,4,3,3,2,229,229,226,226
Fresno,33,2022-08-01,2973,2988,2986,2,18358,18455,18444,11,231,9,9,16,2829,2829,2820,2820
Glenn,33,2022-08-01,28,28,28,0,251,253,252,1,0,0,0,0,42,42,42,42
Humboldt,33,2022-08-01,222,222,222,0,1881,1891,1890,1,12,0,0,3,154,154,154,154
Imperial,33,2022-08-01,635,639,639,0,3540,3560,3558,2,22,5,5,3,957,957,952,952
Inyo,33,2022-08-01,20,20,20,0,280,281,280,1,2,0,0,0,58,58,58,58
Kern,33,2022-08-01,1682,1691,1690,1,14794,14873,14866,7,81,6,6,17,2388,2388,2382,2382
Kings,33,2022-08-01,624,628,628,0,4040,4061,4059,2,6,0,0,1,454,454,454,454
Lake,33,2022-08-01,125,125,125,0,994,999,998,1,7,0,0,2,143,143,143,143
Lassen,33,2022-08-01,102,102,102,0,946,951,950,1,0,0,0,0,63,63,63,63
Los Angeles,33,2022-08-01,30514,30675,30670,5,308594,310220,310172,48,1105,130,132,137,32823,32825,32693,32693
Madera,33,2022-08-01,463,463,463,0,3482,3499,3497,2,10,0,0,7,368,368,368,368
Marin,33,2022-08-01,411,411,411,0,5124,5150,5147,3,32,0,0,4,308,308,308,308
Mariposa,33,2022-08-01,22,22,22,0,226,227,226,1,0,0,0,0,29,29,29,29
Mendocino,33,2022-08-01,174,174,174,0,1257,1264,1263,1,6,1,1,1,135,135,134,134
Merced,33,2022-08-01,637,640,640,0,3551,3570,3568,2,22,6,6,2,849,849,843,843
Modoc,33,2022-08-01,16,16,16,0,31,32,31,1,0,0,0,0,9,9,9,9
Mono,33,2022-08-01,8,8,8,0,67,68,67,1,0,0,0,0,7,7,7,7
Monterey,33,2022-08-01,923,928,927,1,6384,6418,6412,6,33,2,2,1,759,759,757,757
Napa,33,2022-08-01,282,282,282,0,2832,2847,2846,1,8,0,0,2,154,154,154,154
Nevada,33,2022-08-01,123,123,123,0,1404,1411,1410,1,12,0,0,0,132,132,132,132
Orange,33,2022-08-01,6458,6492,6490,2,52327,52602,52583,19,246,32,32,49,7314,7314,7282,7282
Placer,33,2022-08-01,586,588,588,0,4733,4758,4755,3,71,1,1,11,652,652,651,651
Plumas,33,2022-08-01,24,24,24,0,162,163,162,1,0,0,0,0,13,13,13,13
Riverside,33,2022-08-01,6118,6150,6147,3,41849,42070,42049,21,200,5,5,23,6554,6554,6549,6549
Sacramento,33,2022-08-01,3097,3113,3111,2,27833,27979,27964,15,179,18,18,26,3229,3229,3211,3211
San Benito,33,2022-08-01,165,165,165,0,704,710,709,1,2,1,1,0,98,98,97,97
San Bernardino,33,2022-08-01,6041,6073,6071,2,47577,47828,47809,19,184,26,26,23,7975,7975,7949,7949
San Diego,33,2022-08-01,9380,9430,9428,2,68592,68953,68942,11,396,12,12,46,5440,5440,5428,5428
San Francisco,33,2022-08-01,1801,1810,1808,2,21826,21941,21917,24,105,13,13,20,983,983,970,970
San Joaquin,33,2022-08-01,1719,1728,1727,1,15924,16008,15999,9,69,6,6,11,2295,2295,2289,2289
San Luis Obispo,33,2022-08-01,574,576,576,0,4138,4159,4157,2,14,3,3,0,514,514,511,511
San Mateo,33,2022-08-01,1760,1768,1767,1,20168,20274,20267,7,67,0,0,3,730,730,730,730
Santa Barbara,33,2022-08-01,1105,1111,1110,1,7780,7820,7816,4,40,1,1,3,715,715,714,714
Santa Clara,33,2022-08-01,4808,4834,4833,1,44314,44546,44538,8,230,19,19,36,2443,2443,2424,2424
Santa Cruz,33,2022-08-01,747,751,751,0,6857,6893,6890,3,20,1,1,3,269,269,268,268
Shasta,33,2022-08-01,241,241,241,0,2970,2986,2984,2,34,0,0,7,581,581,581,581
Siskiyou,33,2022-08-01,47,47,47,0,298,299,298,1,2,0,0,0,87,87,87,87
Solano,33,2022-08-01,1134,1140,1139,1,9110,9158,9153,5,53,0,0,4,453,453,453,453
Sonoma,33,2022-08-01,917,923,923,0,8182,8225,8221,4,46,3,3,3,509,509,506,506
Stanislaus,33,2022-08-01,1232,1239,1238,1,7710,7750,7744,6,115,7,7,8,1742,1742,1735,1735
Sutter,33,2022-08-01,232,232,232,0,1633,1642,1641,1,0,3,3,0,231,231,228,228
Tehama,33,2022-08-01,89,89,89,0,759,763,762,1,4,0,0,0,211,211,211,211
Trinity,33,2022-08-01,11,11,11,0,71,72,71,1,0,0,0,0,20,20,20,20
Tulare,33,2022-08-01,1031,1037,1036,1,7462,7502,7496,6,46,1,1,3,1518,1518,1517,1517
Tuolumne,33,2022-08-01,143,143,143,0,1110,1115,1114,1,4,0,0,1,193,193,193,193
Ventura,33,2022-08-01,1801,1811,1810,1,16962,17051,17045,6,75,10,10,10,1542,1542,1532,1532
Yolo,33,2022-08-01,329,329,329,0,4161,4182,4180,2,3,2,2,1,335,335,333,333
Yuba,33,2022-08-01,159,159,159,0,1218,1223,1222,1,10,0,0,3,120,120,120,120
Alameda,34,2022-08-08,3279,3300,3299,1,35019,35232,35221,11,133,13,13,20,1988,1988,1975,1975
Amador,34,2022-08-08,50,50,50,0,850,856,855,1,3,0,0,1,89,89,89,89
Butte,34,2022-08-08,331,331,331,0,2510,2526,2525,1,33,1,1,1,454,454,453,453
Calaveras,34,2022-08-08,57,57,57,0,559,562,561,1,1,1,1,0,133,133,132,132
Colusa,34,2022-08-08,15,15,15,0,362,365,364,1,0,0,0,0,22,22,22,22
Contra Costa,34,2022-08-08,2167,2181,2180,1,19763,19883,19873,10,102,4,4,14,1412,1412,1408,1408
Del Norte,34,2022-08-08,49,49,49,0,498,502,501,1,4,1,1,1,54,54,53,53
El Dorado,34,2022-08-08,195,195,195,0,2315,2330,2329,1,4,0,0,2,229,229,229,229
Fresno,34,2022-08-08,2392,2406,2405,1,17811,17920,17911,9,207,8,8,25,2837,2837,2829,2829
Glenn,34,2022-08-08,21,21,21,0,251,253,252,1,0,0,0,0,42,42,42,42
Humboldt,34,2022-08-08,201,201,201,0,1934,1946,1945,1,12,1,1,2,155,155,154,154
Imperial,34,2022-08-08,548,550,550,0,3273,3292,3291,1,16,2,2,2,959,959,957,957
Inyo,34,2022-08-08,8,8,8,0,277,279,278,1,1,0,0,1,58,58,58,58
Kern,34,2022-08-08,1306,1314,1314,0,13629,13712,13707,5,61,6,6,16,2394,2394,2388,2388
Kings,34,2022-08-08,466,468,468,0,3321,3341,3340,1,20,0,0,2,454,454,454,454
Lake,34,2022-08-08,101,101,101,0,898,904,903,1,4,0,0,1,143,143,143,143
Lassen,34,2022-08-08,132,132,132,0,1022,1029,1028,1,1,0,0,0,63,63,63,63
Los Angeles,34,2022-08-08,25644,25800,25797,3,290553,292313,292278,35,1030,125,129,121,32948,32954,32823,32825
Madera,34,2022-08-08,377,377,377,0,3189,3208,3206,2,16,0,0,3,368,368,368,368
Marin,34,2022-08-08,354,354,354,0,4488,4516,4514,2,26,2,2,2,310,310,308,308
Mariposa,34,2022-08-08,25,25,25,0,206,207,206,1,0,0,0,0,29,29,29,29
Mendocino,34,2022-08-08,129,129,129,0,1136,1141,1140,1,3,1,1,1,136,136,135,135
Merced,34,2022-08-08,522,524,524,0,3388,3408,3407,1,17,1,1,5,850,850,849,849
Modoc,34,2022-08-08,2,2,2,0,22,23,22,1,0,0,0,0,9,9,9,9
Mono,34,2022-08-08,9,9,9,0,90,91,90,1,0,0,0,0,7,7,7,7
Monterey,34,2022-08-08,732,737,736,1,5748,5782,5778,4,28,1,1,0,760,760,759,759
Napa,34,2022-08-08,251,251,251,0,2609,2626,2625,1,10,2,2,3,156,156,154,154
Nevada,34,2022-08-08,91,91,91,0,1300,1307,1306,1,4,0,0,0,132,132,132,132
Orange,34,2022-08-08,5252,5284,5283,1,47944,48233,48219,14,242,26,26,40,7340,7340,7314,7314
Placer,34,2022-08-08,504,505,505,0,4509,4536,4534,2,65,3,3,9,655,655,652,652
Plumas,34,2022-08-08,23,23,23,0,190,191,190,1,1,0,0,0,13,13,13,13
Riverside,34,2022-08-08,5493,5526,5524,2,40120,40363,40348,15,174,10,10,13,6564,6564,6554,6554
Sacramento,34,2022-08-08,2602,2618,2617,1,26846,27009,26998,11,156,16,16,20,3245,3245,3229,3229
San Benito,34,2022-08-08,171,171,171,0,716,723,722,1,1,0,0,0,98,98,98,98
San Bernardino,34,2022-08-08,4994,5024,5022,2,44578,44847,44833,14,204,20,20,15,7995,7995,7975,7975
San Diego,34,2022-08-08,7277,7321,7320,1,62851,63231,63223,8,337,9,9,30,5449,5449,5440,5440
San Francisco,34,2022-08-08,1472,1480,1479,1,20242,20365,20348,17,94,11,11,21,994,994,983,983
San Joaquin,34,2022-08-08,1509,1518,1517,1,15511,15605,15598,7,55,6,6,12,2301,2301,2295,2295
San Luis Obispo,34,2022-08-08,496,498,498,0,3629,3649,3648,1,14,0,0,2,514,514,514,514
San Mateo,34,2022-08-08,1499,1508,1508,0,18187,18297,18292,5,60,0,0,5,730,730,730,730
Santa Barbara,34,2022-08-08,953,959,959,0,7539,7584,7581,3,46,3,3,4,718,718,715,715
Santa Clara,34,2022-08-08,4136,4162,4161,1,39745,39985,39980,5,203,14,14,40,2457,2457,2443,2443
Santa Cruz,34,2022-08-08,616,621,621,0,6055,6093,6091,2,28,1,1,0,270,270,269,269
Shasta,34,2022-08-08,189,189,189,0,2839,2858,2857,1,33,1,1,3,582,582,581,581
Siskiyou,34,2022-08-08,50,50,50,0,291,292,291,1,0,1,1,0,88,88,87,87
Solano,34,2022-08-08,872,877,877,0,7944,7992,7989,3,54,0,0,9,453,453,453,453
Sonoma,34,2022-08-08,828,833,833,0,7741,7787,7784,3,34,3,3,3,512,512,509,509
Stanislaus,34,2022-08-08,1029,1036,1035,1,7167,7211,7207,4,90,7,7,11,1749,1749,1742,1742
Sutter,34,2022-08-08,223,223,223,0,1558,1569,1568,1,0,0,0,0,231,231,231,231
Tehama,34,2022-08-08,75,75,75,0,686,691,690,1,0,0,0,1,211,211,211,211
Trinity,34,2022-08-08,5,5,5,0,71,72,71,1,0,0,0,0,20,20,20,20
Tulare,34,2022-08-08,875,882,881,1,7345,7391,7387,4,46,4,4,3,1522,1522,1518,1518
Tuolumne,34,2022-08-08,117,117,117,0,1061,1067,1066,1,4,0,0,0,193,193,193,193
Ventura,34,2022-08-08,1485,1493,1493,0,15971,16068,16064,4,67,5,5,7,1547,1547,1542,1542
Yolo,34,2022-08-08,281,281,281,0,3868,3892,3891,1,4,0,0,3,335,335,335,335
Yuba,34,2022-08-08,135,135,135,0,1087,1094,1093,1,6,0,0,0,120,120,120,120
Alameda,35,2022-08-15,2555,2573,2572,1,33473,33712,33704,8,105,9,9,22,1997,1997,1988,1988
Amador,35,2022-08-15,47,47,47,0,847,855,854,1,2,0,0,0,89,89,89,89
Butte,35,2022-08-15,256,256,256,0,2262,2279,2278,1,19,0,0,2,454,454,454,454
Calaveras,35,2022-08-15,45,45,45,0,528,533,532,1,0,0,0,0,133,133,133,133
Colusa,35,2022-08-15,16,16,16,0,359,362,361,1,1,0,0,0,22,22,22,22
Contra Costa,35,2022-08-15,1754,1767,1766,1,18944,19080,19072,8,72,6,6,9,1418,1418,1412,1412
Del Norte,35,2022-08-15,49,49,49,0,503,507,506,1,2,0,0,1,54,54,54,54
El Dorado,35,2022-08-15,177,177,177,0,2302,2318,2317,1,5,0,0,3,229,229,229,229
Fresno,35,2022-08-15,1855,1868,1867,1,16181,16297,16291,6,170,6,6,17,2843,2843,2837,2837
Glenn,35,2022-08-15,16,16,16,0,225,227,226,1,3,0,0,0,42,42,42,42
Humboldt,35,2022-08-15,174,174,174,0,1607,1620,1619,1,16,0,0,2,155,155,155,155
Imperial,35,2022-08-15,362,362,362,0,3105,3126,3125,1,11,0,0,2,959,959,959,959
Inyo,35,2022-08-15,13,13,13,0,238,241,240,1,2,1,1,0,59,59,58,58
Kern,35,2022-08-15,1176,1184,1184,0,13463,13559,13555,4,59,7,7,16,2401,2401,2394,2394
Kings,35,2022-08-15,332,332,332,0,3220,3243,3242,1,9,0,0,1,454,454,454,454
Lake,35,2022-08-15,103,103,103,0,1031,1038,1037,1,3,1,1,2,144,144,143,143
Lassen,35,2022-08-15,59,59,59,0,896,904,903,1,0,0,0,0,63,63,63,63
Los Angeles,35,2022-08-15,20821,20969,20967,2,286911,288956,288929,27,905,110,116,117,33058,33070,32948,32954
Madera,35,2022-08-15,301,301,301,0,2966,2987,2986,1,12,0,0,3,368,368,368,368
Marin,35,2022-08-15,290,290,290,0,4100,4129,4127,2,15,0,0,0,310,310,310,310
Mariposa,35,2022-08-15,11,11,11,0,202,203,202,1,0,0,0,0,29,29,29,29
Mendocino,35,2022-08-15,99,99,99,0,1014,1020,1019,1,7,0,0,3,136,136,136,136
Merced,35,2022-08-15,436,438,438,0,3436,3460,3459,1,12,2,2,1,852,852,850,850
Modoc,35,2022-08-15,4,4,4,0,23,24,23,1,0,0,0,0,9,9,9,9
Mono,35,2022-08-15,4,4,4,0,62,63,62,1,0,0,0,0,7,7,7,7
Monterey,35,2022-08-15,659,664,664,0,5804,5846,5842,4,30,0,0,1,760,760,760,760
Napa,35,2022-08-15,210,210,210,0,2276,2292,2291,1,13,0,0,0,156,156,156,156
Nevada,35,2022-08-15,94,94,94,0,1218,1227,1226,1,7,0,0,0,132,132,132,132
Orange,35,2022-08-15,4544,4578,4577,1,42898,43204,43194,10,270,31,31,44,7371,7371,7340,7340
Placer,35,2022-08-15,403,403,403,0,4465,4497,4495,2,61,1,1,11,656,656,655,655
Plumas,35,2022-08-15,17,17,17,0,184,185,184,1,0,0,0,0,13,13,13,13
Riverside,35,2022-08-15,4557,4588,4587,1,37613,37881,37870,11,143,11,11,22,6575,6575,6564,6564
Sacramento,35,2022-08-15,2349,2366,2365,1,25365,25546,25538,8,149,11,11,22,3256,3256,3245,3245
San Benito,35,2022-08-15,132,132,132,0,651,657,656,1,3,1,1,1,99,99,98,98
San Bernardino,35,2022-08-15,4650,4684,4683,1,42916,43224,43214,10,144,13,13,22,8008,8008,7995,7995
San Diego,35,2022-08-15,5483,5522,5521,1,59340,59763,59757,6,288,13,13,34,5462,5462,5449,5449
San Francisco,35,2022-08-15,1231,1240,1239,1,19024,19160,19147,13,103,14,14,11,1008,1008,994,994
San Joaquin,35,2022-08-15,1438,1448,1447,1,15035,15141,15136,5,64,8,8,8,2309,2309,2301,2301
San Luis Obispo,35,2022-08-15,319,319,319,0,3327,3352,3351,1,15,4,4,3,518,518,514,514
San Mateo,35,2022-08-15,1199,1207,1207,0,16949,17070,17066,4,56,0,0,5,730,730,730,730
Santa Barbara,35,2022-08-15,822,829,829,0,7151,7202,7200,2,44,1,1,4,719,719,718,718
Santa Clara,35,2022-08-15,3320,3344,3344,0,38640,38917,38913,4,200,7,7,24,2464,2464,2457,2457
Santa Cruz,35,2022-08-15,491,495,495,0,7543,7598,7596,2,23,3,3,1,273,273,270,270
Shasta,35,2022-08-15,188,188,188,0,2795,2816,2815,1,19,1,1,1,583,583,582,582
Siskiyou,35,2022-08-15,27,27,27,0,284,285,284,1,3,0,0,1,88,88,88,88
Solano,35,2022-08-15,654,659,659,0,7438,7492,7490,2,45,0,0,10,453,453,453,453
Sonoma,35,2022-08-15,619,624,624,0,7305,7357,7355,2,39,2,2,2,514,514,512,512
Stanislaus,35,2022-08-15,930,937,937,0,7646,7701,7697,4,99,9,9,11,1758,1758,1749,1749
Sutter,35,2022-08-15,195,195,195,0,1598,1611,1610,1,0,1,1,0,232,232,231,231
Tehama,35,2022-08-15,59,59,59,0,653,658,657,1,1,0,0,0,211,211,211,211
Trinity,35,2022-08-15,8,8,8,0,58,59,58,1,0,0,0,0,20,20,20,20
Tulare,35,2022-08-15,714,720,720,0,7356,7410,7407,3,32,3,3,1,1525,1525,1522,1522
Tuolumne,35,2022-08-15,108,108,108,0,1001,1008,1007,1,1,0,0,0,193,193,193,193
Ventura,35,2022-08-15,1477,1488,1488,0,15309,15419,15416,3,70,5,5,7,1552,1552,1547,1547
Yolo,35,2022-08-15,260,260,260,0,3531,3556,3555,1,2,1,1,1,336,336,335,335
Yuba,35,2022-08-15,128,128,128,0,1084,1092,1091,1,9,0,0,0,120,120,120,120
Alameda,36,2022-08-22,2228,2247,2247,0,32826,33099,33093,6,117,7,7,21,2004,2004,1997,1997
Amador,36,2022-08-22,49,49,49,0,811,820,819,1,2,1,1,0,90,90,89,89
Butte,36,2022-08-22,216,216,216,0,2146,2164,2163,1,17,1,1,2,455,455,454,454
Calaveras,36,2022-08-22,43,43,43,0,573,579,578,1,1,0,0,0,133,133,133,133
Colusa,36,2022-08-22,16,16,16,0,394,398,397,1,0,0,0,0,22,22,22,22
Contra Costa,36,2022-08-22,1512,1525,1525,0,18805,18961,18955,6,56,5,5,9,1423,1423,1418,1418
Del Norte,36,2022-08-22,31,31,31,0,465,471,470,1,3,1,1,0,55,55,54,54
El Dorado,36,2022-08-22,146,146,146,0,2223,2242,2241,1,4,1,1,0,230,230,229,229
Fresno,36,2022-08-22,1573,1585,1585,0,15829,15961,15956,5,162,5,5,14,2848,2848,2843,2843
Glenn,36,2022-08-22,23,23,23,0,227,229,228,1,1,0,0,0,42,42,42,42
Humboldt,36,2022-08-22,147,147,147,0,1695,1711,1710,1,6,1,1,3,156,156,155,155
Imperial,36,2022-08-22,285,286,286,0,2858,2882,2881,1,15,0,0,0,959,959,959,959
Inyo,36,2022-08-22,8,8,8,0,215,216,215,1,0,0,0,0,59,59,59,59
Kern,36,2022-08-22,961,969,969,0,13724,13838,13835,3,69,6,6,10,2407,2407,2401,2401
Kings,36,2022-08-22,370,373,373,0,3619,3650,3649,1,10,1,1,0,455,455,454,454
Lake,36,2022-08-22,98,98,98,0,891,899,898,1,5,0,0,0,144,144,144,144
Lassen,36,2022-08-22,36,36,36,0,831,840,839,1,0,0,0,0,63,63,63,63
Los Angeles,36,2022-08-22,18388,18541,18540,1,273739,276014,275994,20,811,112,119,104,33170,33189,33058,33070
Madera,36,2022-08-22,292,292,292,0,2620,2642,2641,1,14,2,2,4,370,370,368,368
Marin,36,2022-08-22,248,248,248,0,3956,3989,3988,1,17,0,0,3,310,310,310,310
Mariposa,36,2022-08-22,12,12,12,0,177,178,177,1,0,0,0,0,29,29,29,29
Mendocino,36,2022-08-22,116,116,116,0,1157,1169,1168,1,3,0,0,2,136,136,136,136
Merced,36,2022-08-22,432,436,436,0,3645,3677,3676,1,12,4,4,1,856,856,852,852
Modoc,36,2022-08-22,6,6,6,0,26,27,26,1,0,0,0,0,9,9,9,9
Mono,36,2022-08-22,4,4,4,0,66,67,66,1,0,0,0,0,7,7,7,7
Monterey,36,2022-08-22,541,546,546,0,5915,5965,5962,3,27,1,1,2,761,761,760,760
Napa,36,2022-08-22,126,126,126,0,1992,2010,2009,1,5,1,1,1,157,157,156,156
Nevada,36,2022-08-22,80,80,80,0,1188,1200,1199,1,6,0,0,0,132,132,132,132
Orange,36,2022-08-22,3769,3801,3800,1,40637,40974,40967,7,224,20,20,35,7391,7391,7371,7371
Placer,36,2022-08-22,372,374,374,0,4287,4323,4322,1,61,1,1,14,657,657,656,656
Plumas,36,2022-08-22,20,20,20,0,175,176,175,1,1,0,0,0,13,13,13,13
Riverside,36,2022-08-22,4370,4406,4405,1,37074,37381,37372,9,142,12,12,19,6587,6587,6575,6575
Sacramento,36,2022-08-22,2071,2088,2087,1,24734,24940,24934,6,144,14,14,25,3270,3270,3256,3256
San Benito,36,2022-08-22,102,102,102,0,596,603,602,1,1,1,1,1,100,100,99,99
San Bernardino,36,2022-08-22,4561,4600,4599,1,43074,43432,43424,8,160,18,18,22,8026,8026,8008,8008
San Diego,36,2022-08-22,4787,4827,4827,0,57400,57877,57873,4,287,5,5,28,5467,5467,5462,5462
San Francisco,36,2022-08-22,1071,1079,1078,1,18211,18362,18353,9,81,16,16,12,1024,1024,1008,1008
San Joaquin,36,2022-08-22,1183,1193,1193,0,15398,15526,15522,4,56,1,1,8,2310,2310,2309,2309
San Luis Obispo,36,2022-08-22,251,251,251,0,3104,3130,3129,1,16,1,1,0,519,519,518,518
San Mateo,36,2022-08-22,1004,1012,1012,0,16739,16877,16874,3,42,0,0,2,730,730,730,730
Santa Barbara,36,2022-08-22,719,726,726,0,7454,7517,7515,2,37,1,1,2,720,720,719,719
Santa Clara,36,2022-08-22,2994,3020,3020,0,39062,39387,39384,3,173,9,9,27,2473,2473,2464,2464
Santa Cruz,36,2022-08-22,499,504,504,0,11972,12073,12071,2,13,0,0,0,273,273,273,273
Shasta,36,2022-08-22,170,170,170,0,2760,2783,2782,1,10,2,2,2,585,585,583,583
Siskiyou,36,2022-08-22,25,25,25,0,249,250,249,1,4,1,1,2,89,89,88,88
Solano,36,2022-08-22,520,525,525,0,7176,7237,7235,2,35,0,0,12,453,453,453,453
Sonoma,36,2022-08-22,596,602,602,0,7385,7446,7444,2,42,2,2,1,516,516,514,514
Stanislaus,36,2022-08-22,884,891,891,0,7637,7699,7696,3,79,7,7,16,1765,1765,1758,1758
Sutter,36,2022-08-22,189,189,189,0,1658,1673,1672,1,0,0,0,0,232,232,232,232
Tehama,36,2022-08-22,51,51,51,0,635,642,641,1,1,0,0,0,211,211,211,211
Trinity,36,2022-08-22,10,10,10,0,63,64,63,1,0,0,0,0,20,20,20,20
Tulare,36,2022-08-22,711,718,718,0,6797,6852,6849,3,33,3,3,1,1528,1528,1525,1525
Tuolumne,36,2022-08-22,103,103,103,0,1026,1035,1034,1,0,0,0,0,193,193,193,193
Ventura,36,2022-08-22,1290,1300,1300,0,15035,15160,15158,2,59,3,3,9,1555,1555,1552,1552
Yolo,36,2022-08-22,200,200,200,0,3465,3494,3493,1,10,1,1,1,337,337,336,336
Yuba,36,2022-08-22,127,127,127,0,1108,1119,1118,1,13,0,0,3,120,120,120,120
Alameda,37,2022-08-29,1961,1980,1980,0,33847,34176,34171,5,99,11,11,20,2015,2015,2004,2004
Amador,37,2022-08-29,46,46,46,0,799,808,807,1,2,1,1,0,91,91,90,90
Butte,37,2022-08-29,235,236,236,0,2187,2210,2209,1,18,0,0,3,455,455,455,455
Calaveras,37,2022-08-29,59,59,59,0,591,597,596,1,1,0,0,0,133,133,133,133
Colusa,37,2022-08-29,10,10,10,0,328,331,330,1,3,0,0,0,22,22,22,22
Contra Costa,37,2022-08-29,1328,1341,1341,0,18757,18940,18935,5,44,4,4,7,1427,1427,1423,1423
Del Norte,37,2022-08-29,27,27,27,0,437,443,442,1,5,0,0,1,55,55,55,55
El Dorado,37,2022-08-29,143,143,143,0,1949,1969,1968,1,1,0,0,1,230,230,230,230
Fresno,37,2022-08-29,1398,1412,1412,0,15783,15936,15932,4,159,3,3,15,2851,2851,2848,2848
Glenn,37,2022-08-29,23,23,23,0,220,222,221,1,1,0,0,0,42,42,42,42
Humboldt,37,2022-08-29,122,122,122,0,1676,1693,1692,1,4,0,0,0,156,156,156,156
Imperial,37,2022-08-29,291,293,293,0,2932,2960,2959,1,14,1,1,2,960,960,959,959
Inyo,37,2022-08-29,7,7,7,0,178,179,178,1,0,0,0,0,59,59,59,59
Kern,37,2022-08-29,805,812,812,0,13203,13330,13328,2,50,0,0,8,2407,2407,2407,2407
Kings,37,2022-08-29,313,316,316,0,3468,3501,3500,1,8,0,0,0,455,455,455,455
Lake,37,2022-08-29,86,86,86,0,876,885,884,1,1,1,1,0,145,145,144,144
Lassen,37,2022-08-29,27,27,27,0,769,777,776,1,0,0,0,0,63,63,63,63
Los Angeles,37,2022-08-29,15455,15607,15606,1,270295,272924,272908,16,753,85,92,83,33255,33281,33170,33189
Madera,37,2022-08-29,293,294,294,0,3029,3059,3058,1,13,0,0,3,370,370,370,370
Marin,37,2022-08-29,211,211,211,0,3837,3874,3873,1,16,2,2,2,312,312,310,310
Mariposa,37,2022-08-29,23,23,23,0,194,195,194,1,0,0,0,0,29,29,29,29
Mendocino,37,2022-08-29,86,86,86,0,979,990,989,1,2,0,0,1,136,136,136,136
Merced,37,2022-08-29,373,376,376,0,3406,3439,3438,1,11,3,3,0,859,859,856,856
Modoc,37,2022-08-29,1,1,1,0,30,31,30,1,0,0,0,0,9,9,9,9
Mono,37,2022-08-29,2,2,2,0,45,46,45,1,0,0,0,0,7,7,7,7
Monterey,37,2022-08-29,392,396,396,0,5346,5397,5395,2,33,2,2,5,763,763,761,761
Napa,37,2022-08-29,127,127,127,0,2154,2176,2175,1,10,0,0,1,157,157,157,157
Nevada,37,2022-08-29,115,115,115,0,1206,1221,1220,1,6,0,0,0,132,132,132,132
Orange,37,2022-08-29,2916,2945,2945,0,38867,39244,39239,5,195,17,17,25,7408,7408,7391,7391
Placer,37,2022-08-29,366,369,369,0,4198,4239,4238,1,55,1,1,12,658,658,657,657
Plumas,37,2022-08-29,18,18,18,0,159,160,159,1,1,0,0,0,13,13,13,13
Riverside,37,2022-08-29,3638,3674,3673,1,36383,36738,36731,7,124,9,9,11,6596,6596,6587,6587
Sacramento,37,2022-08-29,1841,1859,1859,0,24505,24743,24738,5,137,9,9,20,3279,3279,3270,3270
San Benito,37,2022-08-29,117,117,117,0,661,668,667,1,1,0,0,0,100,100,100,100
San Bernardino,37,2022-08-29,3592,3627,3626,1,40787,41185,41179,6,156,14,14,18,8040,8040,8026,8026
San Diego,37,2022-08-29,3929,3967,3967,0,56529,57080,57077,3,222,12,12,25,5479,5479,5467,5467
San Francisco,37,2022-08-29,857,865,865,0,18607,18788,18781,7,57,7,7,12,1031,1031,1024,1024
San Joaquin,37,2022-08-29,987,996,996,0,13958,14095,14092,3,27,5,5,11,2315,2315,2310,2310
San Luis Obispo,37,2022-08-29,314,315,315,0,3238,3271,3270,1,17,3,3,0,522,522,519,519
San Mateo,37,2022-08-29,836,844,844,0,16324,16483,16481,2,26,0,0,5,730,730,730,730
Santa Barbara,37,2022-08-29,630,637,637,0,7647,7721,7720,1,24,1,1,3,721,721,720,720
Santa Clara,37,2022-08-29,2289,2310,2310,0,38358,38731,38729,2,135,4,4,24,2477,2477,2473,2473
Santa Cruz,37,2022-08-29,383,386,386,0,12672,12795,12793,2,16,0,0,1,273,273,273,273
Shasta,37,2022-08-29,122,122,122,0,2583,2609,2608,1,19,1,1,1,586,586,585,585
Siskiyou,37,2022-08-29,24,24,24,0,249,252,251,1,0,1,1,0,90,90,89,89
Solano,37,2022-08-29,539,545,545,0,7248,7318,7317,1,33,1,1,8,454,454,453,453
Sonoma,37,2022-08-29,481,486,486,0,7115,7183,7182,1,37,1,1,4,517,517,516,516
Stanislaus,37,2022-08-29,838,846,846,0,8068,8147,8145,2,79,6,6,6,1771,1771,1765,1765
Sutter,37,2022-08-29,169,169,169,0,1634,1651,1650,1,0,0,0,0,232,232,232,232
Tehama,37,2022-08-29,65,65,65,0,743,750,749,1,4,0,0,1,211,211,211,211
Trinity,37,2022-08-29,7,7,7,0,56,57,56,1,0,0,0,0,20,20,20,20
Tulare,37,2022-08-29,665,672,672,0,7391,7464,7462,2,42,0,0,1,1528,1528,1528,1528
Tuolumne,37,2022-08-29,90,90,90,0,864,875,874,1,1,0,0,0,193,193,193,193
Ventura,37,2022-08-29,1007,1017,1017,0,14628,14770,14768,2,71,4,4,7,1559,1559,1555,1555
Yolo,37,2022-08-29,200,200,200,0,3611,3645,3644,1,5,0,0,3,337,337,337,337
Yuba,37,2022-08-29,136,136,136,0,1174,1187,1186,1,14,0,0,1,120,120,120,120
Alameda,38,2022-09-05,1425,1441,1441,0,27837,28145,28142,3,89,4,4,16,2019,2019,2015,2015
Amador,38,2022-09-05,44,44,44,0,744,754,753,1,3,0,0,2,91,91,91,91
Butte,38,2022-09-05,192,192,192,0,2129,2153,2152,1,14,2,2,2,457,457,455,455
Calaveras,38,2022-09-05,21,21,21,0,451,458,457,1,0,0,0,0,133,133,133,133
Colusa,38,2022-09-05,7,7,7,0,196,199,198,1,2,0,0,0,22,22,22,22
Contra Costa,38,2022-09-05,943,954,954,0,15397,15567,15564,3,62,5,5,9,1432,1432,1427,1427
Del Norte,38,2022-09-05,7,7,7,0,339,343,342,1,1,0,0,1,55,55,55,55
El Dorado,38,2022-09-05,85,85,85,0,1524,1543,1542,1,3,0,0,3,230,230,230,230
Fresno,38,2022-09-05,1085,1096,1096,0,13066,13211,13209,2,162,10,10,16,2861,2861,2851,2851
Glenn,38,2022-09-05,11,11,11,0,188,190,189,1,1,0,0,0,42,42,42,42
Humboldt,38,2022-09-05,108,108,108,0,1307,1322,1321,1,9,1,1,2,157,157,156,156
Imperial,38,2022-09-05,232,234,234,0,2517,2546,2545,1,8,0,0,2,960,960,960,960
Inyo,38,2022-09-05,12,12,12,0,139,140,139,1,0,0,0,1,59,59,59,59
Kern,38,2022-09-05,709,717,717,0,11208,11332,11330,2,50,4,4,8,2411,2411,2407,2407
Kings,38,2022-09-05,229,231,231,0,2852,2885,2884,1,8,0,0,0,455,455,455,455
Lake,38,2022-09-05,63,63,63,0,649,657,656,1,1,2,2,1,147,147,145,145
Lassen,38,2022-09-05,19,19,19,0,631,638,637,1,0,0,0,0,63,63,63,63
Los Angeles,38,2022-09-05,10608,10727,10727,0,221031,223475,223465,10,695,96,103,91,33351,33384,33255,33281
Madera,38,2022-09-05,204,205,205,0,2511,2539,2538,1,12,0,0,4,370,370,370,370
Marin,38,2022-09-05,187,187,187,0,3543,3583,3582,1,12,0,0,1,312,312,312,312
Mariposa,38,2022-09-05,11,11,11,0,177,178,177,1,0,0,0,0,29,29,29,29
Mendocino,38,2022-09-05,54,54,54,0,840,851,850,1,2,1,1,1,137,137,136,136
Merced,38,2022-09-05,245,247,247,0,2597,2627,2626,1,12,2,2,1,861,861,859,859
Modoc,38,2022-09-05,3,3,3,0,17,18,17,1,0,0,0,0,9,9,9,9
Mono,38,2022-09-05,4,4,4,0,52,53,52,1,1,0,0,0,7,7,7,7
Monterey,38,2022-09-05,238,239,239,0,4343,4390,4389,1,24,3,3,0,766,766,763,763
Napa,38,2022-09-05,100,100,100,0,1721,1741,1740,1,6,1,1,2,158,158,157,157
Nevada,38,2022-09-05,79,79,79,0,904,916,915,1,3,0,0,0,132,132,132,132
Orange,38,2022-09-05,2154,2178,2178,0,31893,32246,32243,3,169,13,13,34,7421,7421,7408,7408
Placer,38,2022-09-05,236,236,236,0,3442,3480,3479,1,36,0,0,4,658,658,658,658
Plumas,38,2022-09-05,9,9,9,0,129,130,129,1,0,0,0,0,13,13,13,13
Riverside,38,2022-09-05,2393,2420,2420,0,28019,28329,28325,4,99,7,7,14,6603,6603,6596,6596
Sacramento,38,2022-09-05,1235,1248,1248,0,19385,19599,19596,3,139,12,12,22,3291,3291,3279,3279
San Benito,38,2022-09-05,64,64,64,0,526,533,532,1,0,0,0,2,100,100,100,100
San Bernardino,38,2022-09-05,2310,2336,2336,0,32847,33211,33207,4,122,12,12,19,8052,8052,8040,8040
San Diego,38,2022-09-05,2794,2826,2826,0,48149,48682,48680,2,212,10,10,25,5489,5489,5479,5479
San Francisco,38,2022-09-05,667,675,675,0,15311,15482,15477,5,52,10,10,9,1041,1041,1031,1031
San Joaquin,38,2022-09-05,825,835,835,0,11515,11642,11640,2,43,4,4,10,2319,2319,2315,2315
San Luis Obispo,38,2022-09-05,171,171,171,0,2689,2718,2717,1,7,2,2,1,524,524,522,522
San Mateo,38,2022-09-05,609,616,616,0,13166,13312,13311,1,23,0,0,2,730,730,730,730
Santa Barbara,38,2022-09-05,479,486,486,0,6639,6714,6713,1,39,4,4,3,725,725,721,721
Santa Clara,38,2022-09-05,1884,1904,1904,0,31864,32218,32216,2,127,9,9,20,2486,2486,2477,2477
Santa Cruz,38,2022-09-05,279,283,283,0,10218,10332,10331,1,16,0,0,0,273,273,273,273
Shasta,38,2022-09-05,102,102,102,0,2015,2039,2038,1,15,0,0,0,586,586,586,586
Siskiyou,38,2022-09-05,30,30,30,0,217,218,217,1,0,0,0,0,90,90,90,90
Solano,38,2022-09-05,365,369,369,0,5931,5998,5997,1,34,1,1,11,455,455,454,454
Sonoma,38,2022-09-05,366,370,370,0,6006,6073,6072,1,40,0,0,2,517,517,517,517
Stanislaus,38,2022-09-05,543,549,549,0,6334,6403,6402,1,69,5,5,4,1776,1776,1771,1771
Sutter,38,2022-09-05,114,114,114,0,1474,1490,1489,1,0,0,0,0,232,232,232,232
Tehama,38,2022-09-05,50,50,50,0,582,590,589,1,2,1,1,0,212,212,211,211
Trinity,38,2022-09-05,4,4,4,0,51,52,51,1,0,0,0,0,20,20,20,20
Tulare,38,2022-09-05,416,420,420,0,5179,5237,5236,1,37,2,2,1,1530,1530,1528,1528
Tuolumne,38,2022-09-05,67,67,67,0,739,749,748,1,1,0,0,0,193,193,193,193
Ventura,38,2022-09-05,851,862,862,0,12332,12468,12467,1,48,8,8,1,1567,1567,1559,1559
Yolo,38,2022-09-05,136,136,136,0,2704,2736,2735,1,1,3,3,2,340,340,337,337
Yuba,38,2022-09-05,87,87,87,0,973,985,984,1,14,0,0,1,120,120,120,120
Alameda,39,2022-09-12,1604,1624,1624,0,31648,32045,32042,3,94,5,5,16,2024,2024,2019,2019
Amador,39,2022-09-12,32,32,32,0,867,878,877,1,3,0,0,2,91,91,91,91
Butte,39,2022-09-12,189,190,190,0,2476,2508,2507,1,15,2,2,2,459,459,457,457
Calaveras,39,2022-09-12,14,14,14,0,498,504,503,1,1,0,0,0,133,133,133,133
Colusa,39,2022-09-12,17,17,17,0,414,419,418,1,0,0,0,0,22,22,22,22
Contra Costa,39,2022-09-12,961,973,973,0,17287,17504,17501,3,59,6,6,12,1438,1438,1432,1432
Del Norte,39,2022-09-12,33,33,33,0,597,606,605,1,1,0,0,1,55,55,55,55
El Dorado,39,2022-09-12,100,100,100,0,1899,1923,1922,1,3,0,0,1,230,230,230,230
Fresno,39,2022-09-12,891,902,902,0,14692,14876,14874,2,155,6,6,15,2867,2867,2861,2861
Glenn,39,2022-09-12,15,15,15,0,208,210,209,1,0,0,0,0,42,42,42,42
Humboldt,39,2022-09-12,104,104,104,0,1666,1688,1687,1,6,0,0,5,157,157,157,157
Imperial,39,2022-09-12,256,259,259,0,3296,3338,3337,1,10,0,0,2,960,960,960,960
Inyo,39,2022-09-12,13,13,13,0,195,198,197,1,0,1,1,0,60,60,59,59
Kern,39,2022-09-12,634,642,642,0,12775,12935,12934,1,45,7,7,13,2418,2418,2411,2411
Kings,39,2022-09-12,228,229,229,0,3169,3209,3208,1,6,1,1,0,456,456,455,455
Lake,39,2022-09-12,46,46,46,0,886,899,898,1,3,0,0,1,147,147,147,147
Lassen,39,2022-09-12,19,19,19,0,915,927,926,1,0,0,0,0,63,63,63,63
Los Angeles,39,2022-09-12,10933,11070,11070,0,281382,284907,284897,10,652,87,96,83,33438,33480,33351,33384
Madera,39,2022-09-12,236,239,239,0,2932,2969,2968,1,8,0,0,3,370,370,370,370
Marin,39,2022-09-12,171,171,171,0,3905,3954,3953,1,12,2,2,2,314,314,312,312
Mariposa,39,2022-09-12,14,14,14,0,199,201,200,1,0,0,0,0,29,29,29,29
Mendocino,39,2022-09-12,51,51,51,0,965,979,978,1,2,0,0,1,137,137,137,137
Merced,39,2022-09-12,229,230,230,0,3255,3297,3296,1,6,2,2,1,863,863,861,861
Modoc,39,2022-09-12,2,2,2,0,21,22,21,1,0,0,0,0,9,9,9,9
Mono,39,2022-09-12,7,7,7,0,76,77,76,1,0,0,0,0,7,7,7,7
Monterey,39,2022-09-12,217,218,218,0,4933,4995,4994,1,22,1,1,1,767,767,766,766
Napa,39,2022-09-12,116,116,116,0,2246,2276,2275,1,10,0,0,1,158,158,158,158
Nevada,39,2022-09-12,57,57,57,0,1184,1201,1200,1,2,0,0,0,132,132,132,132
Orange,39,2022-09-12,2064,2089,2089,0,36345,36800,36797,3,159,25,27,22,7446,7448,7421,7421
Placer,39,2022-09-12,235,237,237,0,4055,4106,4105,1,38,0,0,5,658,658,658,658
Plumas,39,2022-09-12,22,22,22,0,194,197,196,1,1,0,0,0,13,13,13,13
Riverside,39,2022-09-12,2228,2255,2255,0,32361,32767,32763,4,124,5,5,12,6608,6608,6603,6603
Sacramento,39,2022-09-12,1270,1286,1286,0,23136,23427,23424,3,119,16,16,15,3307,3307,3291,3291
San Benito,39,2022-09-12,89,89,89,0,597,606,605,1,1,0,0,1,100,100,100,100
San Bernardino,39,2022-09-12,1907,1930,1930,0,36718,37179,37176,3,92,12,12,26,8064,8064,8052,8052
San Diego,39,2022-09-12,3037,3074,3074,0,55615,56315,56313,2,194,5,5,24,5494,5494,5489,5489
San Francisco,39,2022-09-12,793,804,804,0,16811,17023,17019,4,58,8,8,15,1049,1049,1041,1041
San Joaquin,39,2022-09-12,630,638,638,0,13798,13971,13969,2,35,5,5,9,2324,2324,2319,2319
San Luis Obispo,39,2022-09-12,176,177,177,0,3238,3280,3279,1,10,0,0,1,524,524,524,524
San Mateo,39,2022-09-12,643,650,650,0,13750,13923,13922,1,20,0,0,2,730,730,730,730
Santa Barbara,39,2022-09-12,317,322,322,0,7240,7331,7330,1,27,0,0,2,725,725,725,725
Santa Clara,39,2022-09-12,1871,1893,1893,0,36886,37349,37348,1,144,4,4,28,2490,2490,2486,2486
Santa Cruz,39,2022-09-12,269,271,271,0,13324,13491,13490,1,15,0,0,0,273,273,273,273
Shasta,39,2022-09-12,171,172,172,0,2581,2614,2613,1,26,1,1,2,587,587,586,586
Siskiyou,39,2022-09-12,28,28,28,0,290,296,295,1,1,0,0,0,90,90,90,90
Solano,39,2022-09-12,413,418,418,0,6692,6777,6776,1,32,0,0,4,455,455,455,455
Sonoma,39,2022-09-12,388,393,393,0,7029,7118,7117,1,39,3,3,1,520,520,517,517
Stanislaus,39,2022-09-12,444,450,450,0,7711,7808,7807,1,73,1,1,4,1777,1777,1776,1776
Sutter,39,2022-09-12,118,118,118,0,1524,1543,1542,1,0,0,0,0,232,232,232,232
Tehama,39,2022-09-12,47,47,47,0,703,712,711,1,2,0,0,0,212,212,212,212
Trinity,39,2022-09-12,2,2,2,0,74,75,74,1,0,0,0,0,20,20,20,20
Tulare,39,2022-09-12,354,359,359,0,6897,6983,6982,1,39,4,4,0,1534,1534,1530,1530
Tuolumne,39,2022-09-12,59,59,59,0,816,827,826,1,2,0,0,1,193,193,193,193
Ventura,39,2022-09-12,820,830,830,0,14845,15031,15030,1,49,1,1,7,1568,1568,1567,1567
Yolo,39,2022-09-12,142,142,142,0,3238,3279,3278,1,1,1,1,3,341,341,340,340
Yuba,39,2022-09-12,93,93,93,0,1165,1181,1180,1,6,0,0,0,120,120,120,120
Alameda,40,2022-09-19,1222,1241,1241,0,28837,29249,29247,2,80,4,4,7,2028,2028,2024,2024
Amador,40,2022-09-19,33,33,33,0,759,771,770,1,1,3,3,1,94,94,91,91
Butte,40,2022-09-19,117,117,117,0,2129,2160,2159,1,18,0,0,1,459,459,459,459
Calaveras,40,2022-09-19,28,28,28,0,475,483,482,1,0,0,0,0,133,133,133,133
Colusa,40,2022-09-19,12,12,12,0,289,294,293,1,3,0,0,0,22,22,22,22
Contra Costa,40,2022-09-19,815,826,826,0,16693,16933,16931,2,52,7,7,8,1445,1445,1438,1438
Del Norte,40,2022-09-19,21,21,21,0,479,487,486,1,2,0,0,0,55,55,55,55
El Dorado,40,2022-09-19,75,75,75,0,1616,1640,1639,1,3,0,0,0,230,230,230,230
Fresno,40,2022-09-19,592,600,600,0,13308,13497,13496,1,110,7,7,14,2874,2874,2867,2867
Glenn,40,2022-09-19,14,14,14,0,202,204,203,1,2,0,0,0,42,42,42,42
Humboldt,40,2022-09-19,102,102,102,0,1472,1495,1494,1,8,0,0,3,157,157,157,157
Imperial,40,2022-09-19,147,147,147,0,2869,2912,2911,1,11,0,0,2,960,960,960,960
Inyo,40,2022-09-19,8,8,8,0,171,174,173,1,0,0,0,0,60,60,60,60
Kern,40,2022-09-19,435,442,442,0,11496,11662,11661,1,34,2,2,6,2420,2420,2418,2418
Kings,40,2022-09-19,136,136,136,0,2641,2680,2679,1,7,2,2,0,458,458,456,456
Lake,40,2022-09-19,35,35,35,0,902,916,915,1,0,0,0,0,147,147,147,147
Lassen,40,2022-09-19,7,7,7,0,702,714,713,1,0,0,0,0,63,63,63,63
Los Angeles,40,2022-09-19,8470,8592,8592,0,253444,257073,257066,7,564,66,75,69,33504,33555,33438,33480
Madera,40,2022-09-19,107,107,107,0,2689,2729,2728,1,9,1,1,2,371,371,370,370
Marin,40,2022-09-19,137,137,137,0,3693,3747,3746,1,6,0,0,0,314,314,314,314
Mariposa,40,2022-09-19,10,10,10,0,180,182,181,1,0,1,1,0,30,30,29,29
Mendocino,40,2022-09-19,37,37,37,0,937,951,950,1,0,0,0,1,137,137,137,137
Merced,40,2022-09-19,166,167,167,0,2868,2910,2909,1,8,3,3,1,866,866,863,863
Modoc,40,2022-09-19,2,2,2,0,17,18,17,1,0,0,0,0,9,9,9,9
Mono,40,2022-09-19,4,4,4,0,63,64,63,1,0,0,0,0,7,7,7,7
Monterey,40,2022-09-19,159,159,159,0,4251,4313,4312,1,14,1,1,2,768,768,767,767
Napa,40,2022-09-19,97,97,97,0,1770,1796,1795,1,4,0,0,0,158,158,158,158
Nevada,40,2022-09-19,62,62,62,0,1114,1132,1131,1,2,0,0,0,132,132,132,132
Orange,40,2022-09-19,1691,1715,1715,0,33641,34123,34121,2,129,14,15,19,7460,7463,7446,7448
Placer,40,2022-09-19,219,221,221,0,3803,3858,3857,1,51,1,1,4,659,659,658,658
Plumas,40,2022-09-19,22,22,22,0,183,187,186,1,1,0,0,0,13,13,13,13
Riverside,40,2022-09-19,1404,1424,1424,0,28326,28731,28729,2,68,3,3,19,6611,6611,6608,6608
Sacramento,40,2022-09-19,1013,1026,1026,0,21078,21379,21377,2,102,7,7,17,3314,3314,3307,3307
San Benito,40,2022-09-19,55,55,55,0,528,536,535,1,0,0,0,0,100,100,100,100
San Bernardino,40,2022-09-19,1446,1467,1467,0,30904,31346,31344,2,83,7,7,19,8071,8071,8064,8064
San Diego,40,2022-09-19,2564,2601,2601,0,55813,56614,56612,2,175,8,8,19,5502,5502,5494,5494
San Francisco,40,2022-09-19,661,671,671,0,16142,16374,16371,3,43,9,9,11,1058,1058,1049,1049
San Joaquin,40,2022-09-19,443,449,449,0,12528,12707,12706,1,35,5,5,2,2329,2329,2324,2324
San Luis Obispo,40,2022-09-19,151,151,151,0,2776,2816,2815,1,8,0,0,0,524,524,524,524
San Mateo,40,2022-09-19,576,584,584,0,13221,13411,13410,1,20,0,0,2,730,730,730,730
Santa Barbara,40,2022-09-19,260,263,263,0,6797,6894,6893,1,34,2,2,0,727,727,725,725
Santa Clara,40,2022-09-19,1416,1437,1437,0,36026,36544,36543,1,137,7,7,21,2497,2497,2490,2490
Santa Cruz,40,2022-09-19,147,147,147,0,12310,12487,12486,1,5,0,0,1,273,273,273,273
Shasta,40,2022-09-19,96,96,96,0,2097,2127,2126,1,21,0,0,3,587,587,587,587
Siskiyou,40,2022-09-19,21,21,21,0,231,236,235,1,2,1,1,0,91,91,90,90
Solano,40,2022-09-19,273,277,277,0,6102,6190,6189,1,24,0,0,5,455,455,455,455
Sonoma,40,2022-09-19,309,315,315,0,6363,6454,6453,1,27,2,2,1,522,522,520,520
Stanislaus,40,2022-09-19,327,333,333,0,6276,6365,6364,1,57,2,2,4,1779,1779,1777,1777
Sutter,40,2022-09-19,75,75,75,0,1391,1412,1411,1,0,0,0,0,232,232,232,232
Tehama,40,2022-09-19,35,35,35,0,601,609,608,1,2,1,1,0,213,213,212,212
Trinity,40,2022-09-19,3,3,3,0,53,54,53,1,0,0,0,0,20,20,20,20
Tulare,40,2022-09-19,222,224,224,0,5741,5823,5822,1,32,1,1,0,1535,1535,1534,1534
Tuolumne,40,2022-09-19,57,57,57,0,726,737,736,1,0,0,0,0,193,193,193,193
Ventura,40,2022-09-19,596,604,604,0,13418,13610,13609,1,42,2,2,6,1570,1570,1568,1568
Yolo,40,2022-09-19,80,80,80,0,3721,3776,3775,1,2,3,3,2,344,344,341,341
Yuba,40,2022-09-19,60,60,60,0,1036,1052,1051,1,3,0,0,0,120,120,120,120
Alameda,41,2022-09-26,1120,1139,1139,0,27265,27716,27715,1,77,2,2,4,2030,2030,2028,2028
Amador,41,2022-09-26,25,25,25,0,716,728,727,1,1,0,0,1,94,94,94,94
Butte,41,2022-09-26,90,90,90,0,1789,1819,1818,1,23,0,0,1,459,459,459,459
Calaveras,41,2022-09-26,20,20,20,0,387,395,394,1,2,1,1,0,134,134,133,133
Colusa,41,2022-09-26,7,7,7,0,299,304,303,1,1,0,0,0,22,22,22,22
Contra Costa,41,2022-09-26,745,757,757,0,16198,16466,16465,1,48,5,5,7,1450,1450,1445,1445
Del Norte,41,2022-09-26,21,21,21,0,465,474,473,1,2,0,0,0,55,55,55,55
El Dorado,41,2022-09-26,81,81,81,0,1557,1583,1582,1,5,0,0,0,230,230,230,230
Fresno,41,2022-09-26,508,516,516,0,12068,12268,12267,1,84,3,3,13,2877,2877,2874,2874
Glenn,41,2022-09-26,7,7,7,0,175,178,177,1,2,0,0,0,42,42,42,42
Humboldt,41,2022-09-26,94,94,94,0,1311,1332,1331,1,10,2,2,0,159,159,157,157
Imperial,41,2022-09-26,112,112,112,0,2619,2664,2663,1,4,0,0,1,960,960,960,960
Inyo,41,2022-09-26,5,5,5,0,165,168,167,1,0,0,0,0,60,60,60,60
Kern,41,2022-09-26,328,333,333,0,10685,10860,10859,1,32,2,2,7,2422,2422,2420,2420
Kings,41,2022-09-26,106,106,106,0,2616,2660,2659,1,2,1,1,0,459,459,458,458
Lake,41,2022-09-26,23,23,23,0,810,825,824,1,0,0,0,0,147,147,147,147
Lassen,41,2022-09-26,13,13,13,0,531,542,541,1,0,0,0,0,63,63,63,63
Los Angeles,41,2022-09-26,7632,7758,7758,0,237772,241695,241690,5,443,61,73,53,33565,33628,33504,33555
Madera,41,2022-09-26,79,79,79,0,2209,2247,2246,1,8,0,0,2,371,371,371,371
Marin,41,2022-09-26,171,172,172,0,3651,3713,3712,1,10,0,0,0,314,314,314,314
Mariposa,41,2022-09-26,3,3,3,0,155,157,156,1,0,0,0,0,30,30,30,30
Mendocino,41,2022-09-26,35,35,35,0,852,867,866,1,1,0,0,0,137,137,137,137
Merced,41,2022-09-26,119,119,119,0,2787,2834,2833,1,10,1,1,0,867,867,866,866
Modoc,41,2022-09-26,0,0,0,0,13,14,13,1,0,0,0,0,9,9,9,9
Mono,41,2022-09-26,1,1,1,0,60,61,60,1,0,0,0,0,7,7,7,7
Monterey,41,2022-09-26,133,134,134,0,3997,4063,4062,1,14,0,0,2,768,768,768,768
Napa,41,2022-09-26,85,85,85,0,1939,1974,1973,1,5,0,0,1,158,158,158,158
Nevada,41,2022-09-26,45,45,45,0,1067,1086,1085,1,1,0,0,0,132,132,132,132
Orange,41,2022-09-26,1635,1662,1662,0,30637,31143,31141,2,117,17,20,23,7477,7483,7460,7463
Placer,41,2022-09-26,190,192,192,0,3446,3504,3503,1,42,1,1,4,660,660,659,659
Plumas,41,2022-09-26,21,21,21,0,151,153,152,1,1,0,0,0,13,13,13,13
Riverside,41,2022-09-26,1266,1287,1287,0,25025,25439,25437,2,55,6,7,15,6617,6618,6611,6611
Sacramento,41,2022-09-26,892,906,906,0,18811,19122,19121,1,106,11,11,20,3325,3325,3314,3314
San Benito,41,2022-09-26,47,47,47,0,487,496,495,1,0,1,1,2,101,101,100,100
San Bernardino,41,2022-09-26,1195,1213,1213,0,26149,26581,26580,1,75,4,4,12,8075,8075,8071,8071
San Diego,41,2022-09-26,2476,2518,2518,0,50786,51625,51624,1,201,7,7,15,5509,5509,5502,5502
San Francisco,41,2022-09-26,642,651,651,0,15376,15631,15629,2,45,2,2,9,1060,1060,1058,1058
San Joaquin,41,2022-09-26,399,405,405,0,10706,10883,10882,1,35,1,1,3,2330,2330,2329,2329
San Luis Obispo,41,2022-09-26,125,126,126,0,2517,2561,2560,1,7,0,0,0,524,524,524,524
San Mateo,41,2022-09-26,573,581,581,0,12666,12874,12873,1,25,0,0,1,730,730,730,730
Santa Barbara,41,2022-09-26,251,255,255,0,6375,6481,6480,1,22,2,2,0,729,729,727,727
Santa Clara,41,2022-09-26,1358,1381,1381,0,34856,35433,35432,1,113,10,12,17,2507,2509,2497,2497
Santa Cruz,41,2022-09-26,220,223,223,0,12472,12679,12678,1,13,0,0,0,273,273,273,273
Shasta,41,2022-09-26,67,67,67,0,1724,1754,1753,1,14,0,0,3,587,587,587,587
Siskiyou,41,2022-09-26,18,18,18,0,183,186,185,1,1,1,1,0,92,92,91,91
Solano,41,2022-09-26,302,307,307,0,5672,5767,5766,1,23,1,1,2,456,456,455,455
Sonoma,41,2022-09-26,288,293,293,0,6326,6432,6431,1,31,1,1,2,523,523,522,522
Stanislaus,41,2022-09-26,259,264,264,0,5789,5886,5885,1,46,2,2,3,1781,1781,1779,1779
Sutter,41,2022-09-26,68,68,68,0,1139,1158,1157,1,0,0,0,0,232,232,232,232
Tehama,41,2022-09-26,33,33,33,0,550,560,559,1,1,2,2,0,215,215,213,213
Trinity,41,2022-09-26,3,3,3,0,44,45,44,1,0,0,0,0,20,20,20,20
Tulare,41,2022-09-26,162,163,163,0,5083,5168,5167,1,18,2,2,2,1537,1537,1535,1535
Tuolumne,41,2022-09-26,44,44,44,0,687,699,698,1,1,0,0,0,193,193,193,193
Ventura,41,2022-09-26,530,538,538,0,11558,11749,11748,1,33,4,4,1,1574,1574,1570,1570
Yolo,41,2022-09-26,126,126,126,0,3853,3918,3917,1,2,3,3,3,347,347,344,344
Yuba,41,2022-09-26,40,40,40,0,928,944,943,1,6,0,0,1,120,120,120,120
Alameda,42,2022-10-03,1097,1117,1117,0,25818,26327,26326,1,54,3,3,5,2033,2033,2030,2030
Amador,42,2022-10-03,13,13,13,0,681,696,695,1,0,0,0,1,94,94,94,94
Butte,42,2022-10-03,66,66,66,0,1725,1760,1759,1,11,1,1,2,460,460,459,459
Calaveras,42,2022-10-03,18,18,18,0,333,341,340,1,1,0,0,0,134,134,134,134
Colusa,42,2022-10-03,7,7,7,0,188,192,191,1,0,0,0,0,22,22,22,22
Contra Costa,42,2022-10-03,700,714,714,0,15594,15903,15902,1,34,3,3,6,1453,1453,1450,1450
Del Norte,42,2022-10-03,11,11,11,0,382,392,391,1,1,0,0,1,55,55,55,55
El Dorado,42,2022-10-03,67,67,67,0,1367,1395,1394,1,3,0,0,1,230,230,230,230
Fresno,42,2022-10-03,478,488,488,0,10973,11190,11189,1,77,2,2,11,2879,2879,2877,2877
Glenn,42,2022-10-03,6,6,6,0,155,158,157,1,0,0,0,0,42,42,42,42
Humboldt,42,2022-10-03,79,79,79,0,1156,1180,1179,1,6,0,0,1,159,159,159,159
Imperial,42,2022-10-03,140,141,141,0,2546,2598,2597,1,6,0,0,0,960,960,960,960
Inyo,42,2022-10-03,5,5,5,0,159,162,161,1,0,0,0,1,60,60,60,60
Kern,42,2022-10-03,276,281,281,0,9931,10128,10127,1,24,0,0,5,2422,2422,2422,2422
Kings,42,2022-10-03,87,87,87,0,2406,2455,2454,1,2,0,0,0,459,459,459,459
Lake,42,2022-10-03,33,33,33,0,751,767,766,1,3,0,0,0,147,147,147,147
Lassen,42,2022-10-03,7,7,7,0,527,539,538,1,2,0,0,0,63,63,63,63
Los Angeles,42,2022-10-03,6917,7055,7055,0,219078,223384,223380,4,439,46,58,69,33611,33686,33565,33628
Madera,42,2022-10-03,64,64,64,0,1543,1575,1574,1,6,0,0,2,371,371,371,371
Marin,42,2022-10-03,185,189,189,0,3452,3522,3521,1,6,0,0,2,314,314,314,314
Mariposa,42,2022-10-03,5,5,5,0,130,131,130,1,0,0,0,0,30,30,30,30
Mendocino,42,2022-10-03,45,45,45,0,777,794,793,1,4,0,0,0,137,137,137,137
Merced,42,2022-10-03,97,98,98,0,2543,2595,2594,1,5,2,2,1,869,869,867,867
Modoc,42,2022-10-03,2,2,2,0,13,14,13,1,0,0,0,0,9,9,9,9
Mono,42,2022-10-03,4,4,4,0,69,70,69,1,0,0,0,0,7,7,7,7
Monterey,42,2022-10-03,109,109,109,0,3720,3795,3794,1,11,1,1,1,769,769,768,768
Napa,42,2022-10-03,88,88,88,0,1693,1727,1726,1,4,0,0,2,158,158,158,158
Nevada,42,2022-10-03,47,47,47,0,944,963,962,1,1,0,0,4,132,132,132,132
Orange,42,2022-10-03,1513,1543,1543,0,27515,28059,28058,1,131,20,26,16,7497,7509,7477,7483
Placer,42,2022-10-03,163,166,166,0,3071,3133,3132,1,41,2,2,3,662,662,660,660
Plumas,42,2022-10-03,12,12,12,0,106,109,108,1,1,0,0,0,13,13,13,13
Riverside,42,2022-10-03,1138,1161,1161,0,21434,21859,21858,1,59,4,4,12,6621,6622,6617,6618
Sacramento,42,2022-10-03,829,846,846,0,17588,17937,17936,1,88,10,11,19,3335,3336,3325,3325
San Benito,42,2022-10-03,32,32,32,0,428,437,436,1,0,0,0,0,101,101,101,101
San Bernardino,42,2022-10-03,1187,1210,1210,0,23332,23792,23791,1,77,1,1,7,8076,8076,8075,8075
San Diego,42,2022-10-03,2081,2121,2121,0,46493,47413,47412,1,162,7,7,18,5516,5516,5509,5509
San Francisco,42,2022-10-03,597,610,610,0,14579,14868,14866,2,44,3,3,9,1063,1063,1060,1060
San Joaquin,42,2022-10-03,339,347,347,0,9540,9729,9728,1,25,4,5,3,2334,2335,2330,2330
San Luis Obispo,42,2022-10-03,143,146,146,0,2322,2370,2369,1,2,0,0,1,524,524,524,524
San Mateo,42,2022-10-03,540,551,551,0,11775,12008,12007,1,22,0,0,2,730,730,730,730
Santa Barbara,42,2022-10-03,249,256,256,0,6270,6395,6394,1,15,0,0,2,729,729,729,729
Santa Clara,42,2022-10-03,1395,1424,1424,0,31206,31821,31820,1,109,3,3,20,2510,2512,2507,2509
Santa Cruz,42,2022-10-03,219,224,224,0,11116,11337,11336,1,10,0,0,1,273,273,273,273
Shasta,42,2022-10-03,52,52,52,0,1433,1462,1461,1,10,0,0,2,587,587,587,587
Siskiyou,42,2022-10-03,10,10,10,0,204,210,209,1,0,0,0,0,92,92,92,92
Solano,42,2022-10-03,245,251,251,0,5317,5424,5423,1,17,0,0,2,456,456,456,456
Sonoma,42,2022-10-03,320,327,327,0,5920,6037,6036,1,17,0,0,3,523,523,523,523
Stanislaus,42,2022-10-03,194,199,199,0,5317,5423,5422,1,49,0,0,6,1781,1781,1781,1781
Sutter,42,2022-10-03,57,57,57,0,1099,1121,1120,1,0,0,0,0,232,232,232,232
Tehama,42,2022-10-03,20,20,20,0,525,535,534,1,1,0,0,0,215,215,215,215
Trinity,42,2022-10-03,1,1,1,0,43,44,43,1,0,0,0,0,20,20,20,20
Tulare,42,2022-10-03,153,155,155,0,5044,5145,5144,1,19,2,2,1,1539,1539,1537,1537
Tuolumne,42,2022-10-03,23,23,23,0,620,633,632,1,0,0,0,0,193,193,193,193
Ventura,42,2022-10-03,466,475,475,0,10409,10617,10616,1,41,1,1,2,1575,1575,1574,1574
Yolo,42,2022-10-03,123,124,124,0,2917,2975,2974,1,3,2,3,2,349,350,347,347
Yuba,42,2022-10-03,35,35,35,0,791,806,805,1,4,0,0,1,120,120,120,120
Alameda,43,2022-10-10,1122,1149,1149,0,27291,27990,27989,1,45,2,3,7,2035,2036,2033,2033
Amador,43,2022-10-10,15,15,15,0,797,820,819,1,0,0,0,2,94,94,94,94
Butte,43,2022-10-10,66,66,66,0,1730,1775,1774,1,12,0,0,1,460,460,460,460
Calaveras,43,2022-10-10,15,15,15,0,370,381,380,1,0,1,1,0,135,135,134,134
Colusa,43,2022-10-10,2,2,2,0,120,123,122,1,1,0,0,0,22,22,22,22
Contra Costa,43,2022-10-10,731,749,749,0,16626,17053,17052,1,31,7,10,6,1458,1460,1451,1450
Del Norte,43,2022-10-10,10,10,10,0,492,505,504,1,1,0,0,1,55,55,55,55
El Dorado,43,2022-10-10,67,67,67,0,1646,1689,1688,1,7,0,0,4,230,230,230,230
Fresno,43,2022-10-10,472,485,485,0,11955,12261,12260,1,60,3,4,9,2882,2883,2879,2879
Glenn,43,2022-10-10,10,10,10,0,225,230,229,1,1,0,0,0,42,42,42,42
Humboldt,43,2022-10-10,91,91,91,0,1418,1456,1455,1,7,1,1,0,160,160,159,159
Imperial,43,2022-10-10,191,197,197,0,2901,2976,2975,1,7,0,0,0,960,960,960,960
Inyo,43,2022-10-10,3,3,3,0,123,125,124,1,0,0,0,0,60,60,60,60
Kern,43,2022-10-10,304,312,312,0,11596,11895,11894,1,24,0,0,2,2422,2422,2422,2422
Kings,43,2022-10-10,102,102,102,0,2739,2810,2809,1,1,0,0,0,459,459,459,459
Lake,43,2022-10-10,33,33,33,0,915,939,938,1,1,0,0,0,147,147,147,147
Lassen,43,2022-10-10,3,3,3,0,570,587,586,1,0,0,0,0,63,63,63,63
Los Angeles,43,2022-10-10,6650,6822,6822,0,224355,230117,230114,3,436,62,90,51,33666,33765,33604,33675
Madera,43,2022-10-10,65,65,65,0,1690,1733,1732,1,7,0,0,2,371,371,371,371
Marin,43,2022-10-10,205,211,211,0,3758,3856,3855,1,9,0,0,0,314,314,314,314
Mariposa,43,2022-10-10,8,8,8,0,127,130,129,1,0,0,0,0,30,30,30,30
Mendocino,43,2022-10-10,26,26,26,0,971,996,995,1,1,0,0,2,137,137,137,137
Merced,43,2022-10-10,108,110,110,0,2713,2784,2783,1,8,0,0,3,869,869,869,869
Modoc,43,2022-10-10,5,5,5,0,12,13,12,1,0,0,0,0,9,9,9,9
Mono,43,2022-10-10,1,1,1,0,55,56,55,1,0,0,0,0,7,7,7,7
Monterey,43,2022-10-10,105,105,105,0,4305,4418,4417,1,9,0,0,1,769,769,769,769
Napa,43,2022-10-10,76,76,76,0,1763,1809,1808,1,3,0,0,2,158,158,158,158
Nevada,43,2022-10-10,37,37,37,0,974,1002,1001,1,1,0,0,1,132,132,132,132
Orange,43,2022-10-10,1461,1498,1498,0,29058,29803,29802,1,129,11,15,19,7506,7521,7495,7506
Placer,43,2022-10-10,153,155,155,0,3575,3668,3667,1,24,0,0,7,662,662,662,662
Plumas,43,2022-10-10,20,20,20,0,106,109,108,1,0,0,0,0,13,13,13,13
Riverside,43,2022-10-10,1150,1180,1180,0,23128,23722,23721,1,56,2,2,4,6623,6624,6621,6622
Sacramento,43,2022-10-10,878,901,901,0,19673,20178,20177,1,81,4,5,16,3339,3341,3335,3336
San Benito,43,2022-10-10,34,34,34,0,464,477,476,1,3,0,0,0,101,101,101,101
San Bernardino,43,2022-10-10,1079,1105,1105,0,25475,26127,26126,1,66,0,0,13,8076,8076,8076,8076
San Diego,43,2022-10-10,1967,2017,2017,0,51220,52537,52536,1,130,6,9,21,5520,5522,5514,5513
San Francisco,43,2022-10-10,622,637,637,0,15268,15658,15657,1,37,2,2,9,1065,1065,1063,1063
San Joaquin,43,2022-10-10,423,433,433,0,11148,11437,11436,1,17,0,0,8,2334,2335,2334,2335
San Luis Obispo,43,2022-10-10,82,82,82,0,2523,2588,2587,1,2,1,1,0,525,525,524,524
San Mateo,43,2022-10-10,623,640,640,0,13197,13536,13535,1,19,0,0,0,730,730,730,730
Santa Barbara,43,2022-10-10,236,244,244,0,7825,8026,8025,1,20,1,1,1,730,730,729,729
Santa Clara,43,2022-10-10,1395,1430,1430,0,33155,34012,34011,1,107,1,1,18,2511,2513,2510,2512
Santa Cruz,43,2022-10-10,338,348,348,0,12140,12453,12452,1,9,0,0,1,273,273,273,273
Shasta,43,2022-10-10,94,96,96,0,1286,1322,1321,1,13,3,4,1,590,591,587,587
Siskiyou,43,2022-10-10,10,10,10,0,244,252,251,1,0,1,1,0,93,93,92,92
Solano,43,2022-10-10,327,337,337,0,6210,6372,6371,1,23,2,4,4,457,458,455,454
Sonoma,43,2022-10-10,285,293,293,0,6758,6932,6931,1,15,0,0,3,523,523,523,523
Stanislaus,43,2022-10-10,200,206,206,0,5880,6033,6032,1,51,0,0,7,1781,1781,1781,1781
Sutter,43,2022-10-10,56,56,56,0,1125,1153,1152,1,0,0,0,0,232,232,232,232
Tehama,43,2022-10-10,20,20,20,0,562,578,577,1,1,0,0,0,215,215,215,215
Trinity,43,2022-10-10,1,1,1,0,53,54,53,1,0,0,0,0,20,20,20,20
Tulare,43,2022-10-10,164,168,168,0,4963,5092,5091,1,16,1,2,1,1540,1541,1539,1539
Tuolumne,43,2022-10-10,36,36,36,0,654,672,671,1,1,0,0,0,193,193,193,193
Ventura,43,2022-10-10,418,427,427,0,10951,11233,11232,1,41,4,6,1,1578,1579,1574,1573
Yolo,43,2022-10-10,124,126,126,0,3071,3151,3150,1,4,1,1,0,350,351,349,350
Yuba,43,2022-10-10,25,25,25,0,919,943,942,1,0,0,0,0,120,120,120,120
Alameda,44,2022-10-17,890,922,922,0,24024,24869,24868,1,60,4,8,8,2039,2044,2035,2036
Amador,44,2022-10-17,13,13,13,0,588,610,609,1,1,0,0,0,94,94,94,94
Butte,44,2022-10-17,74,75,75,0,1417,1467,1466,1,13,0,0,0,460,460,460,460
Calaveras,44,2022-10-17,18,18,18,0,305,317,316,1,0,0,0,0,135,135,135,135
Colusa,44,2022-10-17,4,4,4,0,79,81,80,1,0,0,0,0,22,22,22,22
Contra Costa,44,2022-10-17,651,674,674,0,14401,14908,14907,1,30,1,2,6,1459,1462,1458,1460
Del Norte,44,2022-10-17,9,9,9,0,379,393,392,1,1,0,0,0,55,55,55,55
El Dorado,44,2022-10-17,66,66,66,0,1304,1351,1350,1,2,0,0,1,230,230,230,230
Fresno,44,2022-10-17,341,353,353,0,9724,10071,10070,1,62,0,0,11,2882,2883,2882,2883
Glenn,44,2022-10-17,5,5,5,0,141,145,144,1,1,0,0,0,42,42,42,42
Humboldt,44,2022-10-17,73,75,75,0,1146,1188,1187,1,1,0,0,0,160,160,160,160
Imperial,44,2022-10-17,116,119,119,0,2305,2386,2385,1,5,0,0,0,960,960,960,960
Inyo,44,2022-10-17,4,4,4,0,122,128,127,1,1,0,0,0,60,60,60,60
Kern,44,2022-10-17,218,226,226,0,9539,9874,9873,1,32,0,0,1,2422,2422,2422,2422
Kings,44,2022-10-17,70,71,71,0,2313,2392,2391,1,2,0,0,0,459,459,459,459
Lake,44,2022-10-17,25,25,25,0,769,798,797,1,1,0,0,0,147,147,147,147
Lassen,44,2022-10-17,7,7,7,0,509,529,528,1,1,0,0,0,63,63,63,63
Los Angeles,44,2022-10-17,4922,5095,5095,0,185355,191842,191840,2,350,27,49,53,33693,33814,33666,33765
Madera,44,2022-10-17,56,57,57,0,1436,1488,1487,1,3,0,0,2,371,371,371,371
Marin,44,2022-10-17,128,134,134,0,3074,3184,3183,1,8,0,0,1,314,314,314,314
Mariposa,44,2022-10-17,5,5,5,0,119,126,125,1,0,0,0,0,30,30,30,30
Mendocino,44,2022-10-17,43,43,43,0,740,767,766,1,2,0,0,0,137,137,137,137
Merced,44,2022-10-17,123,128,128,0,2280,2360,2359,1,15,0,0,2,869,869,869,869
Modoc,44,2022-10-17,1,1,1,0,7,8,7,1,0,0,0,0,9,9,9,9
Mono,44,2022-10-17,6,6,6,0,41,42,41,1,1,0,0,0,7,7,7,7
Monterey,44,2022-10-17,115,119,119,0,3461,3584,3583,1,12,1,2,1,770,771,769,769
Napa,44,2022-10-17,58,58,58,0,1411,1462,1461,1,2,0,0,1,158,158,158,158
Nevada,44,2022-10-17,43,43,43,0,765,793,792,1,0,0,0,5,132,132,132,132
Orange,44,2022-10-17,1073,1110,1110,0,24235,25084,25083,1,91,13,28,18,7519,7549,7506,7521
Placer,44,2022-10-17,106,110,110,0,2704,2803,2802,1,32,0,0,3,662,662,662,662
Plumas,44,2022-10-17,11,11,11,0,98,101,100,1,0,0,0,0,13,13,13,13
Riverside,44,2022-10-17,867,898,898,0,19749,20446,20445,1,66,2,4,2,6625,6628,6623,6624
Sacramento,44,2022-10-17,785,813,813,0,15525,16073,16072,1,84,5,11,14,3344,3352,3339,3341
San Benito,44,2022-10-17,26,26,26,0,358,372,371,1,0,1,2,0,102,103,101,101
San Bernardino,44,2022-10-17,807,836,836,0,21457,22211,22210,1,63,1,3,9,8077,8079,8076,8076
San Diego,44,2022-10-17,1624,1683,1683,0,42259,43745,43744,1,117,8,14,24,5528,5536,5520,5522
San Francisco,44,2022-10-17,516,534,534,0,13635,14116,14115,1,34,2,4,13,1067,1069,1065,1065
San Joaquin,44,2022-10-17,340,351,351,0,8698,9008,9007,1,8,1,2,8,2335,2337,2334,2335
San Luis Obispo,44,2022-10-17,100,103,103,0,2117,2193,2192,1,4,0,0,0,525,525,525,525
San Mateo,44,2022-10-17,525,544,544,0,10894,11276,11275,1,21,0,0,1,730,730,730,730
Santa Barbara,44,2022-10-17,173,179,179,0,5595,5793,5792,1,18,0,0,2,730,730,730,730
Santa Clara,44,2022-10-17,1123,1162,1162,0,27357,28319,28318,1,93,2,4,16,2513,2517,2511,2513
Santa Cruz,44,2022-10-17,280,290,290,0,10193,10561,10560,1,7,1,2,0,274,275,273,273
Shasta,44,2022-10-17,73,74,74,0,1094,1134,1133,1,12,0,0,2,590,591,590,591
Siskiyou,44,2022-10-17,12,12,12,0,180,188,187,1,2,1,2,0,94,95,93,93
Solano,44,2022-10-17,253,261,261,0,4796,4970,4969,1,25,2,4,3,459,462,457,458
Sonoma,44,2022-10-17,235,243,243,0,5352,5542,5541,1,20,1,2,1,524,525,523,523
Stanislaus,44,2022-10-17,215,222,222,0,5255,5442,5441,1,45,0,0,5,1781,1781,1781,1781
Sutter,44,2022-10-17,38,38,38,0,901,935,934,1,0,0,0,0,232,232,232,232
Tehama,44,2022-10-17,21,21,21,0,396,410,409,1,0,0,0,0,215,215,215,215
Trinity,44,2022-10-17,0,0,0,0,34,35,34,1,0,0,0,0,20,20,20,20
Tulare,44,2022-10-17,137,142,142,0,4255,4407,4406,1,11,1,2,1,1541,1543,1540,1541
Tuolumne,44,2022-10-17,36,36,36,0,613,635,634,1,2,0,0,0,193,193,193,193
Ventura,44,2022-10-17,363,377,377,0,9304,9632,9631,1,32,2,5,1,1580,1584,1578,1579
Yolo,44,2022-10-17,99,103,103,0,2184,2263,2262,1,3,2,4,3,352,355,350,351
Yuba,44,2022-10-17,41,41,41,0,759,786,785,1,1,0,0,0,120,120,120,120
Alameda,45,2022-10-24,897,957,957,0,22747,24258,24257,1,46,3,14,10,2042,2058,2039,2044
Amador,45,2022-10-24,16,16,16,0,626,669,668,1,2,0,0,0,94,94,94,94
Butte,45,2022-10-24,64,67,67,0,1396,1489,1488,1,10,1,5,1,461,465,460,460
Calaveras,45,2022-10-24,18,18,18,0,318,340,339,1,0,0,0,0,135,135,135,135
Colusa,45,2022-10-24,3,3,3,0,94,101,100,1,0,0,0,0,22,22,22,22
Contra Costa,45,2022-10-24,600,639,639,0,13757,14662,14661,1,37,1,3,5,1460,1465,1459,1462
Del Norte,45,2022-10-24,6,6,6,0,359,382,381,1,0,0,0,1,55,55,55,55
El Dorado,45,2022-10-24,76,82,82,0,1436,1529,1528,1,1,0,0,0,230,230,230,230
Fresno,45,2022-10-24,363,387,387,0,9578,10213,10212,1,63,0,0,6,2882,2883,2882,2883
Glenn,45,2022-10-24,9,9,9,0,147,162,161,1,0,0,0,0,42,42,42,42
Humboldt,45,2022-10-24,66,71,71,0,1141,1216,1215,1,7,0,0,2,160,160,160,160
Imperial,45,2022-10-24,86,91,91,0,2322,2474,2473,1,8,0,0,0,960,960,960,960
Inyo,45,2022-10-24,3,3,3,0,269,291,290,1,0,0,0,0,60,60,60,60
Kern,45,2022-10-24,239,253,253,0,9493,10119,10118,1,24,0,0,2,2422,2422,2422,2422
Kings,45,2022-10-24,91,97,97,0,2328,2478,2477,1,8,0,0,0,459,459,459,459
Lake,45,2022-10-24,22,22,22,0,631,674,673,1,1,0,0,1,147,147,147,147
Lassen,45,2022-10-24,16,16,16,0,481,514,513,1,1,0,0,0,63,63,63,63
Los Angeles,45,2022-10-24,4821,5141,5141,0,182145,194117,194115,2,332,27,123,43,33720,33937,33693,33814
Madera,45,2022-10-24,56,59,59,0,1357,1449,1448,1,4,0,0,2,371,371,371,371
Marin,45,2022-10-24,129,136,136,0,3042,3242,3241,1,12,0,0,2,314,314,314,314
Mariposa,45,2022-10-24,11,11,11,0,115,123,122,1,0,0,0,0,30,30,30,30
Mendocino,45,2022-10-24,37,40,40,0,767,820,819,1,2,0,0,0,137,137,137,137
Merced,45,2022-10-24,85,91,91,0,2276,2424,2423,1,7,1,4,3,870,873,869,869
Modoc,45,2022-10-24,1,1,1,0,13,14,13,1,0,0,0,0,9,9,9,9
Mono,45,2022-10-24,2,2,2,0,62,67,66,1,0,0,0,0,7,7,7,7
Monterey,45,2022-10-24,116,124,124,0,3673,3914,3913,1,18,0,0,0,770,771,770,771
Napa,45,2022-10-24,51,53,53,0,1456,1555,1554,1,3,0,0,0,158,158,158,158
Nevada,45,2022-10-24,31,32,32,0,759,812,811,1,6,0,0,0,132,132,132,132
Orange,45,2022-10-24,1096,1169,1169,0,25006,26643,26642,1,84,1,7,14,7520,7556,7519,7549
Placer,45,2022-10-24,140,149,149,0,2797,2989,2988,1,39,0,0,6,662,662,662,662
Plumas,45,2022-10-24,12,12,12,0,78,86,85,1,0,0,0,0,13,13,13,13
Riverside,45,2022-10-24,857,914,914,0,19022,20293,20292,1,53,0,0,6,6625,6628,6625,6628
Sacramento,45,2022-10-24,734,783,783,0,14521,15477,15476,1,84,1,4,19,3345,3356,3344,3352
San Benito,45,2022-10-24,38,41,41,0,443,473,472,1,0,0,0,1,102,103,102,103
San Bernardino,45,2022-10-24,763,812,812,0,19580,20880,20879,1,39,3,12,10,8080,8091,8077,8079
San Diego,45,2022-10-24,1584,1689,1689,0,40811,43461,43460,1,83,4,14,18,5532,5550,5528,5536
San Francisco,45,2022-10-24,437,466,466,0,13116,13983,13982,1,35,0,0,5,1067,1069,1067,1069
San Joaquin,45,2022-10-24,265,283,283,0,8139,8687,8686,1,13,0,0,3,2335,2337,2335,2337
San Luis Obispo,45,2022-10-24,84,90,90,0,2028,2162,2161,1,2,0,0,0,525,525,525,525
San Mateo,45,2022-10-24,441,470,470,0,10699,11405,11404,1,19,0,0,2,730,730,730,730
Santa Barbara,45,2022-10-24,152,161,161,0,5697,6073,6072,1,19,2,11,4,732,741,730,730
Santa Clara,45,2022-10-24,1137,1213,1213,0,28146,30005,30004,1,92,0,0,9,2513,2517,2513,2517
Santa Cruz,45,2022-10-24,233,248,248,0,10078,10733,10732,1,14,0,0,0,274,275,274,275
Shasta,45,2022-10-24,71,75,75,0,944,1009,1008,1,5,0,0,2,590,591,590,591
Siskiyou,45,2022-10-24,12,12,12,0,169,181,180,1,0,0,0,0,94,95,94,95
Solano,45,2022-10-24,233,250,250,0,4972,5310,5309,1,20,0,0,1,459,462,459,462
Sonoma,45,2022-10-24,241,258,258,0,5398,5758,5757,1,23,0,0,1,524,525,524,525
Stanislaus,45,2022-10-24,192,204,204,0,4804,5126,5125,1,40,0,0,3,1781,1781,1781,1781
Sutter,45,2022-10-24,27,29,29,0,879,938,937,1,0,0,0,0,232,232,232,232
Tehama,45,2022-10-24,33,33,33,0,360,384,383,1,1,0,0,0,215,215,215,215
Trinity,45,2022-10-24,1,1,1,0,35,37,36,1,0,0,0,0,20,20,20,20
Tulare,45,2022-10-24,106,115,115,0,4315,4607,4606,1,16,0,0,1,1541,1543,1541,1543
Tuolumne,45,2022-10-24,28,28,28,0,620,663,662,1,1,0,0,0,193,193,193,193
Ventura,45,2022-10-24,276,293,293,0,8982,9575,9574,1,40,2,6,6,1582,1590,1580,1584
Yolo,45,2022-10-24,84,91,91,0,2001,2138,2137,1,5,1,3,0,353,358,352,355
Yuba,45,2022-10-24,46,49,49,0,791,845,844,1,5,0,0,1,120,120,120,120
Alameda,46,2022-10-31,776,2543,2543,0,19489,46897,46896,1,57,1,9,4,2043,2067,2042,2058
Amador,46,2022-10-31,12,66,66,0,480,1071,1070,1,2,1,14,0,95,108,94,94
Butte,46,2022-10-31,51,101,101,0,1272,3012,3011,1,11,0,0,3,461,465,461,465
Calaveras,46,2022-10-31,10,33,33,0,226,916,915,1,0,0,0,0,135,135,135,135
Colusa,46,2022-10-31,9,11,11,0,76,164,163,1,0,0,0,0,22,22,22,22
Contra Costa,46,2022-10-31,560,1841,1841,0,11658,28609,28608,1,37,0,0,7,1460,1465,1460,1465
Del Norte,46,2022-10-31,15,37,37,0,308,791,790,1,1,0,0,0,55,55,55,55
El Dorado,46,2022-10-31,76,172,172,0,1177,2956,2955,1,2,0,0,0,230,230,230,230
Fresno,46,2022-10-31,292,827,827,0,8398,20212,20211,1,57,0,0,8,2882,2883,2882,2883
Glenn,46,2022-10-31,8,27,27,0,79,216,215,1,1,0,0,0,42,42,42,42
Humboldt,46,2022-10-31,32,67,67,0,869,2018,2017,1,6,0,0,2,160,160,160,160
Imperial,46,2022-10-31,99,263,263,0,2417,8007,8006,1,7,0,0,0,960,960,960,960
Inyo,46,2022-10-31,6,10,10,0,232,577,576,1,0,0,0,0,60,60,60,60
Kern,46,2022-10-31,227,501,501,0,7587,13740,13739,1,20,0,0,2,2422,2422,2422,2422
Kings,46,2022-10-31,108,219,219,0,2080,4289,4288,1,3,0,0,1,459,459,459,459
Lake,46,2022-10-31,23,94,94,0,645,2011,2010,1,1,0,0,1,147,147,147,147
Lassen,46,2022-10-31,13,29,29,0,421,680,679,1,1,0,0,0,63,63,63,63
Los Angeles,46,2022-10-31,3858,6221,6221,0,121894,161367,161365,2,344,9,113,44,33729,34050,33720,33937
Madera,46,2022-10-31,40,132,132,0,1189,2852,2851,1,3,0,0,2,371,371,371,371
Marin,46,2022-10-31,112,329,329,0,2866,6236,6235,1,10,0,0,1,314,314,314,314
Mariposa,46,2022-10-31,8,11,11,0,115,179,178,1,0,0,0,0,30,30,30,30
Mendocino,46,2022-10-31,18,27,27,0,633,2008,2007,1,1,0,0,2,137,137,137,137
Merced,46,2022-10-31,74,196,196,0,1551,3522,3521,1,5,0,0,0,870,873,870,873
Modoc,46,2022-10-31,1,1,1,0,11,13,12,1,0,0,0,0,9,9,9,9
Mono,46,2022-10-31,1,1,1,0,80,280,279,1,1,0,0,0,7,7,7,7
Monterey,46,2022-10-31,82,156,156,0,2985,7307,7306,1,18,0,0,0,770,771,770,771
Napa,46,2022-10-31,32,131,131,0,1282,3701,3700,1,2,0,0,0,158,158,158,158
Nevada,46,2022-10-31,22,45,45,0,548,986,985,1,6,0,0,0,132,132,132,132
Orange,46,2022-10-31,862,1896,1896,0,21099,46808,46807,1,91,0,0,14,7520,7556,7520,7556
Placer,46,2022-10-31,101,227,227,0,2273,5846,5845,1,40,0,0,5,662,662,662,662
Plumas,46,2022-10-31,5,19,19,0,66,246,245,1,0,0,0,0,13,13,13,13
Riverside,46,2022-10-31,673,2019,2019,0,14511,30889,30888,1,64,2,36,5,6627,6664,6625,6628
Sacramento,46,2022-10-31,591,1684,1684,0,11591,27346,27345,1,80,1,11,16,3346,3367,3345,3356
San Benito,46,2022-10-31,29,100,100,0,345,819,818,1,1,0,0,1,102,103,102,103
San Bernardino,46,2022-10-31,665,1236,1236,0,15586,30580,30579,1,64,0,0,11,8080,8091,8080,8091
San Diego,46,2022-10-31,1321,2777,2777,0,34145,74067,74066,1,109,0,0,13,5532,5550,5532,5550
San Francisco,46,2022-10-31,435,1347,1347,0,11893,27825,27823,2,45,0,0,3,1067,1069,1067,1069
San Joaquin,46,2022-10-31,246,726,726,0,6634,15882,15881,1,21,0,0,3,2335,2337,2335,2337
San Luis Obispo,46,2022-10-31,55,113,113,0,1520,3075,3074,1,1,0,0,0,525,525,525,525
San Mateo,46,2022-10-31,389,1139,1139,0,9478,23594,23593,1,30,0,0,2,730,730,730,730
Santa Barbara,46,2022-10-31,130,250,250,0,4870,10713,10712,1,20,0,0,6,732,741,732,741
Santa Clara,46,2022-10-31,924,2617,2617,0,24220,51861,51860,1,85,0,0,16,2513,2517,2513,2517
Santa Cruz,46,2022-10-31,107,186,186,0,7257,10129,10128,1,7,0,0,0,274,275,274,275
Shasta,46,2022-10-31,33,49,49,0,605,1105,1104,1,6,0,0,1,590,591,590,591
Siskiyou,46,2022-10-31,14,50,50,0,190,522,521,1,1,0,0,0,94,95,94,95
Solano,46,2022-10-31,271,948,948,0,4416,13251,13250,1,16,0,0,4,459,462,459,462
Sonoma,46,2022-10-31,166,527,527,0,4881,12545,12544,1,24,0,0,3,524,525,524,525
Stanislaus,46,2022-10-31,170,424,424,0,4135,11006,11005,1,49,0,0,8,1781,1781,1781,1781
Sutter,46,2022-10-31,48,173,173,0,799,2036,2035,1,0,0,0,0,232,232,232,232
Tehama,46,2022-10-31,8,9,9,0,255,404,403,1,1,0,0,0,215,215,215,215
Trinity,46,2022-10-31,15,30,30,0,65,129,128,1,5,0,0,0,20,20,20,20
Tulare,46,2022-10-31,90,202,202,0,2728,5367,5366,1,12,0,0,0,1541,1543,1541,1543
Tuolumne,46,2022-10-31,14,31,31,0,449,1117,1116,1,3,0,0,0,193,193,193,193
Ventura,46,2022-10-31,243,472,472,0,7658,17870,17869,1,24,0,0,2,1582,1590,1582,1590
Yolo,46,2022-10-31,47,169,169,0,1415,3279,3278,1,3,0,0,1,353,358,353,358
Yuba,46,2022-10-31,34,71,71,0,664,1769,1768,1,3,0,0,0,120,120,120,120
