county,time,date,cases,est_cases,est_omicron_cases,est_other_cases,tests,est_tests,est_omicron_tests,est_other_tests,hospitalizations
Alameda,1,2021-12-25,5374,5398,4327,1071,81840,82189,64944,17245,117
Amador,1,2021-12-25,75,75,60,15,1446,1451,1141,310,4
Butte,1,2021-12-25,347,347,281,66,3764,3780,2973,807,31
Calaveras,1,2021-12-25,72,72,57,15,951,955,745,210,2
Colusa,1,2021-12-25,14,14,11,3,234,234,184,50,2
Contra Costa,1,2021-12-25,3225,3239,2603,636,42509,42690,33753,8937,66
Del Norte,1,2021-12-25,20,20,16,4,1186,1191,940,251,0
El Dorado,1,2021-12-25,384,384,310,74,4034,4050,3186,864,12
Fresno,1,2021-12-25,1513,1519,1222,297,22188,22283,17630,4653,168
Glenn,1,2021-12-25,37,37,30,7,408,409,316,93,0
Humboldt,1,2021-12-25,334,334,273,61,3063,3076,2399,677,11
Imperial,1,2021-12-25,657,658,522,136,5293,5315,4205,1110,51
Inyo,1,2021-12-25,81,81,67,14,414,414,329,85,0
Kern,1,2021-12-25,1202,1208,969,239,19106,19187,15123,4064,99
Kings,1,2021-12-25,351,351,282,69,5196,5218,4104,1114,20
Lake,1,2021-12-25,43,43,35,8,1128,1132,896,236,0
Lassen,1,2021-12-25,19,19,15,4,2174,2183,1724,459,0
Los Angeles,1,2021-12-25,66198,66483,53523,12960,674369,677243,536728,140515,1005
Madera,1,2021-12-25,207,207,168,39,4072,4090,3212,878,18
Marin,1,2021-12-25,1158,1164,933,231,14227,14289,11410,2879,6
Mariposa,1,2021-12-25,31,31,25,6,499,501,400,101,0
Mendocino,1,2021-12-25,86,86,69,17,2477,2488,1947,541,6
Merced,1,2021-12-25,428,428,341,87,4775,4796,3755,1041,18
Modoc,1,2021-12-25,5,5,4,1,54,54,42,12,2
Mono,1,2021-12-25,93,93,76,17,356,357,283,74,1
Monterey,1,2021-12-25,710,712,576,136,12055,12107,9580,2527,36
Napa,1,2021-12-25,559,560,455,105,5496,5519,4420,1099,5
Nevada,1,2021-12-25,204,204,162,42,2460,2470,1928,542,6
Orange,1,2021-12-25,10758,10805,8743,2062,105053,105502,83919,21583,274
Placer,1,2021-12-25,917,922,740,182,10154,10197,8008,2189,92
Plumas,1,2021-12-25,10,10,8,2,379,380,296,84,0
Riverside,1,2021-12-25,9287,9327,7496,1831,75387,75708,59707,16001,389
Sacramento,1,2021-12-25,3363,3377,2714,663,46841,47040,37123,9917,180
San Benito,1,2021-12-25,199,199,159,40,2015,2025,1599,426,5
San Bernardino,1,2021-12-25,8776,8814,7094,1720,78348,78681,62256,16425,449
San Diego,1,2021-12-25,17460,17535,14082,3453,154044,154700,122327,32373,371
San Francisco,1,2021-12-25,5632,5655,4516,1139,61272,61532,48863,12669,36
San Joaquin,1,2021-12-25,1556,1562,1259,303,20375,20463,16141,4322,78
San Luis Obispo,1,2021-12-25,721,724,580,144,9955,9997,7882,2115,22
San Mateo,1,2021-12-25,3539,3554,2876,678,49146,49356,39274,10082,30
Santa Barbara,1,2021-12-25,1415,1421,1148,273,13610,13668,10768,2900,37
Santa Clara,1,2021-12-25,6171,6198,5002,1196,96007,96415,76144,20271,134
Santa Cruz,1,2021-12-25,655,656,530,126,11430,11478,9046,2432,14
Shasta,1,2021-12-25,194,194,155,39,4466,4485,3494,991,37
Siskiyou,1,2021-12-25,15,15,12,3,342,342,269,73,0
Solano,1,2021-12-25,842,845,682,163,14672,14735,11749,2986,44
Sonoma,1,2021-12-25,1324,1330,1072,258,18707,18785,14834,3951,16
Stanislaus,1,2021-12-25,882,888,713,175,10207,10250,8041,2209,116
Sutter,1,2021-12-25,175,175,139,36,1984,1993,1568,425,0
Tehama,1,2021-12-25,64,64,52,12,1031,1035,814,221,11
Trinity,1,2021-12-25,2,2,2,0,95,95,75,20,0
Tulare,1,2021-12-25,561,561,451,110,10120,10163,7954,2209,48
Tuolumne,1,2021-12-25,133,133,108,25,1695,1702,1341,361,5
Ventura,1,2021-12-25,3576,3591,2888,703,33606,33749,26590,7159,83
Yolo,1,2021-12-25,544,544,438,106,19681,19764,15531,4233,8
Yuba,1,2021-12-25,116,116,93,23,1477,1483,1163,320,13
Alameda,2,2022-01-01,13959,14027,12998,1029,100947,101435,93858,7577,181
Amador,2,2022-01-01,148,148,137,11,1811,1819,1685,134,8
Butte,2,2022-01-01,885,891,826,65,5573,5600,5179,421,30
Calaveras,2,2022-01-01,167,167,155,12,1134,1139,1053,86,3
Colusa,2,2022-01-01,50,50,46,4,295,295,273,22,4
Contra Costa,2,2022-01-01,11121,11173,10352,821,59096,59382,54962,4420,113
Del Norte,2,2022-01-01,61,61,57,4,1911,1921,1777,144,0
El Dorado,2,2022-01-01,996,1001,929,72,5265,5292,4901,391,17
Fresno,2,2022-01-01,4902,4924,4566,358,34367,34533,31989,2544,209
Glenn,2,2022-01-01,68,68,63,5,514,515,475,40,0
Humboldt,2,2022-01-01,717,721,667,54,4595,4617,4269,348,10
Imperial,2,2022-01-01,1476,1483,1373,110,8043,8081,7483,598,57
Inyo,2,2022-01-01,207,207,192,15,594,597,554,43,3
Kern,2,2022-01-01,4272,4293,3982,311,29356,29497,27281,2216,126
Kings,2,2022-01-01,862,868,804,64,7270,7306,6764,542,17
Lake,2,2022-01-01,144,144,134,10,1445,1450,1343,107,2
Lassen,2,2022-01-01,45,45,42,3,2372,2383,2204,179,2
Los Angeles,2,2022-01-01,174964,175809,162857,12952,926753,931230,862263,68967,1933
Madera,2,2022-01-01,661,665,616,49,5600,5628,5206,422,19
Marin,2,2022-01-01,2205,2217,2048,169,17442,17525,16180,1345,25
Mariposa,2,2022-01-01,73,73,68,5,531,533,494,39,0
Mendocino,2,2022-01-01,325,325,301,24,2883,2898,2679,219,6
Merced,2,2022-01-01,1226,1231,1139,92,7286,7320,6774,546,22
Modoc,2,2022-01-01,11,11,10,1,51,51,47,4,0
Mono,2,2022-01-01,170,170,157,13,382,383,354,29,2
Monterey,2,2022-01-01,1944,1954,1812,142,17292,17375,16098,1277,29
Napa,2,2022-01-01,1516,1525,1413,112,10031,10079,9339,740,10
Nevada,2,2022-01-01,468,468,435,33,2135,2146,1992,154,6
Orange,2,2022-01-01,39367,39557,36661,2896,197676,198631,183946,14685,540
Placer,2,2022-01-01,2388,2399,2225,174,13827,13892,12854,1038,142
Plumas,2,2022-01-01,35,35,33,2,326,326,302,24,2
Riverside,2,2022-01-01,26626,26754,24790,1964,124251,124850,115542,9308,578
Sacramento,2,2022-01-01,11258,11312,10488,824,70239,70579,65346,5233,271
San Benito,2,2022-01-01,598,601,556,45,2950,2963,2741,222,5
San Bernardino,2,2022-01-01,27592,27725,25679,2046,121169,121754,112729,9025,668
San Diego,2,2022-01-01,53174,53431,49483,3948,227299,228395,211347,17048,645
San Francisco,2,2022-01-01,9734,9780,9057,723,74064,74421,68888,5533,89
San Joaquin,2,2022-01-01,5495,5522,5126,396,31681,31834,29479,2355,98
San Luis Obispo,2,2022-01-01,2117,2128,1968,160,14443,14511,13419,1092,19
San Mateo,2,2022-01-01,8987,9030,8363,667,66249,66568,61618,4950,41
Santa Barbara,2,2022-01-01,4170,4190,3883,307,21955,22060,20427,1633,57
Santa Clara,2,2022-01-01,17615,17700,16416,1284,131933,132571,122722,9849,224
Santa Cruz,2,2022-01-01,1860,1868,1733,135,15116,15190,14054,1136,21
Shasta,2,2022-01-01,438,438,406,32,5327,5352,4946,406,13
Siskiyou,2,2022-01-01,57,57,53,4,417,417,385,32,0
Solano,2,2022-01-01,3514,3532,3276,256,23503,23616,21871,1745,77
Sonoma,2,2022-01-01,3679,3697,3425,272,27502,27635,25549,2086,30
Stanislaus,2,2022-01-01,2635,2648,2457,191,15778,15855,14669,1186,129
Sutter,2,2022-01-01,396,396,367,29,2597,2609,2414,195,0
Tehama,2,2022-01-01,169,169,157,12,1162,1167,1079,88,4
Trinity,2,2022-01-01,8,8,7,1,101,101,94,7,0
Tulare,2,2022-01-01,1602,1609,1492,117,14257,14326,13246,1080,55
Tuolumne,2,2022-01-01,284,284,264,20,1866,1875,1736,139,6
Ventura,2,2022-01-01,11370,11425,10579,846,55123,55388,51222,4166,129
Yolo,2,2022-01-01,1589,1597,1480,117,24898,25017,23113,1904,10
Yuba,2,2022-01-01,358,358,333,25,2027,2038,1887,151,22
Alameda,3,2022-01-08,31019,31182,30053,1129,187616,188598,181731,6867,338
Amador,3,2022-01-08,373,373,359,14,2704,2718,2616,102,6
Butte,3,2022-01-08,1929,1941,1870,71,9865,9917,9549,368,47
Calaveras,3,2022-01-08,455,456,440,16,2411,2423,2334,89,2
Colusa,3,2022-01-08,80,80,77,3,641,644,620,24,5
Contra Costa,3,2022-01-08,18888,18987,18290,697,101056,101584,97872,3712,204
Del Norte,3,2022-01-08,161,161,155,6,3792,3812,3681,131,2
El Dorado,3,2022-01-08,2120,2132,2054,78,8745,8790,8468,322,18
Fresno,3,2022-01-08,11985,12047,11617,430,57338,57638,55553,2085,306
Glenn,3,2022-01-08,181,181,175,6,865,870,838,32,2
Humboldt,3,2022-01-08,1415,1422,1370,52,8152,8195,7895,300,16
Imperial,3,2022-01-08,3420,3437,3311,126,13518,13588,13088,500,74
Inyo,3,2022-01-08,392,392,377,15,1234,1241,1196,45,4
Kern,3,2022-01-08,10945,11001,10598,403,54117,54398,52384,2014,191
Kings,3,2022-01-08,1946,1958,1887,71,11683,11744,11313,431,22
Lake,3,2022-01-08,455,456,439,17,2648,2662,2564,98,2
Lassen,3,2022-01-08,118,118,114,4,3417,3435,3305,130,2
Los Angeles,3,2022-01-08,333276,335019,322868,12151,2058996,2069771,1995069,74702,3510
Madera,3,2022-01-08,1702,1711,1650,61,9926,9977,9608,369,29
Marin,3,2022-01-08,3065,3082,2968,114,21343,21455,20664,791,30
Mariposa,3,2022-01-08,180,180,173,7,1099,1104,1064,40,0
Mendocino,3,2022-01-08,800,806,776,30,5426,5455,5251,204,7
Merced,3,2022-01-08,3158,3175,3059,116,13143,13210,12724,486,39
Modoc,3,2022-01-08,16,16,15,1,92,92,89,3,0
Mono,3,2022-01-08,261,261,251,10,841,845,814,31,1
Monterey,3,2022-01-08,4405,4428,4268,160,31733,31899,30729,1170,65
Napa,3,2022-01-08,2690,2705,2605,100,14681,14757,14210,547,15
Nevada,3,2022-01-08,1103,1109,1069,40,4818,4843,4665,178,15
Orange,3,2022-01-08,61437,61757,59484,2273,309972,311592,300205,11387,934
Placer,3,2022-01-08,4814,4840,4665,175,20985,21095,20324,771,180
Plumas,3,2022-01-08,102,102,98,4,739,744,716,28,4
Riverside,3,2022-01-08,47548,47796,46037,1759,182980,183936,177165,6771,893
Sacramento,3,2022-01-08,25802,25937,24994,943,117517,118131,113800,4331,424
San Benito,3,2022-01-08,967,972,935,37,4221,4244,4085,159,6
San Bernardino,3,2022-01-08,46553,46796,45085,1711,185797,186768,179964,6804,961
San Diego,3,2022-01-08,85913,86363,83176,3187,338797,340566,328014,12552,986
San Francisco,3,2022-01-08,16416,16503,15893,610,119823,120448,116037,4411,158
San Joaquin,3,2022-01-08,12902,12971,12501,470,58119,58423,56293,2130,158
San Luis Obispo,3,2022-01-08,4275,4297,4139,158,21408,21519,20724,795,41
San Mateo,3,2022-01-08,14762,14839,14290,549,110543,111121,107000,4121,109
Santa Barbara,3,2022-01-08,8320,8364,8054,310,44671,44905,43253,1652,77
Santa Clara,3,2022-01-08,35116,35299,33998,1301,255266,256600,247161,9439,432
Santa Cruz,3,2022-01-08,4351,4374,4214,160,41275,41491,39967,1524,18
Shasta,3,2022-01-08,993,999,962,37,8091,8132,7826,306,57
Siskiyou,3,2022-01-08,106,106,102,4,849,854,822,32,5
Solano,3,2022-01-08,6555,6589,6352,237,34778,34961,33691,1270,103
Sonoma,3,2022-01-08,8363,8407,8100,307,45508,45746,44050,1696,73
Stanislaus,3,2022-01-08,5968,5999,5783,216,26391,26528,25555,973,184
Sutter,3,2022-01-08,1083,1089,1050,39,4612,4637,4466,171,0
Tehama,3,2022-01-08,454,455,439,16,2363,2375,2287,88,12
Trinity,3,2022-01-08,33,33,32,1,263,263,254,9,0
Tulare,3,2022-01-08,4244,4266,4112,154,21930,22045,21233,812,65
Tuolumne,3,2022-01-08,703,707,681,26,3950,3970,3823,147,14
Ventura,3,2022-01-08,17620,17712,17062,650,85833,86282,83120,3162,233
Yolo,3,2022-01-08,3836,3856,3713,143,49728,49987,48126,1861,8
Yuba,3,2022-01-08,925,931,898,33,3759,3778,3641,137,35
Alameda,4,2022-01-15,26980,27139,26761,378,182545,183630,181073,2557,442
Amador,4,2022-01-15,490,491,484,7,3770,3792,3738,54,9
Butte,4,2022-01-15,2114,2126,2096,30,9563,9619,9479,140,58
Calaveras,4,2022-01-15,613,617,608,9,2693,2709,2671,38,5
Colusa,4,2022-01-15,167,167,165,2,776,781,770,11,2
Contra Costa,4,2022-01-15,16560,16659,16424,235,94608,95171,93840,1331,261
Del Norte,4,2022-01-15,202,202,199,3,3903,3926,3870,56,3
El Dorado,4,2022-01-15,2179,2192,2160,32,8896,8948,8819,129,16
Fresno,4,2022-01-15,16760,16862,16634,228,67087,67487,66563,924,446
Glenn,4,2022-01-15,305,305,301,4,1052,1057,1042,15,2
Humboldt,4,2022-01-15,1260,1267,1249,18,8780,8832,8707,125,37
Imperial,4,2022-01-15,3728,3750,3696,54,14031,14113,13913,200,94
Inyo,4,2022-01-15,395,397,391,6,1229,1236,1218,18,3
Kern,4,2022-01-15,13105,13182,12992,190,58104,58447,57601,846,264
Kings,4,2022-01-15,3507,3528,3478,50,16358,16455,16225,230,46
Lake,4,2022-01-15,590,594,586,8,3160,3180,3137,43,4
Lassen,4,2022-01-15,277,277,273,4,3592,3613,3561,52,1
Los Angeles,4,2022-01-15,249617,251097,247533,3564,1987097,1998923,1971407,27516,4673
Madera,4,2022-01-15,2439,2454,2420,34,10989,11054,10899,155,38
Marin,4,2022-01-15,2672,2689,2651,38,19099,19212,18942,270,37
Mariposa,4,2022-01-15,189,189,186,3,1222,1228,1211,17,0
Mendocino,4,2022-01-15,983,989,975,14,5543,5576,5496,80,25
Merced,4,2022-01-15,4143,4168,4109,59,14711,14798,14587,211,53
Modoc,4,2022-01-15,10,10,10,0,107,107,105,2,0
Mono,4,2022-01-15,235,235,232,3,854,860,848,12,1
Monterey,4,2022-01-15,5982,6017,5935,82,29772,29948,29525,423,75
Napa,4,2022-01-15,2193,2207,2175,32,13227,13305,13113,192,24
Nevada,4,2022-01-15,1321,1327,1308,19,5645,5678,5597,81,23
Orange,4,2022-01-15,47132,47410,46725,685,279095,280750,276763,3987,1223
Placer,4,2022-01-15,4752,4780,4711,69,21039,21163,20858,305,222
Plumas,4,2022-01-15,159,159,157,2,748,753,742,11,4
Riverside,4,2022-01-15,45452,45721,45068,653,180111,181180,178620,2560,1047
Sacramento,4,2022-01-15,22342,22475,22155,320,109217,109864,108299,1565,545
San Benito,4,2022-01-15,948,954,939,15,4320,4344,4279,65,8
San Bernardino,4,2022-01-15,41337,41581,40984,597,178722,179784,177264,2520,1145
San Diego,4,2022-01-15,67404,67803,66835,968,282837,284513,280501,4012,1230
San Francisco,4,2022-01-15,11912,11982,11814,168,98994,99584,98196,1388,243
San Joaquin,4,2022-01-15,14326,14409,14201,208,63447,63823,62904,919,245
San Luis Obispo,4,2022-01-15,4118,4143,4084,59,22097,22229,21912,317,44
San Mateo,4,2022-01-15,13797,13878,13678,200,105472,106096,104571,1525,126
Santa Barbara,4,2022-01-15,7589,7633,7521,112,43862,44121,43485,636,123
Santa Clara,4,2022-01-15,31897,32086,31622,464,246154,247610,244059,3551,516
Santa Cruz,4,2022-01-15,4304,4329,4268,61,44546,44812,44189,623,35
Shasta,4,2022-01-15,1313,1320,1302,18,9534,9591,9453,138,83
Siskiyou,4,2022-01-15,158,158,156,2,1019,1024,1008,16,5
Solano,4,2022-01-15,7075,7117,7021,96,37608,37833,37319,514,146
Sonoma,4,2022-01-15,8129,8177,8060,117,45694,45962,45302,660,96
Stanislaus,4,2022-01-15,7664,7711,7602,109,30251,30431,29994,437,234
Sutter,4,2022-01-15,1375,1383,1363,20,5042,5070,4996,74,0
Tehama,4,2022-01-15,634,639,630,9,2583,2599,2562,37,15
Trinity,4,2022-01-15,42,42,41,1,272,272,268,4,0
Tulare,4,2022-01-15,7455,7500,7395,105,27519,27682,27289,393,98
Tuolumne,4,2022-01-15,940,947,934,13,4353,4379,4317,62,9
Ventura,4,2022-01-15,13860,13941,13738,203,75083,75528,74437,1091,346
Yolo,4,2022-01-15,3034,3052,3007,45,42987,43242,42627,615,18
Yuba,4,2022-01-15,1105,1111,1095,16,3954,3978,3921,57,57
Alameda,5,2022-01-22,20439,20583,20540,43,158340,159453,159132,321,484
Amador,5,2022-01-22,561,564,563,1,4292,4323,4315,8,11
Butte,5,2022-01-22,1952,1966,1962,4,8622,8682,8663,19,88
Calaveras,5,2022-01-22,594,599,598,1,2413,2430,2425,5,7
Colusa,5,2022-01-22,160,160,160,0,786,792,790,2,5
Contra Costa,5,2022-01-22,13256,13349,13320,29,80223,80787,80622,165,331
Del Norte,5,2022-01-22,300,300,299,1,3768,3795,3787,8,2
El Dorado,5,2022-01-22,1550,1562,1559,3,7110,7160,7145,15,28
Fresno,5,2022-01-22,17451,17573,17537,36,66931,67402,67265,137,578
Glenn,5,2022-01-22,252,252,251,1,919,925,923,2,0
Humboldt,5,2022-01-22,982,989,987,2,7343,7395,7379,16,22
Imperial,5,2022-01-22,3518,3543,3536,7,12510,12598,12572,26,85
Inyo,5,2022-01-22,158,158,158,0,599,603,602,1,1
Kern,5,2022-01-22,10648,10723,10700,23,49225,49570,49468,102,322
Kings,5,2022-01-22,4084,4113,4104,9,16737,16855,16821,34,43
Lake,5,2022-01-22,683,688,687,1,3148,3171,3164,7,9
Lassen,5,2022-01-22,422,424,423,1,3275,3298,3291,7,1
Los Angeles,5,2022-01-22,171877,173082,172718,364,1721869,1733998,1730717,3281,4730
Madera,5,2022-01-22,2774,2795,2789,6,11230,11309,11285,24,58
Marin,5,2022-01-22,1957,1970,1966,4,16761,16879,16844,35,60
Mariposa,5,2022-01-22,149,149,149,0,938,944,942,2,0
Mendocino,5,2022-01-22,962,969,967,2,4789,4823,4813,10,22
Merced,5,2022-01-22,3176,3198,3191,7,12220,12305,12279,26,65
Modoc,5,2022-01-22,16,16,16,0,101,102,101,1,0
Mono,5,2022-01-22,98,98,98,0,462,464,463,1,1
Monterey,5,2022-01-22,5265,5301,5289,12,30975,31193,31128,65,108
Napa,5,2022-01-22,1701,1713,1709,4,11646,11727,11703,24,24
Nevada,5,2022-01-22,1047,1053,1051,2,4683,4716,4706,10,26
Orange,5,2022-01-22,30017,30227,30159,68,222873,224439,223985,454,1181
Placer,5,2022-01-22,3828,3856,3848,8,17895,18022,17984,38,275
Plumas,5,2022-01-22,213,213,213,0,829,835,833,2,6
Riverside,5,2022-01-22,33706,33943,33869,74,153535,154613,154292,321,1096
Sacramento,5,2022-01-22,17119,17238,17201,37,92566,93215,93022,193,654
San Benito,5,2022-01-22,856,862,860,2,3844,3870,3861,9,8
San Bernardino,5,2022-01-22,27760,27954,27894,60,144745,145764,145471,293,1235
San Diego,5,2022-01-22,54007,54385,54270,115,242907,244615,244111,504,1348
San Francisco,5,2022-01-22,8984,9047,9026,21,85214,85813,85634,179,291
San Joaquin,5,2022-01-22,11338,11418,11394,24,52994,53365,53252,113,308
San Luis Obispo,5,2022-01-22,3596,3621,3613,8,20295,20437,20394,43,51
San Mateo,5,2022-01-22,9057,9121,9100,21,87112,87725,87546,179,177
Santa Barbara,5,2022-01-22,6556,6603,6588,15,39809,40088,40003,85,142
Santa Clara,5,2022-01-22,23721,23887,23835,52,214120,215623,215176,447,546
Santa Cruz,5,2022-01-22,5148,5183,5173,10,47999,48340,48256,84,43
Shasta,5,2022-01-22,1448,1459,1456,3,9274,9340,9320,20,87
Siskiyou,5,2022-01-22,155,155,155,0,800,804,802,2,6
Solano,5,2022-01-22,5066,5102,5092,10,29981,30192,30133,59,166
Sonoma,5,2022-01-22,7174,7224,7208,16,40133,40414,40329,85,106
Stanislaus,5,2022-01-22,6693,6740,6725,15,27245,27436,27377,59,315
Sutter,5,2022-01-22,1117,1124,1122,2,4887,4920,4909,11,0
Tehama,5,2022-01-22,586,591,590,1,2375,2392,2387,5,20
Trinity,5,2022-01-22,64,64,64,0,309,310,309,1,0
Tulare,5,2022-01-22,7243,7292,7276,16,27818,28013,27954,59,136
Tuolumne,5,2022-01-22,892,899,897,2,3516,3541,3534,7,17
Ventura,5,2022-01-22,9886,9956,9934,22,63211,63655,63526,129,362
Yolo,5,2022-01-22,2262,2279,2274,5,37476,37739,37662,77,24
Yuba,5,2022-01-22,939,945,943,2,3674,3700,3692,8,68
Alameda,6,2022-01-29,12504,12605,12604,1,139549,140685,140675,10,451
Amador,6,2022-01-29,363,365,365,0,3211,3239,3238,1,19
Butte,6,2022-01-29,1277,1288,1288,0,7817,7880,7879,1,102
Calaveras,6,2022-01-29,281,282,282,0,1885,1901,1900,1,4
Colusa,6,2022-01-29,117,117,117,0,668,674,673,1,2
Contra Costa,6,2022-01-29,8334,8403,8402,1,71195,71775,71770,5,295
Del Norte,6,2022-01-29,359,361,361,0,4066,4099,4098,1,9
El Dorado,6,2022-01-29,842,849,849,0,6052,6104,6103,1,20
Fresno,6,2022-01-29,12085,12184,12183,1,57605,58075,58071,4,603
Glenn,6,2022-01-29,209,209,209,0,751,758,757,1,4
Humboldt,6,2022-01-29,618,624,624,0,6033,6083,6082,1,26
Imperial,6,2022-01-29,2535,2555,2555,0,11974,12071,12070,1,103
Inyo,6,2022-01-29,66,66,66,0,491,496,495,1,4
Kern,6,2022-01-29,6388,6441,6440,1,42634,42982,42979,3,309
Kings,6,2022-01-29,2777,2800,2800,0,14829,14950,14949,1,53
Lake,6,2022-01-29,559,563,563,0,3353,3380,3379,1,10
Lassen,6,2022-01-29,343,345,345,0,3406,3434,3433,1,5
Los Angeles,6,2022-01-29,88371,89089,89082,7,1545501,1558103,1557997,106,3997
Madera,6,2022-01-29,1837,1853,1853,0,9678,9757,9756,1,58
Marin,6,2022-01-29,1226,1236,1236,0,13970,14083,14082,1,48
Mariposa,6,2022-01-29,106,106,106,0,863,871,870,1,0
Mendocino,6,2022-01-29,541,544,544,0,3581,3611,3610,1,14
Merced,6,2022-01-29,2287,2305,2305,0,10768,10855,10854,1,64
Modoc,6,2022-01-29,12,12,12,0,96,97,96,1,2
Mono,6,2022-01-29,42,42,42,0,341,345,344,1,0
Monterey,6,2022-01-29,3805,3837,3837,0,26468,26684,26682,2,121
Napa,6,2022-01-29,1124,1133,1133,0,9671,9750,9749,1,25
Nevada,6,2022-01-29,677,683,683,0,4060,4094,4093,1,30
Orange,6,2022-01-29,14380,14497,14496,1,181986,183467,183454,13,979
Placer,6,2022-01-29,2579,2600,2600,0,15544,15671,15670,1,232
Plumas,6,2022-01-29,152,152,152,0,704,710,709,1,2
Riverside,6,2022-01-29,19177,19333,19331,2,124469,125481,125472,9,1001
Sacramento,6,2022-01-29,11155,11246,11245,1,78956,79598,79592,6,602
San Benito,6,2022-01-29,530,534,534,0,3269,3298,3297,1,7
San Bernardino,6,2022-01-29,15136,15259,15258,1,118940,119911,119903,8,1027
San Diego,6,2022-01-29,29272,29509,29507,2,188930,190466,190451,15,1237
San Francisco,6,2022-01-29,4974,5013,5013,0,73424,74022,74016,6,267
San Joaquin,6,2022-01-29,6539,6592,6591,1,42956,43306,43303,3,312
San Luis Obispo,6,2022-01-29,2314,2333,2333,0,16965,17103,17102,1,67
San Mateo,6,2022-01-29,4935,4975,4975,0,75801,76419,76413,6,161
Santa Barbara,6,2022-01-29,4277,4310,4310,0,35203,35489,35486,3,117
Santa Clara,6,2022-01-29,16093,16224,16223,1,202581,204233,204218,15,554
Santa Cruz,6,2022-01-29,3433,3461,3461,0,46354,46736,46734,2,45
Shasta,6,2022-01-29,1080,1088,1088,0,8512,8580,8579,1,90
Siskiyou,6,2022-01-29,125,125,125,0,689,695,694,1,13
Solano,6,2022-01-29,4215,4250,4250,0,29033,29270,29268,2,175
Sonoma,6,2022-01-29,4194,4228,4228,0,32567,32830,32827,3,103
Stanislaus,6,2022-01-29,4103,4135,4135,0,22203,22383,22381,2,340
Sutter,6,2022-01-29,717,723,723,0,3833,3865,3864,1,0
Tehama,6,2022-01-29,406,409,409,0,2134,2153,2152,1,22
Trinity,6,2022-01-29,38,38,38,0,219,220,219,1,0
Tulare,6,2022-01-29,4969,5009,5009,0,24006,24201,24199,2,152
Tuolumne,6,2022-01-29,825,831,831,0,3325,3354,3353,1,19
Ventura,6,2022-01-29,5571,5616,5616,0,54095,54535,54531,4,321
Yolo,6,2022-01-29,1541,1553,1553,0,36780,37081,37078,3,21
Yuba,6,2022-01-29,611,617,617,0,3009,3034,3033,1,86
Alameda,7,2022-02-05,6816,6881,6881,0,117835,118961,118960,1,378
Amador,7,2022-02-05,239,239,239,0,3005,3033,3032,1,16
Butte,7,2022-02-05,868,877,877,0,6516,6579,6578,1,90
Calaveras,7,2022-02-05,212,212,212,0,1528,1544,1543,1,2
Colusa,7,2022-02-05,91,91,91,0,557,564,563,1,4
Contra Costa,7,2022-02-05,4595,4639,4639,0,56533,57072,57071,1,261
Del Norte,7,2022-02-05,246,246,246,0,3841,3879,3878,1,7
El Dorado,7,2022-02-05,504,509,509,0,5010,5059,5058,1,29
Fresno,7,2022-02-05,7147,7215,7215,0,45078,45510,45509,1,577
Glenn,7,2022-02-05,139,139,139,0,635,643,642,1,4
Humboldt,7,2022-02-05,497,502,502,0,4893,4941,4940,1,22
Imperial,7,2022-02-05,1242,1254,1254,0,8666,8750,8749,1,81
Inyo,7,2022-02-05,52,52,52,0,430,435,434,1,3
Kern,7,2022-02-05,3861,3898,3898,0,34967,35301,35300,1,233
Kings,7,2022-02-05,1515,1529,1529,0,10516,10618,10617,1,57
Lake,7,2022-02-05,386,391,391,0,2708,2736,2735,1,9
Lassen,7,2022-02-05,156,156,156,0,2990,3018,3017,1,5
Los Angeles,7,2022-02-05,43718,44135,44135,0,1397761,1411133,1411132,1,2971
Madera,7,2022-02-05,1251,1263,1263,0,8247,8326,8325,1,56
Marin,7,2022-02-05,721,728,728,0,11789,11902,11901,1,33
Mariposa,7,2022-02-05,56,56,56,0,620,626,625,1,0
Mendocino,7,2022-02-05,353,357,357,0,2958,2988,2987,1,18
Merced,7,2022-02-05,1342,1356,1356,0,8215,8295,8294,1,64
Modoc,7,2022-02-05,22,22,22,0,158,160,159,1,3
Mono,7,2022-02-05,46,46,46,0,268,270,269,1,0
Monterey,7,2022-02-05,2481,2504,2504,0,22638,22854,22853,1,96
Napa,7,2022-02-05,789,797,797,0,7853,7928,7927,1,23
Nevada,7,2022-02-05,393,397,397,0,3201,3233,3232,1,27
Orange,7,2022-02-05,7333,7402,7402,0,152552,154010,154009,1,640
Placer,7,2022-02-05,1523,1537,1537,0,12456,12576,12575,1,201
Plumas,7,2022-02-05,96,96,96,0,540,547,546,1,1
Riverside,7,2022-02-05,9502,9592,9592,0,97295,98223,98222,1,759
Sacramento,7,2022-02-05,6574,6637,6637,0,63744,64353,64352,1,525
San Benito,7,2022-02-05,338,342,342,0,2712,2738,2737,1,8
San Bernardino,7,2022-02-05,7808,7883,7883,0,90765,91633,91632,1,742
San Diego,7,2022-02-05,15688,15838,15838,0,153438,154905,154904,1,1017
San Francisco,7,2022-02-05,2647,2671,2671,0,55938,56473,56472,1,233
San Joaquin,7,2022-02-05,3829,3865,3865,0,36252,36598,36597,1,256
San Luis Obispo,7,2022-02-05,1432,1446,1446,0,13049,13174,13173,1,41
San Mateo,7,2022-02-05,2848,2876,2876,0,60566,61146,61145,1,134
Santa Barbara,7,2022-02-05,2709,2735,2735,0,32177,32484,32483,1,105
Santa Clara,7,2022-02-05,9223,9310,9310,0,169320,170935,170934,1,481
Santa Cruz,7,2022-02-05,2064,2083,2083,0,38772,39144,39143,1,38
Shasta,7,2022-02-05,730,737,737,0,7054,7121,7120,1,81
Siskiyou,7,2022-02-05,103,103,103,0,691,698,697,1,8
Solano,7,2022-02-05,2570,2594,2594,0,23768,23995,23994,1,135
Sonoma,7,2022-02-05,2316,2338,2338,0,26921,27178,27177,1,80
Stanislaus,7,2022-02-05,2811,2838,2838,0,18972,19153,19152,1,300
Sutter,7,2022-02-05,430,435,435,0,3366,3399,3398,1,0
Tehama,7,2022-02-05,326,330,330,0,1697,1715,1714,1,24
Trinity,7,2022-02-05,24,24,24,0,148,149,148,1,0
Tulare,7,2022-02-05,2959,2987,2987,0,18166,18340,18339,1,165
Tuolumne,7,2022-02-05,405,408,408,0,2593,2618,2617,1,13
Ventura,7,2022-02-05,3004,3033,3033,0,42188,42591,42590,1,249
Yolo,7,2022-02-05,923,931,931,0,31607,31910,31909,1,14
Yuba,7,2022-02-05,389,394,394,0,2462,2486,2485,1,60
Alameda,8,2022-02-12,4006,4050,4050,0,98863,99953,99952,1,289
Amador,8,2022-02-12,112,112,112,0,2373,2400,2399,1,15
Butte,8,2022-02-12,537,544,544,0,5453,5513,5512,1,78
Calaveras,8,2022-02-12,114,114,114,0,1272,1287,1286,1,6
Colusa,8,2022-02-12,46,46,46,0,508,515,514,1,3
Contra Costa,8,2022-02-12,2741,2771,2771,0,45438,45940,45939,1,189
Del Norte,8,2022-02-12,257,259,259,0,3615,3655,3654,1,9
El Dorado,8,2022-02-12,310,314,314,0,4533,4583,4582,1,25
Fresno,8,2022-02-12,4258,4305,4305,0,36072,36471,36470,1,510
Glenn,8,2022-02-12,60,60,60,0,470,477,476,1,4
Humboldt,8,2022-02-12,397,402,402,0,4351,4400,4399,1,19
Imperial,8,2022-02-12,693,700,700,0,6443,6514,6513,1,70
Inyo,8,2022-02-12,28,28,28,0,395,400,399,1,2
Kern,8,2022-02-12,2384,2410,2410,0,28756,29073,29072,1,210
Kings,8,2022-02-12,897,906,906,0,8123,8212,8211,1,52
Lake,8,2022-02-12,260,262,262,0,2365,2392,2391,1,10
Lassen,8,2022-02-12,138,138,138,0,2762,2792,2791,1,3
Los Angeles,8,2022-02-12,24844,25118,25118,0,1306133,1320530,1320529,1,2203
Madera,8,2022-02-12,723,730,730,0,6901,6978,6977,1,48
Marin,8,2022-02-12,433,439,439,0,10090,10202,10201,1,31
Mariposa,8,2022-02-12,28,28,28,0,431,437,436,1,0
Mendocino,8,2022-02-12,232,233,233,0,2445,2472,2471,1,18
Merced,8,2022-02-12,853,861,861,0,7044,7124,7123,1,47
Modoc,8,2022-02-12,21,21,21,0,188,191,190,1,0
Mono,8,2022-02-12,14,14,14,0,179,181,180,1,0
Monterey,8,2022-02-12,1460,1475,1475,0,18360,18562,18561,1,89
Napa,8,2022-02-12,471,477,477,0,6705,6779,6778,1,17
Nevada,8,2022-02-12,210,211,211,0,2605,2634,2633,1,20
Orange,8,2022-02-12,4463,4512,4512,0,132508,133967,133966,1,462
Placer,8,2022-02-12,768,776,776,0,10236,10350,10349,1,157
Plumas,8,2022-02-12,44,44,44,0,419,425,424,1,2
Riverside,8,2022-02-12,5460,5518,5518,0,76757,77602,77601,1,536
Sacramento,8,2022-02-12,3820,3862,3862,0,53215,53802,53801,1,445
San Benito,8,2022-02-12,212,213,213,0,2195,2220,2219,1,7
San Bernardino,8,2022-02-12,4408,4457,4457,0,73868,74683,74682,1,536
San Diego,8,2022-02-12,9555,9659,9659,0,127518,128923,128922,1,767
San Francisco,8,2022-02-12,1827,1846,1846,0,47436,47960,47959,1,198
San Joaquin,8,2022-02-12,2306,2331,2331,0,30514,30850,30849,1,191
San Luis Obispo,8,2022-02-12,871,880,880,0,10242,10355,10354,1,30
San Mateo,8,2022-02-12,1568,1585,1585,0,52983,53567,53566,1,79
Santa Barbara,8,2022-02-12,1277,1291,1291,0,22951,23205,23204,1,81
Santa Clara,8,2022-02-12,5516,5576,5576,0,151160,152825,152824,1,387
Santa Cruz,8,2022-02-12,1186,1199,1199,0,33601,33971,33970,1,33
Shasta,8,2022-02-12,507,512,512,0,5988,6055,6054,1,86
Siskiyou,8,2022-02-12,79,79,79,0,576,583,582,1,5
Solano,8,2022-02-12,1413,1429,1429,0,19285,19498,19497,1,104
Sonoma,8,2022-02-12,1378,1394,1394,0,22276,22522,22521,1,61
Stanislaus,8,2022-02-12,1657,1675,1675,0,15580,15752,15751,1,258
Sutter,8,2022-02-12,248,248,248,0,2860,2893,2892,1,0
Tehama,8,2022-02-12,192,192,192,0,1427,1444,1443,1,19
Trinity,8,2022-02-12,21,21,21,0,161,162,161,1,0
Tulare,8,2022-02-12,1789,1808,1808,0,15730,15904,15903,1,151
Tuolumne,8,2022-02-12,221,223,223,0,2251,2277,2276,1,12
Ventura,8,2022-02-12,1809,1829,1829,0,37082,37491,37490,1,200
Yolo,8,2022-02-12,591,597,597,0,28016,28325,28324,1,15
Yuba,8,2022-02-12,244,246,246,0,2121,2145,2144,1,45
Alameda,9,2022-02-19,2259,2286,2286,0,86798,87875,87874,1,227
Amador,9,2022-02-19,91,91,91,0,2115,2142,2141,1,9
Butte,9,2022-02-19,317,321,321,0,4526,4582,4581,1,72
Calaveras,9,2022-02-19,52,52,52,0,923,936,935,1,6
Colusa,9,2022-02-19,29,29,29,0,372,377,376,1,6
Contra Costa,9,2022-02-19,1674,1695,1695,0,38765,39247,39246,1,146
Del Norte,9,2022-02-19,155,155,155,0,3012,3050,3049,1,9
El Dorado,9,2022-02-19,173,173,173,0,3862,3910,3909,1,10
Fresno,9,2022-02-19,2470,2502,2502,0,29394,29757,29756,1,413
Glenn,9,2022-02-19,33,33,33,0,394,400,399,1,2
Humboldt,9,2022-02-19,242,245,245,0,3668,3714,3713,1,20
Imperial,9,2022-02-19,422,428,428,0,5035,5099,5098,1,47
Inyo,9,2022-02-19,13,13,13,0,362,367,366,1,1
Kern,9,2022-02-19,1409,1427,1427,0,24544,24849,24848,1,124
Kings,9,2022-02-19,574,581,581,0,7107,7195,7194,1,33
Lake,9,2022-02-19,226,227,227,0,2145,2173,2172,1,9
Lassen,9,2022-02-19,143,143,143,0,2169,2197,2196,1,4
Los Angeles,9,2022-02-19,14022,14195,14195,0,1214236,1229308,1229307,1,1476
Madera,9,2022-02-19,425,430,430,0,5716,5787,5786,1,42
Marin,9,2022-02-19,264,266,266,0,9621,9742,9741,1,27
Mariposa,9,2022-02-19,20,20,20,0,404,410,409,1,0
Mendocino,9,2022-02-19,142,142,142,0,2221,2249,2248,1,10
Merced,9,2022-02-19,557,565,565,0,5747,5820,5819,1,38
Modoc,9,2022-02-19,10,10,10,0,71,72,71,1,1
Mono,9,2022-02-19,8,8,8,0,171,173,172,1,0
Monterey,9,2022-02-19,907,918,918,0,14532,14712,14711,1,63
Napa,9,2022-02-19,304,307,307,0,5580,5650,5649,1,10
Nevada,9,2022-02-19,130,130,130,0,2300,2328,2327,1,21
Orange,9,2022-02-19,2824,2859,2859,0,104752,106045,106044,1,360
Placer,9,2022-02-19,397,403,403,0,9063,9176,9175,1,144
Plumas,9,2022-02-19,23,23,23,0,364,370,369,1,1
Riverside,9,2022-02-19,2974,3010,3010,0,63775,64567,64566,1,380
Sacramento,9,2022-02-19,2402,2433,2433,0,46200,46773,46772,1,342
San Benito,9,2022-02-19,135,135,135,0,1946,1970,1969,1,4
San Bernardino,9,2022-02-19,2315,2344,2344,0,62045,62815,62814,1,380
San Diego,9,2022-02-19,5511,5579,5579,0,104784,106082,106081,1,613
San Francisco,9,2022-02-19,1133,1146,1146,0,43488,44028,44027,1,144
San Joaquin,9,2022-02-19,1296,1312,1312,0,25467,25782,25781,1,134
San Luis Obispo,9,2022-02-19,595,602,602,0,8733,8841,8840,1,26
San Mateo,9,2022-02-19,896,907,907,0,46291,46865,46864,1,65
Santa Barbara,9,2022-02-19,756,766,766,0,20404,20658,20657,1,58
Santa Clara,9,2022-02-19,3055,3093,3093,0,131444,133073,133072,1,320
Santa Cruz,9,2022-02-19,672,679,679,0,27770,28115,28114,1,24
Shasta,9,2022-02-19,323,326,326,0,5239,5304,5303,1,74
Siskiyou,9,2022-02-19,53,53,53,0,523,530,529,1,11
Solano,9,2022-02-19,803,813,813,0,15751,15948,15947,1,88
Sonoma,9,2022-02-19,780,790,790,0,17896,18118,18117,1,41
Stanislaus,9,2022-02-19,925,936,936,0,12638,12795,12794,1,203
Sutter,9,2022-02-19,155,155,155,0,2351,2382,2381,1,0
Tehama,9,2022-02-19,122,122,122,0,1236,1252,1251,1,14
Trinity,9,2022-02-19,16,16,16,0,221,224,223,1,0
Tulare,9,2022-02-19,971,984,984,0,11928,12077,12076,1,99
Tuolumne,9,2022-02-19,124,124,124,0,1863,1887,1886,1,7
Ventura,9,2022-02-19,1017,1029,1029,0,29652,30020,30019,1,137
Yolo,9,2022-02-19,343,347,347,0,23316,23606,23605,1,11
Yuba,9,2022-02-19,162,162,162,0,1727,1749,1748,1,29
Alameda,10,2022-02-26,1483,1503,1503,0,66123,67060,67059,1,164
Amador,10,2022-02-26,65,65,65,0,1948,1976,1975,1,10
Butte,10,2022-02-26,193,194,194,0,3917,3971,3970,1,48
Calaveras,10,2022-02-26,35,35,35,0,1035,1053,1052,1,0
Colusa,10,2022-02-26,11,11,11,0,351,357,356,1,3
Contra Costa,10,2022-02-26,981,994,994,0,30721,31157,31156,1,116
Del Norte,10,2022-02-26,88,88,88,0,2637,2676,2675,1,6
El Dorado,10,2022-02-26,113,113,113,0,3230,3276,3275,1,10
Fresno,10,2022-02-26,1354,1373,1373,0,24277,24621,24620,1,288
Glenn,10,2022-02-26,20,20,20,0,367,374,373,1,0
Humboldt,10,2022-02-26,136,137,137,0,2622,2660,2659,1,8
Imperial,10,2022-02-26,259,263,263,0,4358,4419,4418,1,24
Inyo,10,2022-02-26,10,10,10,0,309,314,313,1,0
Kern,10,2022-02-26,888,901,901,0,21071,21369,21368,1,101
Kings,10,2022-02-26,258,260,260,0,5682,5763,5762,1,21
Lake,10,2022-02-26,127,127,127,0,1767,1793,1792,1,3
Lassen,10,2022-02-26,58,58,58,0,1806,1833,1832,1,1
Los Angeles,10,2022-02-26,8456,8575,8575,0,1155624,1172030,1172029,1,1041
Madera,10,2022-02-26,207,208,208,0,4016,4073,4072,1,31
Marin,10,2022-02-26,147,147,147,0,6855,6953,6952,1,15
Mariposa,10,2022-02-26,34,34,34,0,314,319,318,1,0
Mendocino,10,2022-02-26,77,77,77,0,1683,1708,1707,1,10
Merced,10,2022-02-26,282,285,285,0,4512,4575,4574,1,31
Modoc,10,2022-02-26,6,6,6,0,49,50,49,1,1
Mono,10,2022-02-26,5,5,5,0,166,168,167,1,0
Monterey,10,2022-02-26,418,424,424,0,12397,12572,12571,1,32
Napa,10,2022-02-26,173,175,175,0,4776,4844,4843,1,9
Nevada,10,2022-02-26,78,78,78,0,1904,1932,1931,1,12
Orange,10,2022-02-26,1837,1863,1863,0,73489,74527,74526,1,254
Placer,10,2022-02-26,273,278,278,0,7628,7736,7735,1,115
Plumas,10,2022-02-26,26,26,26,0,316,322,321,1,0
Riverside,10,2022-02-26,1786,1811,1811,0,56345,57142,57141,1,279
Sacramento,10,2022-02-26,1213,1231,1231,0,38731,39280,39279,1,248
San Benito,10,2022-02-26,61,61,61,0,1475,1497,1496,1,1
San Bernardino,10,2022-02-26,1254,1272,1272,0,53086,53839,53838,1,229
San Diego,10,2022-02-26,3398,3447,3447,0,89446,90709,90708,1,461
San Francisco,10,2022-02-26,863,876,876,0,34938,35433,35432,1,109
San Joaquin,10,2022-02-26,724,735,735,0,21353,21656,21655,1,94
San Luis Obispo,10,2022-02-26,319,323,323,0,7267,7371,7370,1,17
San Mateo,10,2022-02-26,543,550,550,0,32962,33429,33428,1,51
Santa Barbara,10,2022-02-26,411,418,418,0,18070,18326,18325,1,45
Santa Clara,10,2022-02-26,1788,1815,1815,0,79792,80922,80921,1,253
Santa Cruz,10,2022-02-26,480,488,488,0,23263,23595,23594,1,19
Shasta,10,2022-02-26,173,174,174,0,4396,4459,4458,1,52
Siskiyou,10,2022-02-26,29,29,29,0,386,393,392,1,6
Solano,10,2022-02-26,493,499,499,0,13379,13570,13569,1,78
Sonoma,10,2022-02-26,458,466,466,0,14074,14274,14273,1,27
Stanislaus,10,2022-02-26,509,516,516,0,11077,11233,11232,1,170
Sutter,10,2022-02-26,106,106,106,0,2149,2181,2180,1,0
Tehama,10,2022-02-26,58,58,58,0,1084,1101,1100,1,10
Trinity,10,2022-02-26,6,6,6,0,111,112,111,1,0
Tulare,10,2022-02-26,512,520,520,0,10549,10698,10697,1,86
Tuolumne,10,2022-02-26,84,84,84,0,1360,1380,1379,1,7
Ventura,10,2022-02-26,609,617,617,0,26102,26472,26471,1,99
Yolo,10,2022-02-26,215,218,218,0,21653,21961,21960,1,9
Yuba,10,2022-02-26,79,79,79,0,1643,1667,1666,1,20
Alameda,11,2022-03-05,1161,1180,1180,0,70107,71246,71245,1,138
Amador,11,2022-03-05,75,76,76,0,1337,1359,1358,1,6
Butte,11,2022-03-05,135,136,136,0,3591,3649,3648,1,31
Calaveras,11,2022-03-05,30,30,30,0,1089,1108,1107,1,1
Colusa,11,2022-03-05,10,10,10,0,331,338,337,1,6
Contra Costa,11,2022-03-05,667,678,678,0,30843,31345,31344,1,94
Del Norte,11,2022-03-05,53,53,53,0,1801,1832,1831,1,6
El Dorado,11,2022-03-05,93,93,93,0,3115,3167,3166,1,6
Fresno,11,2022-03-05,972,986,986,0,21954,22310,22309,1,191
Glenn,11,2022-03-05,12,12,12,0,360,367,366,1,1
Humboldt,11,2022-03-05,110,110,110,0,2929,2977,2976,1,9
Imperial,11,2022-03-05,169,170,170,0,4322,4393,4392,1,21
Inyo,11,2022-03-05,9,9,9,0,353,360,359,1,1
Kern,11,2022-03-05,517,526,526,0,20173,20501,20500,1,78
Kings,11,2022-03-05,165,166,166,0,4890,4970,4969,1,13
Lake,11,2022-03-05,70,70,70,0,1773,1802,1801,1,5
Lassen,11,2022-03-05,83,84,84,0,1612,1640,1639,1,0
Los Angeles,11,2022-03-05,6059,6158,6158,0,1125295,1143587,1143586,1,834
Madera,11,2022-03-05,134,134,134,0,3972,4035,4034,1,19
Marin,11,2022-03-05,168,169,169,0,7359,7480,7479,1,13
Mariposa,11,2022-03-05,14,14,14,0,297,303,302,1,0
Mendocino,11,2022-03-05,75,75,75,0,1748,1778,1777,1,10
Merced,11,2022-03-05,201,203,203,0,4449,4522,4521,1,25
Modoc,11,2022-03-05,1,1,1,0,50,51,50,1,0
Mono,11,2022-03-05,3,3,3,0,129,130,129,1,1
Monterey,11,2022-03-05,267,270,270,0,11136,11318,11317,1,21
Napa,11,2022-03-05,200,203,203,0,4853,4933,4932,1,9
Nevada,11,2022-03-05,47,47,47,0,1674,1701,1700,1,5
Orange,11,2022-03-05,1336,1358,1358,0,68971,70091,70090,1,200
Placer,11,2022-03-05,180,183,183,0,7534,7656,7655,1,96
Plumas,11,2022-03-05,4,4,4,0,255,260,259,1,0
Riverside,11,2022-03-05,1100,1119,1119,0,51957,52801,52800,1,187
Sacramento,11,2022-03-05,844,857,857,0,37549,38158,38157,1,177
San Benito,11,2022-03-05,38,38,38,0,1450,1475,1474,1,2
San Bernardino,11,2022-03-05,880,894,894,0,50515,51338,51337,1,149
San Diego,11,2022-03-05,2514,2555,2555,0,91503,92991,92990,1,330
San Francisco,11,2022-03-05,679,691,691,0,36427,37019,37018,1,75
San Joaquin,11,2022-03-05,461,469,469,0,19304,19618,19617,1,63
San Luis Obispo,11,2022-03-05,304,309,309,0,7143,7259,7258,1,9
San Mateo,11,2022-03-05,571,580,580,0,38534,39160,39159,1,43
Santa Barbara,11,2022-03-05,218,221,221,0,16896,17171,17170,1,26
Santa Clara,11,2022-03-05,1549,1574,1574,0,108890,110656,110655,1,207
Santa Cruz,11,2022-03-05,343,348,348,0,24514,24913,24912,1,19
Shasta,11,2022-03-05,142,142,142,0,4759,4837,4836,1,42
Siskiyou,11,2022-03-05,19,19,19,0,405,412,411,1,4
Solano,11,2022-03-05,411,418,418,0,13082,13296,13295,1,73
Sonoma,11,2022-03-05,372,379,379,0,14491,14725,14724,1,30
Stanislaus,11,2022-03-05,319,325,325,0,10292,10458,10457,1,122
Sutter,11,2022-03-05,89,89,89,0,1951,1983,1982,1,0
Tehama,11,2022-03-05,51,51,51,0,1168,1188,1187,1,8
Trinity,11,2022-03-05,6,6,6,0,111,112,111,1,0
Tulare,11,2022-03-05,354,360,360,0,9796,9956,9955,1,48
Tuolumne,11,2022-03-05,54,54,54,0,1202,1221,1220,1,3
Ventura,11,2022-03-05,414,421,421,0,26013,26436,26435,1,58
Yolo,11,2022-03-05,172,173,173,0,21708,22062,22061,1,6
Yuba,11,2022-03-05,67,67,67,0,1555,1582,1581,1,18
Alameda,12,2022-03-12,951,968,968,0,64880,66130,66129,1,101
Amador,12,2022-03-12,32,32,32,0,1409,1437,1436,1,5
Butte,12,2022-03-12,72,72,72,0,3378,3444,3443,1,19
Calaveras,12,2022-03-12,16,16,16,0,1013,1033,1032,1,1
Colusa,12,2022-03-12,6,6,6,0,239,245,244,1,2
Contra Costa,12,2022-03-12,597,609,609,0,28191,28734,28733,1,59
Del Norte,12,2022-03-12,44,44,44,0,1408,1437,1436,1,5
El Dorado,12,2022-03-12,55,55,55,0,2867,2924,2923,1,8
Fresno,12,2022-03-12,619,632,632,0,20843,21245,21244,1,159
Glenn,12,2022-03-12,17,17,17,0,314,322,321,1,1
Humboldt,12,2022-03-12,65,65,65,0,2666,2717,2716,1,5
Imperial,12,2022-03-12,89,89,89,0,4476,4564,4563,1,13
Inyo,12,2022-03-12,10,10,10,0,153,157,156,1,0
Kern,12,2022-03-12,316,322,322,0,18717,19079,19078,1,60
Kings,12,2022-03-12,217,221,221,0,4617,4708,4707,1,16
Lake,12,2022-03-12,63,63,63,0,1555,1586,1585,1,0
Lassen,12,2022-03-12,25,25,25,0,1312,1338,1337,1,0
Los Angeles,12,2022-03-12,4285,4367,4367,0,1093943,1115041,1115040,1,571
Madera,12,2022-03-12,85,86,86,0,3554,3623,3622,1,21
Marin,12,2022-03-12,164,166,166,0,6310,6432,6431,1,14
Mariposa,12,2022-03-12,7,7,7,0,216,222,221,1,0
Mendocino,12,2022-03-12,41,41,41,0,1459,1490,1489,1,5
Merced,12,2022-03-12,148,150,150,0,3971,4050,4049,1,25
Modoc,12,2022-03-12,3,3,3,0,53,54,53,1,1
Mono,12,2022-03-12,2,2,2,0,106,107,106,1,0
Monterey,12,2022-03-12,180,182,182,0,9992,10184,10183,1,17
Napa,12,2022-03-12,145,147,147,0,4123,4203,4202,1,7
Nevada,12,2022-03-12,51,51,51,0,1508,1538,1537,1,3
Orange,12,2022-03-12,930,948,948,0,62312,63513,63512,1,157
Placer,12,2022-03-12,158,161,161,0,7164,7303,7302,1,90
Plumas,12,2022-03-12,10,10,10,0,293,299,298,1,0
Riverside,12,2022-03-12,780,794,794,0,48219,49149,49148,1,131
Sacramento,12,2022-03-12,619,631,631,0,34046,34701,34700,1,143
San Benito,12,2022-03-12,27,27,27,0,1361,1388,1387,1,2
San Bernardino,12,2022-03-12,595,606,606,0,47565,48483,48482,1,129
San Diego,12,2022-03-12,2004,2042,2042,0,90598,92342,92341,1,232
San Francisco,12,2022-03-12,586,597,597,0,33187,33828,33827,1,44
San Joaquin,12,2022-03-12,314,322,322,0,18307,18658,18657,1,46
San Luis Obispo,12,2022-03-12,162,165,165,0,6605,6732,6731,1,6
San Mateo,12,2022-03-12,469,477,477,0,34344,35005,35004,1,31
Santa Barbara,12,2022-03-12,194,198,198,0,16249,16561,16560,1,20
Santa Clara,12,2022-03-12,1142,1165,1165,0,94066,95877,95876,1,142
Santa Cruz,12,2022-03-12,251,256,256,0,22558,22994,22993,1,12
Shasta,12,2022-03-12,98,98,98,0,4730,4821,4820,1,21
Siskiyou,12,2022-03-12,17,17,17,0,389,396,395,1,0
Solano,12,2022-03-12,260,265,265,0,11984,12215,12214,1,66
Sonoma,12,2022-03-12,239,245,245,0,12897,13144,13143,1,18
Stanislaus,12,2022-03-12,250,255,255,0,9322,9501,9500,1,116
Sutter,12,2022-03-12,64,64,64,0,1720,1754,1753,1,0
Tehama,12,2022-03-12,27,27,27,0,970,990,989,1,1
Trinity,12,2022-03-12,2,2,2,0,96,97,96,1,0
Tulare,12,2022-03-12,217,221,221,0,9246,9423,9422,1,40
Tuolumne,12,2022-03-12,29,29,29,0,1176,1198,1197,1,2
Ventura,12,2022-03-12,349,356,356,0,23952,24413,24412,1,44
Yolo,12,2022-03-12,133,133,133,0,20524,20919,20918,1,4
Yuba,12,2022-03-12,44,44,44,0,1378,1406,1405,1,13
Alameda,13,2022-03-19,670,686,686,0,62107,63612,63611,1,69
Amador,13,2022-03-19,29,29,29,0,1333,1367,1366,1,3
Butte,13,2022-03-19,85,85,85,0,2872,2942,2941,1,17
Calaveras,13,2022-03-19,14,14,14,0,615,631,630,1,0
Colusa,13,2022-03-19,1,1,1,0,229,235,234,1,2
Contra Costa,13,2022-03-19,456,467,467,0,26520,27164,27163,1,68
Del Norte,13,2022-03-19,18,18,18,0,1229,1259,1258,1,2
El Dorado,13,2022-03-19,40,40,40,0,2612,2676,2675,1,2
Fresno,13,2022-03-19,348,357,357,0,18809,19265,19264,1,122
Glenn,13,2022-03-19,8,8,8,0,336,344,343,1,1
Humboldt,13,2022-03-19,35,35,35,0,2308,2364,2363,1,8
Imperial,13,2022-03-19,60,60,60,0,3712,3803,3802,1,9
Inyo,13,2022-03-19,1,1,1,0,143,148,147,1,0
Kern,13,2022-03-19,213,218,218,0,17646,18074,18073,1,40
Kings,13,2022-03-19,76,76,76,0,4191,4293,4292,1,6
Lake,13,2022-03-19,20,20,20,0,1394,1429,1428,1,0
Lassen,13,2022-03-19,10,10,10,0,1328,1361,1360,1,0
Los Angeles,13,2022-03-19,3906,4001,4001,0,1063130,1088980,1088979,1,484
Madera,13,2022-03-19,44,44,44,0,3254,3334,3333,1,20
Marin,13,2022-03-19,151,156,156,0,6010,6156,6155,1,13
Mariposa,13,2022-03-19,8,8,8,0,237,245,244,1,0
Mendocino,13,2022-03-19,34,34,34,0,1465,1501,1500,1,5
Merced,13,2022-03-19,98,99,99,0,3701,3792,3791,1,16
Modoc,13,2022-03-19,2,2,2,0,45,46,45,1,0
Mono,13,2022-03-19,2,2,2,0,130,133,132,1,1
Monterey,13,2022-03-19,151,156,156,0,9853,10092,10091,1,19
Napa,13,2022-03-19,66,66,66,0,3385,3466,3465,1,8
Nevada,13,2022-03-19,26,26,26,0,1431,1466,1465,1,1
Orange,13,2022-03-19,747,764,764,0,56653,58028,58027,1,137
Placer,13,2022-03-19,109,110,110,0,6150,6300,6299,1,52
Plumas,13,2022-03-19,1,1,1,0,204,210,209,1,0
Riverside,13,2022-03-19,667,682,682,0,50862,52095,52094,1,110
Sacramento,13,2022-03-19,471,483,483,0,29632,30351,30350,1,123
San Benito,13,2022-03-19,26,26,26,0,1312,1345,1344,1,2
San Bernardino,13,2022-03-19,470,482,482,0,46860,47998,47997,1,93
San Diego,13,2022-03-19,1504,1540,1540,0,82242,84236,84235,1,209
San Francisco,13,2022-03-19,648,664,664,0,31304,32066,32065,1,42
San Joaquin,13,2022-03-19,232,237,237,0,14634,14989,14988,1,38
San Luis Obispo,13,2022-03-19,113,115,115,0,6250,6402,6401,1,3
San Mateo,13,2022-03-19,382,392,392,0,30903,31655,31654,1,31
Santa Barbara,13,2022-03-19,180,184,184,0,14681,15036,15035,1,18
Santa Clara,13,2022-03-19,1022,1047,1047,0,89423,91592,91591,1,145
Santa Cruz,13,2022-03-19,216,220,220,0,20231,20724,20723,1,10
Shasta,13,2022-03-19,57,57,57,0,4015,4113,4112,1,1
Siskiyou,13,2022-03-19,10,10,10,0,351,361,360,1,1
Solano,13,2022-03-19,198,203,203,0,10907,11174,11173,1,43
Sonoma,13,2022-03-19,223,229,229,0,12251,12548,12547,1,18
Stanislaus,13,2022-03-19,154,157,157,0,8191,8389,8388,1,87
Sutter,13,2022-03-19,31,31,31,0,1411,1447,1446,1,0
Tehama,13,2022-03-19,9,9,9,0,874,896,895,1,1
Trinity,13,2022-03-19,1,1,1,0,92,94,93,1,0
Tulare,13,2022-03-19,131,133,133,0,7707,7895,7894,1,30
Tuolumne,13,2022-03-19,17,17,17,0,1097,1124,1123,1,2
Ventura,13,2022-03-19,285,292,292,0,22499,23044,23043,1,38
Yolo,13,2022-03-19,97,98,98,0,21553,22077,22076,1,4
Yuba,13,2022-03-19,34,34,34,0,1252,1284,1283,1,7
Alameda,14,2022-03-26,842,870,870,0,54461,56264,56263,1,70
Amador,14,2022-03-26,10,10,10,0,1252,1294,1293,1,3
Butte,14,2022-03-26,68,68,68,0,2575,2661,2660,1,15
Calaveras,14,2022-03-26,13,13,13,0,561,581,580,1,0
Colusa,14,2022-03-26,4,4,4,0,178,184,183,1,0
Contra Costa,14,2022-03-26,489,505,505,0,23655,24441,24440,1,54
Del Norte,14,2022-03-26,18,18,18,0,971,1005,1004,1,0
El Dorado,14,2022-03-26,48,48,48,0,2584,2670,2669,1,0
Fresno,14,2022-03-26,303,313,313,0,17320,17897,17896,1,108
Glenn,14,2022-03-26,8,8,8,0,300,310,309,1,0
Humboldt,14,2022-03-26,25,25,25,0,2445,2525,2524,1,6
Imperial,14,2022-03-26,51,52,52,0,3456,3571,3570,1,7
Inyo,14,2022-03-26,3,3,3,0,148,154,153,1,1
Kern,14,2022-03-26,152,156,156,0,16716,17269,17268,1,26
Kings,14,2022-03-26,65,65,65,0,4162,4301,4300,1,2
Lake,14,2022-03-26,13,13,13,0,1107,1145,1144,1,0
Lassen,14,2022-03-26,6,6,6,0,1179,1218,1217,1,0
Los Angeles,14,2022-03-26,4174,4312,4312,0,1045079,1079937,1079936,1,393
Madera,14,2022-03-26,25,25,25,0,3198,3305,3304,1,7
Marin,14,2022-03-26,164,171,171,0,5590,5776,5775,1,8
Mariposa,14,2022-03-26,6,6,6,0,173,180,179,1,0
Mendocino,14,2022-03-26,28,28,28,0,1253,1296,1295,1,0
Merced,14,2022-03-26,64,64,64,0,3127,3231,3230,1,12
Modoc,14,2022-03-26,2,2,2,0,48,50,49,1,0
Mono,14,2022-03-26,3,3,3,0,131,136,135,1,0
Monterey,14,2022-03-26,159,164,164,0,9092,9392,9391,1,19
Napa,14,2022-03-26,60,60,60,0,3165,3272,3271,1,1
Nevada,14,2022-03-26,25,25,25,0,1352,1399,1398,1,1
Orange,14,2022-03-26,789,816,816,0,49940,51603,51602,1,107
Placer,14,2022-03-26,109,113,113,0,5771,5962,5961,1,62
Plumas,14,2022-03-26,2,2,2,0,247,255,254,1,0
Riverside,14,2022-03-26,509,527,527,0,41158,42531,42530,1,87
Sacramento,14,2022-03-26,449,463,463,0,28562,29511,29510,1,117
San Benito,14,2022-03-26,10,10,10,0,1223,1264,1263,1,0
San Bernardino,14,2022-03-26,470,485,485,0,37477,38726,38725,1,80
San Diego,14,2022-03-26,1309,1353,1353,0,69337,71636,71635,1,161
San Francisco,14,2022-03-26,757,783,783,0,30543,31561,31560,1,35
San Joaquin,14,2022-03-26,189,196,196,0,14672,15157,15156,1,34
San Luis Obispo,14,2022-03-26,98,102,102,0,5436,5616,5615,1,5
San Mateo,14,2022-03-26,505,522,522,0,30809,31830,31829,1,31
Santa Barbara,14,2022-03-26,120,126,126,0,8470,8752,8751,1,21
Santa Clara,14,2022-03-26,1338,1382,1382,0,83454,86237,86236,1,120
Santa Cruz,14,2022-03-26,136,141,141,0,18341,18952,18951,1,7
Shasta,14,2022-03-26,40,40,40,0,3660,3782,3781,1,10
Siskiyou,14,2022-03-26,8,8,8,0,284,296,295,1,0
Solano,14,2022-03-26,158,164,164,0,10009,10344,10343,1,42
Sonoma,14,2022-03-26,224,230,230,0,7769,8028,8027,1,14
Stanislaus,14,2022-03-26,127,132,132,0,7435,7681,7680,1,56
Sutter,14,2022-03-26,27,27,27,0,1394,1440,1439,1,0
Tehama,14,2022-03-26,14,14,14,0,773,799,798,1,2
Trinity,14,2022-03-26,0,0,0,0,98,103,102,1,0
Tulare,14,2022-03-26,95,98,98,0,7222,7461,7460,1,22
Tuolumne,14,2022-03-26,9,9,9,0,1020,1056,1055,1,3
Ventura,14,2022-03-26,325,337,337,0,20476,21155,21154,1,26
Yolo,14,2022-03-26,96,99,99,0,13457,13911,13910,1,3
Yuba,14,2022-03-26,32,32,32,0,1176,1215,1214,1,3
Alameda,15,2022-04-02,790,836,836,0,52551,55561,55560,1,57
Amador,15,2022-04-02,4,4,4,0,1121,1185,1184,1,1
Butte,15,2022-04-02,49,51,51,0,2310,2440,2439,1,10
Calaveras,15,2022-04-02,8,8,8,0,549,582,581,1,0
Colusa,15,2022-04-02,3,3,3,0,186,199,198,1,0
Contra Costa,15,2022-04-02,488,517,517,0,22882,24201,24200,1,55
Del Norte,15,2022-04-02,9,9,9,0,1056,1119,1118,1,1
El Dorado,15,2022-04-02,45,48,48,0,2542,2689,2688,1,2
Fresno,15,2022-04-02,187,198,198,0,15468,16360,16359,1,89
Glenn,15,2022-04-02,4,4,4,0,257,272,271,1,0
Humboldt,15,2022-04-02,18,18,18,0,2371,2506,2505,1,7
Imperial,15,2022-04-02,54,57,57,0,3221,3407,3406,1,6
Inyo,15,2022-04-02,7,7,7,0,162,171,170,1,0
Kern,15,2022-04-02,150,160,160,0,15426,16310,16309,1,23
Kings,15,2022-04-02,50,52,52,0,3844,4064,4063,1,3
Lake,15,2022-04-02,10,10,10,0,929,982,981,1,0
Lassen,15,2022-04-02,4,4,4,0,1021,1080,1079,1,0
Los Angeles,15,2022-04-02,4586,4855,4855,0,1452909,1537500,1537499,1,339
Madera,15,2022-04-02,29,30,30,0,3078,3256,3255,1,9
Marin,15,2022-04-02,135,144,144,0,6191,6552,6551,1,14
Mariposa,15,2022-04-02,3,3,3,0,204,218,217,1,0
Mendocino,15,2022-04-02,23,23,23,0,1204,1274,1273,1,0
Merced,15,2022-04-02,53,55,55,0,3050,3225,3224,1,4
Modoc,15,2022-04-02,4,4,4,0,34,36,35,1,0
Mono,15,2022-04-02,0,0,0,0,152,161,160,1,0
Monterey,15,2022-04-02,101,108,108,0,7183,7594,7593,1,11
Napa,15,2022-04-02,50,53,53,0,3057,3230,3229,1,3
Nevada,15,2022-04-02,23,23,23,0,1227,1298,1297,1,0
Orange,15,2022-04-02,859,910,910,0,48963,51798,51797,1,81
Placer,15,2022-04-02,106,112,112,0,6130,6484,6483,1,48
Plumas,15,2022-04-02,2,2,2,0,214,226,225,1,0
Riverside,15,2022-04-02,534,565,565,0,35484,37521,37520,1,62
Sacramento,15,2022-04-02,402,425,425,0,29415,31102,31101,1,80
San Benito,15,2022-04-02,14,14,14,0,1137,1202,1201,1,0
San Bernardino,15,2022-04-02,522,551,551,0,36927,39057,39056,1,46
San Diego,15,2022-04-02,1439,1524,1524,0,61378,64915,64914,1,151
San Francisco,15,2022-04-02,851,899,899,0,26225,27734,27733,1,31
San Joaquin,15,2022-04-02,177,189,189,0,13966,14751,14750,1,23
San Luis Obispo,15,2022-04-02,99,104,104,0,5113,5405,5404,1,4
San Mateo,15,2022-04-02,573,606,606,0,26631,28158,28157,1,20
Santa Barbara,15,2022-04-02,155,164,164,0,13630,14416,14415,1,11
Santa Clara,15,2022-04-02,1283,1357,1357,0,83111,87879,87878,1,120
Santa Cruz,15,2022-04-02,174,184,184,0,19466,20572,20571,1,5
Shasta,15,2022-04-02,22,22,22,0,3269,3449,3448,1,5
Siskiyou,15,2022-04-02,4,4,4,0,296,314,313,1,0
Solano,15,2022-04-02,134,142,142,0,8986,9501,9500,1,41
Sonoma,15,2022-04-02,238,251,251,0,9574,10129,10128,1,14
Stanislaus,15,2022-04-02,93,99,99,0,6999,7394,7393,1,33
Sutter,15,2022-04-02,22,22,22,0,1150,1216,1215,1,0
Tehama,15,2022-04-02,5,5,5,0,702,743,742,1,0
Trinity,15,2022-04-02,1,1,1,0,76,80,79,1,0
Tulare,15,2022-04-02,53,55,55,0,6919,7313,7312,1,19
Tuolumne,15,2022-04-02,9,9,9,0,892,945,944,1,1
Ventura,15,2022-04-02,268,283,283,0,19565,20690,20689,1,22
Yolo,15,2022-04-02,61,66,66,0,26984,28535,28534,1,1
Yuba,15,2022-04-02,11,11,11,0,950,1005,1004,1,4
Alameda,16,2022-04-07,397,451,451,0,27975,34510,34509,1,79
Amador,16,2022-04-07,1,1,1,0,765,940,939,1,1
Butte,16,2022-04-07,16,18,18,0,1344,1640,1639,1,6
Calaveras,16,2022-04-07,2,2,2,0,431,528,527,1,0
Colusa,16,2022-04-07,2,2,2,0,135,167,166,1,0
Contra Costa,16,2022-04-07,216,246,246,0,11391,14031,14030,1,51
Del Norte,16,2022-04-07,2,2,2,0,634,765,764,1,1
El Dorado,16,2022-04-07,19,22,22,0,1520,1869,1868,1,2
Fresno,16,2022-04-07,74,83,83,0,10106,12398,12397,1,75
Glenn,16,2022-04-07,1,1,1,0,172,202,201,1,0
Humboldt,16,2022-04-07,13,15,15,0,1552,1929,1928,1,11
Imperial,16,2022-04-07,8,8,8,0,2121,2592,2591,1,4
Inyo,16,2022-04-07,2,2,2,0,112,137,136,1,0
Kern,16,2022-04-07,45,51,51,0,10851,13377,13376,1,24
Kings,16,2022-04-07,14,16,16,0,2940,3630,3629,1,4
Lake,16,2022-04-07,4,4,4,0,503,611,610,1,0
Lassen,16,2022-04-07,1,1,1,0,811,980,979,1,0
Los Angeles,16,2022-04-07,1696,1909,1909,0,403810,462444,462443,1,314
Madera,16,2022-04-07,7,7,7,0,2080,2561,2560,1,10
Marin,16,2022-04-07,69,79,79,0,3208,3951,3950,1,11
Mariposa,16,2022-04-07,1,1,1,0,149,183,182,1,0
Mendocino,16,2022-04-07,12,13,13,0,717,865,864,1,0
Merced,16,2022-04-07,26,29,29,0,2012,2464,2463,1,6
Modoc,16,2022-04-07,1,1,1,0,35,43,42,1,0
Mono,16,2022-04-07,0,0,0,0,72,89,88,1,0
Monterey,16,2022-04-07,34,39,39,0,4668,5690,5689,1,12
Napa,16,2022-04-07,24,27,27,0,1816,2222,2221,1,2
Nevada,16,2022-04-07,11,12,12,0,921,1126,1125,1,1
Orange,16,2022-04-07,351,396,396,0,31605,39020,39019,1,91
Placer,16,2022-04-07,38,42,42,0,3802,4630,4629,1,42
Plumas,16,2022-04-07,1,1,1,0,163,196,195,1,0
Riverside,16,2022-04-07,232,265,265,0,22139,27324,27323,1,64
Sacramento,16,2022-04-07,160,182,182,0,19036,23371,23370,1,79
San Benito,16,2022-04-07,7,7,7,0,824,1007,1006,1,0
San Bernardino,16,2022-04-07,295,339,339,0,23506,29022,29021,1,56
San Diego,16,2022-04-07,635,722,722,0,41409,50767,50766,1,129
San Francisco,16,2022-04-07,394,448,448,0,18603,22980,22979,1,31
San Joaquin,16,2022-04-07,88,101,101,0,9339,11430,11429,1,18
San Luis Obispo,16,2022-04-07,41,46,46,0,3282,4040,4039,1,3
San Mateo,16,2022-04-07,239,271,271,0,18565,22859,22858,1,15
Santa Barbara,16,2022-04-07,85,96,96,0,9302,11528,11527,1,7
Santa Clara,16,2022-04-07,577,654,654,0,46383,57129,57128,1,111
Santa Cruz,16,2022-04-07,137,160,160,0,5462,6792,6791,1,1
Shasta,16,2022-04-07,9,10,10,0,2268,2740,2739,1,4
Siskiyou,16,2022-04-07,1,1,1,0,196,243,242,1,0
Solano,16,2022-04-07,74,82,82,0,5397,6617,6616,1,42
Sonoma,16,2022-04-07,140,158,158,0,6208,7706,7705,1,9
Stanislaus,16,2022-04-07,46,53,53,0,4729,5725,5724,1,34
Sutter,16,2022-04-07,12,12,12,0,796,966,965,1,0
Tehama,16,2022-04-07,6,6,6,0,481,592,591,1,0
Trinity,16,2022-04-07,0,0,0,0,48,59,58,1,0
Tulare,16,2022-04-07,20,23,23,0,5131,6260,6259,1,12
Tuolumne,16,2022-04-07,9,10,10,0,675,808,807,1,0
Ventura,16,2022-04-07,99,112,112,0,11074,13650,13649,1,22
Yolo,16,2022-04-07,28,32,32,0,7589,9101,9100,1,0
Yuba,16,2022-04-07,7,8,8,0,651,801,800,1,2
