county,time,date,cases,est_cases,est_omicron_cases,est_other_cases,tests,est_tests,est_omicron_tests,est_other_tests,hospitalizations,deaths,est_deaths,icu,cum_deaths,cum_est_deaths,prev_cum_deaths,prev_cum_est_deaths
Alameda,1,2021-12-25,5494,5500,2831,2669,83115,83214,42513,40701,70,12,12,16,1552,1552,1540,1540
Amador,1,2021-12-25,75,75,30,45,1474,1474,576,898,2,0,0,2,70,70,70,70
Butte,1,2021-12-25,356,356,203,153,3809,3813,2146,1667,28,3,3,3,361,361,358,358
Calaveras,1,2021-12-25,72,72,31,41,965,965,409,556,0,1,1,2,93,93,92,92
Colusa,1,2021-12-25,15,15,7,8,239,239,112,127,2,0,0,0,21,21,21,21
Contra Costa,1,2021-12-25,3251,3256,1260,1996,43046,43096,16515,26581,37,2,2,12,1076,1076,1074,1074
Del Norte,1,2021-12-25,20,20,9,11,1225,1225,557,668,0,0,0,0,42,42,42,42
El Dorado,1,2021-12-25,389,389,168,221,4121,4125,1759,2366,7,1,1,4,178,178,177,177
Fresno,1,2021-12-25,1524,1524,612,912,22546,22572,8975,13597,112,14,14,40,2428,2428,2414,2414
Glenn,1,2021-12-25,37,37,16,21,412,412,178,234,0,0,0,0,38,38,38,38
Humboldt,1,2021-12-25,334,334,152,182,3141,3145,1399,1746,9,2,2,1,121,121,119,119
Imperial,1,2021-12-25,659,659,280,379,5387,5392,2280,3112,26,12,12,25,826,826,814,814
Inyo,1,2021-12-25,80,80,38,42,420,420,198,222,0,2,2,0,50,50,48,48
Kern,1,2021-12-25,1205,1205,573,632,19629,19652,9275,10377,66,18,18,32,2034,2034,2016,2016
Kings,1,2021-12-25,352,352,151,201,5356,5362,2275,3087,16,2,2,4,388,388,386,386
Lake,1,2021-12-25,43,43,17,26,1144,1144,451,693,0,1,1,0,117,117,116,116
Lassen,1,2021-12-25,19,19,9,10,2322,2324,1155,1169,0,0,0,0,54,54,54,54
Los Angeles,1,2021-12-25,66436,66513,48453,18060,660147,660924,479644,181280,716,109,109,188,27451,27451,27342,27342
Madera,1,2021-12-25,212,212,85,127,4152,4157,1637,2520,5,1,1,7,333,333,332,332
Marin,1,2021-12-25,1163,1163,473,690,14378,14395,5833,8562,3,0,0,1,256,256,256,256
Mariposa,1,2021-12-25,31,31,12,19,504,504,195,309,0,0,0,0,21,21,21,21
Mendocino,1,2021-12-25,86,86,29,57,2497,2500,822,1678,5,1,1,1,103,103,102,102
Merced,1,2021-12-25,429,429,200,229,4861,4866,2245,2621,0,9,9,2,699,699,690,690
Modoc,1,2021-12-25,5,5,2,3,57,57,27,30,2,0,0,0,6,6,6,6
Mono,1,2021-12-25,93,93,28,65,356,356,104,252,1,0,0,0,4,4,4,4
Monterey,1,2021-12-25,722,722,215,507,12221,12236,3585,8651,25,3,3,10,644,644,641,641
Napa,1,2021-12-25,559,559,281,278,5566,5573,2777,2796,2,0,0,3,107,107,107,107
Nevada,1,2021-12-25,205,205,82,123,2513,2516,998,1518,5,1,1,1,111,111,110,110
Orange,1,2021-12-25,10834,10848,5805,5043,106783,106909,56785,50124,196,30,30,60,6019,6019,5989,5989
Placer,1,2021-12-25,919,919,350,569,10317,10328,3876,6452,57,4,4,25,502,502,498,498
Plumas,1,2021-12-25,11,11,5,6,395,395,165,230,0,0,0,0,12,12,12,12
Riverside,1,2021-12-25,9361,9372,4310,5062,76530,76620,34901,41719,280,49,49,77,5539,5539,5490,5490
Sacramento,1,2021-12-25,3381,3386,1495,1891,47936,47992,20982,27010,115,20,20,43,2505,2505,2485,2485
San Benito,1,2021-12-25,203,203,100,103,2097,2100,1027,1073,2,3,3,3,82,82,79,79
San Bernardino,1,2021-12-25,9260,9271,4768,4503,79741,79835,40699,39136,297,73,73,124,6582,6582,6509,6509
San Diego,1,2021-12-25,17486,17506,12553,4953,157014,157198,112305,44893,263,29,29,92,4503,4503,4474,4474
San Francisco,1,2021-12-25,5616,5623,1556,4067,62129,62203,17117,45086,22,2,2,12,692,692,690,690
San Joaquin,1,2021-12-25,1556,1556,652,904,20814,20839,8620,12219,52,16,16,22,1983,1983,1967,1967
San Luis Obispo,1,2021-12-25,718,718,345,373,10072,10084,4807,5277,14,1,1,8,371,371,370,370
San Mateo,1,2021-12-25,3546,3552,1899,1653,50462,50523,26787,23736,13,2,2,5,598,598,596,596
Santa Barbara,1,2021-12-25,1420,1420,646,774,13841,13856,6218,7638,26,4,4,11,573,573,569,569
Santa Clara,1,2021-12-25,6180,6187,4368,1819,97873,97989,68764,29225,78,12,12,36,1986,1986,1974,1974
Santa Cruz,1,2021-12-25,653,653,323,330,11583,11596,5666,5930,11,0,0,3,230,230,230,230
Shasta,1,2021-12-25,203,203,90,113,4589,4594,2007,2587,25,5,5,12,452,452,447,447
Siskiyou,1,2021-12-25,15,15,8,7,344,344,173,171,0,1,1,0,63,63,62,62
Solano,1,2021-12-25,838,838,385,453,15119,15137,6908,8229,24,3,3,5,390,390,387,387
Sonoma,1,2021-12-25,1325,1325,618,707,18925,18946,8739,10207,12,0,0,4,420,420,420,420
Stanislaus,1,2021-12-25,884,884,312,572,10380,10392,3621,6771,87,19,19,17,1445,1445,1426,1426
Sutter,1,2021-12-25,177,177,80,97,2013,2014,908,1106,0,1,1,0,193,193,192,192
Tehama,1,2021-12-25,64,64,23,41,1046,1046,376,670,9,0,0,2,164,164,164,164
Trinity,1,2021-12-25,3,3,1,2,96,96,34,62,0,1,1,0,19,19,18,18
Tulare,1,2021-12-25,560,560,195,365,10434,10446,3588,6858,34,12,12,13,1315,1315,1303,1303
Tuolumne,1,2021-12-25,133,133,54,79,1743,1743,692,1051,4,0,0,1,153,153,153,153
Ventura,1,2021-12-25,3578,3584,1987,1597,34018,34058,18715,15343,61,7,7,13,1216,1216,1209,1209
Yolo,1,2021-12-25,545,545,265,280,20045,20069,9654,10415,5,0,0,2,270,270,270,270
Yuba,1,2021-12-25,114,114,54,60,1501,1501,701,800,8,1,1,3,102,102,101,101
Alameda,2,2022-01-01,14216,14234,8182,6052,102079,102204,58592,43612,126,7,7,24,1559,1559,1552,1552
Amador,2,2022-01-01,149,149,68,81,1850,1852,840,1012,5,1,1,2,71,71,70,70
Butte,2,2022-01-01,916,916,574,342,5681,5688,3548,2140,26,1,1,4,362,362,361,361
Calaveras,2,2022-01-01,175,175,86,89,1149,1149,559,590,2,1,1,1,94,94,93,93
Colusa,2,2022-01-01,53,53,28,25,299,299,159,140,4,0,0,0,21,21,21,21
Contra Costa,2,2022-01-01,11125,11139,4965,6174,59701,59774,26560,33214,64,10,10,21,1086,1086,1076,1076
Del Norte,2,2022-01-01,61,61,32,29,1963,1964,1013,951,0,0,0,0,42,42,42,42
El Dorado,2,2022-01-01,1001,1001,493,508,5332,5337,2616,2721,11,3,3,6,181,181,178,178
Fresno,2,2022-01-01,5024,5029,2319,2710,34805,34846,16027,18819,146,14,14,42,2442,2442,2428,2428
Glenn,2,2022-01-01,70,70,35,35,517,517,256,261,0,0,0,0,38,38,38,38
Humboldt,2,2022-01-01,724,724,370,354,4662,4667,2377,2290,7,0,0,3,121,121,121,121
Imperial,2,2022-01-01,1497,1497,727,770,8155,8165,3962,4203,29,12,12,28,838,838,826,826
Inyo,2,2022-01-01,210,210,112,98,598,598,319,279,2,0,0,1,50,50,50,50
Kern,2,2022-01-01,4286,4292,2310,1982,30064,30101,16095,14006,88,13,13,33,2047,2047,2034,2034
Kings,2,2022-01-01,871,871,426,445,7435,7443,3630,3813,16,2,2,1,390,390,388,388
Lake,2,2022-01-01,145,145,67,78,1470,1471,671,800,0,0,0,1,117,117,117,117
Lassen,2,2022-01-01,47,47,27,20,2511,2515,1401,1114,2,0,0,0,54,54,54,54
Los Angeles,2,2022-01-01,175323,175536,135771,39765,912260,913375,706104,207271,1529,133,133,263,27584,27584,27451,27451
Madera,2,2022-01-01,664,664,304,360,5686,5692,2593,3099,10,2,2,3,335,335,333,333
Marin,2,2022-01-01,2211,2212,1025,1187,17581,17602,8144,9458,18,1,1,1,257,257,256,256
Mariposa,2,2022-01-01,73,73,33,40,534,534,239,295,0,0,0,0,21,21,21,21
Mendocino,2,2022-01-01,325,325,126,199,2901,2905,1124,1781,4,0,0,2,103,103,103,103
Merced,2,2022-01-01,1223,1223,643,580,7404,7413,3896,3517,10,7,7,12,706,706,699,699
Modoc,2,2022-01-01,11,11,6,5,52,52,28,24,0,0,0,0,6,6,6,6
Mono,2,2022-01-01,170,170,59,111,386,386,133,253,2,0,0,0,4,4,4,4
Monterey,2,2022-01-01,1972,1973,691,1282,17496,17518,6108,11410,19,5,5,10,649,649,644,644
Napa,2,2022-01-01,1519,1519,851,668,10130,10141,5673,4468,9,1,1,1,108,108,107,107
Nevada,2,2022-01-01,471,471,219,252,2183,2185,1014,1171,4,1,1,2,112,112,111,111
Orange,2,2022-01-01,39479,39526,23460,16066,199719,199964,118506,81458,425,31,31,97,6050,6050,6019,6019
Placer,2,2022-01-01,2376,2378,1046,1332,14042,14059,6140,7919,99,12,12,25,514,514,502,502
Plumas,2,2022-01-01,36,36,17,19,353,353,170,183,2,0,0,0,12,12,12,12
Riverside,2,2022-01-01,26665,26698,13893,12805,125625,125779,65257,60522,452,52,52,93,5591,5591,5539,5539
Sacramento,2,2022-01-01,11298,11312,5683,5629,71511,71598,35842,35756,187,27,27,56,2532,2532,2505,2505
San Benito,2,2022-01-01,620,620,342,278,3035,3039,1675,1364,2,3,3,3,85,85,82,82
San Bernardino,2,2022-01-01,29442,29478,16903,12575,122932,123083,70483,52600,476,88,88,148,6670,6670,6582,6582
San Diego,2,2022-01-01,53156,53220,40635,12585,229990,230270,175673,54597,504,30,30,124,4533,4533,4503,4503
San Francisco,2,2022-01-01,9690,9701,3188,6513,74978,75069,24602,50467,68,5,5,16,697,697,692,692
San Joaquin,2,2022-01-01,5530,5536,2657,2879,32319,32360,15429,16931,68,10,10,26,1993,1993,1983,1983
San Luis Obispo,2,2022-01-01,2132,2135,1151,984,14639,14657,7904,6753,14,5,5,5,376,376,371,371
San Mateo,2,2022-01-01,9025,9036,5353,3683,67525,67607,39978,27629,27,2,2,7,600,600,598,598
Santa Barbara,2,2022-01-01,4188,4193,2156,2037,22305,22334,11455,10879,49,6,6,8,579,579,573,573
Santa Clara,2,2022-01-01,17664,17686,13334,4352,134006,134170,100908,33262,145,8,8,53,1994,1994,1986,1986
Santa Cruz,2,2022-01-01,1859,1859,1033,826,15285,15305,8448,6857,15,3,3,6,233,233,230,230
Shasta,2,2022-01-01,438,438,221,217,5442,5448,2726,2722,11,3,3,2,455,455,452,452
Siskiyou,2,2022-01-01,57,57,33,24,456,456,258,198,0,0,0,0,63,63,63,63
Solano,2,2022-01-01,3487,3491,1815,1676,24103,24132,12509,11623,54,4,4,8,394,394,390,390
Sonoma,2,2022-01-01,3708,3712,1952,1760,27938,27972,14643,13329,26,5,5,3,425,425,420,420
Stanislaus,2,2022-01-01,2646,2649,1091,1558,15973,15993,6531,9462,100,7,7,20,1452,1452,1445,1445
Sutter,2,2022-01-01,403,403,209,194,2618,2622,1347,1275,0,3,3,0,196,196,193,193
Tehama,2,2022-01-01,169,169,72,97,1173,1173,491,682,2,3,3,2,167,167,164,164
Trinity,2,2022-01-01,9,9,4,5,101,101,42,59,0,0,0,0,19,19,19,19
Tulare,2,2022-01-01,1612,1612,656,956,14670,14687,5921,8766,45,8,8,8,1323,1323,1315,1315
Tuolumne,2,2022-01-01,284,284,132,152,1903,1904,875,1029,6,1,1,0,154,154,153,153
Ventura,2,2022-01-01,11367,11381,6967,4414,55664,55731,34032,21699,103,7,7,21,1223,1223,1216,1216
Yolo,2,2022-01-01,1624,1624,889,735,25310,25341,13759,11582,8,2,2,2,272,272,270,270
Yuba,2,2022-01-01,360,360,193,167,2057,2059,1095,964,16,1,1,6,103,103,102,102
Alameda,3,2022-01-08,30698,30736,19558,11178,190589,190830,121342,69488,265,13,13,42,1572,1572,1559,1559
Amador,3,2022-01-08,376,376,194,182,2775,2778,1429,1349,3,0,0,3,71,71,71,71
Butte,3,2022-01-08,1950,1950,1331,619,9999,10011,6826,3185,43,1,1,4,363,363,362,362
Calaveras,3,2022-01-08,455,455,252,203,2434,2438,1345,1093,0,1,1,2,95,95,94,94
Colusa,3,2022-01-08,78,78,47,31,660,660,392,268,5,0,0,0,21,21,21,21
Contra Costa,3,2022-01-08,19847,19871,10115,9756,102540,102670,52262,50408,149,10,10,23,1096,1096,1086,1086
Del Norte,3,2022-01-08,159,159,92,67,3855,3859,2257,1602,2,0,0,0,42,42,42,42
El Dorado,3,2022-01-08,2118,2118,1174,944,8873,8885,4922,3963,15,7,7,3,188,188,181,181
Fresno,3,2022-01-08,12010,12026,6324,5702,57936,58009,30446,27563,244,17,17,40,2459,2459,2442,2442
Glenn,3,2022-01-08,180,180,102,78,872,872,488,384,2,1,1,0,39,39,38,38
Humboldt,3,2022-01-08,1414,1414,812,602,8249,8261,4745,3516,14,4,4,2,125,125,121,121
Imperial,3,2022-01-08,3408,3413,1874,1539,13673,13690,7512,6178,52,13,13,22,851,851,838,838
Inyo,3,2022-01-08,390,390,231,159,1244,1244,740,504,4,1,1,0,51,51,50,50
Kern,3,2022-01-08,10961,10974,6571,4403,55475,55545,33204,22341,160,24,24,31,2071,2071,2047,2047
Kings,3,2022-01-08,1961,1961,1084,877,11936,11951,6596,5355,19,1,1,3,391,391,390,390
Lake,3,2022-01-08,457,457,238,219,2672,2675,1387,1288,1,2,2,1,119,119,117,117
Lassen,3,2022-01-08,122,122,76,46,3627,3631,2236,1395,2,0,0,0,54,54,54,54
Los Angeles,3,2022-01-08,333665,334087,272442,61645,1909525,1911938,1559378,352560,2929,245,245,435,27829,27829,27584,27584
Madera,3,2022-01-08,1699,1699,888,811,10066,10079,5241,4838,19,3,3,7,338,338,335,335
Marin,3,2022-01-08,3081,3085,1630,1455,21656,21683,11470,10213,19,2,2,4,259,259,257,257
Mariposa,3,2022-01-08,181,181,92,89,1104,1104,565,539,0,1,1,0,22,22,21,21
Mendocino,3,2022-01-08,808,808,364,444,5478,5485,2467,3018,4,3,3,3,106,106,103,103
Merced,3,2022-01-08,3301,3306,1951,1355,13645,13662,8052,5610,28,12,12,11,718,718,706,706
Modoc,3,2022-01-08,16,16,10,6,95,95,57,38,0,0,0,0,6,6,6,6
Mono,3,2022-01-08,260,260,106,154,841,841,344,497,1,1,1,0,5,5,4,4
Monterey,3,2022-01-08,4459,4465,1828,2637,32072,32112,13114,18998,44,4,4,12,653,653,649,649
Napa,3,2022-01-08,2691,2695,1671,1024,14850,14869,9217,5652,14,1,1,1,109,109,108,108
Nevada,3,2022-01-08,1110,1110,585,525,4899,4904,2575,2329,11,2,2,4,114,114,112,112
Orange,3,2022-01-08,61450,61528,40139,21389,313065,313462,204658,108804,779,77,77,128,6127,6127,6050,6050
Placer,3,2022-01-08,4815,4821,2423,2398,21314,21341,10704,10637,141,10,10,24,524,524,514,514
Plumas,3,2022-01-08,121,121,66,55,785,785,424,361,4,0,0,0,12,12,12,12
Riverside,3,2022-01-08,47571,47632,27746,19886,185327,185562,108076,77486,714,71,71,137,5662,5662,5591,5591
Sacramento,3,2022-01-08,26596,26629,15058,11571,119972,120123,67817,52306,319,36,36,80,2568,2568,2532,2532
San Benito,3,2022-01-08,960,960,588,372,4317,4322,2648,1674,4,0,0,2,85,85,85,85
San Bernardino,3,2022-01-08,49958,50021,31738,18283,189223,189463,120254,69209,742,105,105,181,6775,6775,6670,6670
San Diego,3,2022-01-08,85732,85840,69197,16643,343364,343797,277163,66634,774,48,48,169,4581,4581,4533,4533
San Francisco,3,2022-01-08,16344,16366,6320,10046,121391,121544,47025,74519,130,9,9,26,706,706,697,697
San Joaquin,3,2022-01-08,12980,12996,7043,5953,59849,59924,32427,27497,117,19,19,33,2012,2012,1993,1993
San Luis Obispo,3,2022-01-08,4265,4270,2577,1693,21582,21609,13030,8579,33,3,3,7,379,379,376,376
San Mateo,3,2022-01-08,15122,15141,9862,5279,114257,114402,74467,39935,82,5,5,15,605,605,600,600
Santa Barbara,3,2022-01-08,8328,8339,4799,3540,45770,45828,26395,19433,71,7,7,6,586,586,579,579
Santa Clara,3,2022-01-08,34999,35043,27915,7128,262150,262481,209123,53358,329,22,22,62,2016,2016,1994,1994
Santa Cruz,3,2022-01-08,4353,4359,2684,1675,41810,41863,25748,16115,16,4,4,2,237,237,233,233
Shasta,3,2022-01-08,1000,1000,566,434,8245,8256,4656,3600,41,7,7,13,462,462,455,455
Siskiyou,3,2022-01-08,107,107,67,40,874,874,545,329,4,1,1,1,64,64,63,63
Solano,3,2022-01-08,6559,6567,3831,2736,35778,35824,20870,14954,76,5,5,12,399,399,394,394
Sonoma,3,2022-01-08,8376,8387,4938,3449,46911,46969,27585,19384,65,8,8,6,433,433,425,425
Stanislaus,3,2022-01-08,5984,5991,2838,3153,27092,27125,12807,14318,148,14,14,20,1466,1466,1452,1452
Sutter,3,2022-01-08,1089,1089,631,458,4671,4676,2699,1977,0,1,1,0,197,197,196,196
Tehama,3,2022-01-08,459,459,223,236,2392,2396,1157,1239,10,1,1,2,168,168,167,167
Trinity,3,2022-01-08,33,33,16,17,263,263,127,136,0,0,0,0,19,19,19,19
Tulare,3,2022-01-08,4301,4307,2021,2286,22496,22525,10525,12000,53,8,8,9,1331,1331,1323,1323
Tuolumne,3,2022-01-08,709,709,372,337,4032,4037,2109,1928,13,2,2,1,156,156,154,154
Ventura,3,2022-01-08,17593,17616,11814,5802,87059,87169,58463,28706,200,19,19,28,1242,1242,1223,1223
Yolo,3,2022-01-08,3983,3989,2423,1566,50688,50753,30811,19942,7,3,3,1,275,275,272,272
Yuba,3,2022-01-08,927,927,553,374,3808,3813,2269,1544,28,0,0,7,103,103,103,103
Alameda,4,2022-01-15,27041,27077,18705,8372,185722,185964,128468,57496,344,21,21,58,1593,1593,1572,1572
Amador,4,2022-01-15,490,490,283,207,3816,3821,2201,1620,5,2,2,4,73,73,71,71
Butte,4,2022-01-15,2119,2121,1555,566,9634,9647,7065,2582,52,3,3,3,366,366,363,363
Calaveras,4,2022-01-15,607,607,371,236,2724,2728,1668,1060,3,2,2,2,97,97,95,95
Colusa,4,2022-01-15,166,166,108,58,800,800,521,279,2,0,0,0,21,21,21,21
Contra Costa,4,2022-01-15,17370,17393,9914,7479,95765,95890,54683,41207,203,22,22,35,1118,1118,1096,1096
Del Norte,4,2022-01-15,199,199,127,72,3969,3974,2527,1447,3,0,0,0,42,42,42,42
El Dorado,4,2022-01-15,2182,2183,1336,847,9009,9021,5526,3495,13,4,4,3,192,192,188,188
Fresno,4,2022-01-15,16756,16778,9839,6939,68022,68111,39900,28211,366,23,23,64,2482,2482,2459,2459
Glenn,4,2022-01-15,305,305,190,115,1061,1061,658,403,2,1,1,0,40,40,39,39
Humboldt,4,2022-01-15,1261,1261,797,464,8890,8902,5634,3268,17,2,2,7,127,127,125,125
Imperial,4,2022-01-15,3728,3733,2270,1463,14253,14272,8689,5583,66,6,6,28,857,857,851,851
Inyo,4,2022-01-15,397,397,258,139,1238,1238,804,434,3,1,1,0,52,52,51,51
Kern,4,2022-01-15,13167,13183,8638,4545,59462,59539,38998,20541,221,25,25,35,2096,2096,2071,2071
Kings,4,2022-01-15,3487,3492,2136,1356,16570,16591,10156,6435,44,3,3,2,394,394,391,391
Lake,4,2022-01-15,591,591,344,247,3194,3199,1861,1338,1,1,1,3,120,120,119,119
Lassen,4,2022-01-15,292,292,197,95,3783,3788,2550,1238,1,0,0,0,54,54,54,54
Los Angeles,4,2022-01-15,249925,250250,212497,37753,1801071,1803420,1532204,271216,3885,437,437,622,28266,28266,27829,27829
Madera,4,2022-01-15,2425,2428,1416,1012,11172,11186,6508,4678,28,4,4,4,342,342,338,338
Marin,4,2022-01-15,2675,2678,1579,1099,19329,19353,11420,7933,30,4,4,4,263,263,259,259
Mariposa,4,2022-01-15,189,189,107,82,1227,1227,702,525,0,0,0,0,22,22,22,22
Mendocino,4,2022-01-15,982,982,503,479,5575,5582,2856,2726,21,2,2,1,108,108,106,106
Merced,4,2022-01-15,4166,4171,2700,1471,14976,14995,9701,5294,42,15,15,11,733,733,718,718
Modoc,4,2022-01-15,10,10,7,3,110,110,72,38,0,0,0,0,6,6,6,6
Mono,4,2022-01-15,235,235,110,125,856,856,402,454,1,0,0,0,5,5,5,5
Monterey,4,2022-01-15,6064,6070,2857,3213,30166,30205,14165,16040,61,7,7,13,660,660,653,653
Napa,4,2022-01-15,2195,2197,1484,713,13382,13401,9055,4346,18,2,2,6,111,111,109,109
Nevada,4,2022-01-15,1317,1317,772,545,5715,5721,3350,2371,23,1,1,0,115,115,114,114
Orange,4,2022-01-15,47073,47134,33248,13886,282252,282619,199518,83101,1020,114,114,180,6241,6241,6127,6127
Placer,4,2022-01-15,4765,4772,2680,2092,21333,21361,11996,9365,171,11,11,36,535,535,524,524
Plumas,4,2022-01-15,186,186,111,75,806,806,482,324,4,0,0,0,12,12,12,12
Riverside,4,2022-01-15,45526,45586,29208,16378,182995,183234,117480,65754,851,95,95,155,5757,5757,5662,5662
Sacramento,4,2022-01-15,23540,23571,14700,8871,111595,111741,69666,42075,441,48,48,92,2616,2616,2568,2568
San Benito,4,2022-01-15,941,941,628,313,4434,4440,2968,1472,5,2,2,3,87,87,85,85
San Bernardino,4,2022-01-15,43992,44049,30330,13719,182564,182801,126041,56760,883,125,125,217,6900,6900,6775,6775
San Diego,4,2022-01-15,67389,67477,56801,10676,286950,287325,241941,45384,1015,91,91,191,4672,4672,4581,4581
San Francisco,4,2022-01-15,11803,11818,5283,6535,100572,100704,45028,55676,188,13,13,42,719,719,706,706
San Joaquin,4,2022-01-15,14298,14316,8592,5724,65110,65195,39124,26071,186,17,17,53,2029,2029,2012,2012
San Luis Obispo,4,2022-01-15,4096,4101,2708,1393,22361,22390,14784,7606,36,8,8,6,387,387,379,379
San Mateo,4,2022-01-15,13875,13893,9790,4103,109073,109214,76960,32254,87,11,11,24,616,616,605,605
Santa Barbara,4,2022-01-15,7604,7614,4824,2790,44894,44952,28502,16450,110,12,12,12,598,598,586,586
Santa Clara,4,2022-01-15,31571,31613,26344,5269,252725,253054,210916,42138,423,21,21,71,2037,2037,2016,2016
Santa Cruz,4,2022-01-15,4372,4378,2941,1437,45091,45150,30348,14802,31,1,1,3,238,238,237,237
Shasta,4,2022-01-15,1329,1329,832,497,9713,9726,6071,3655,60,6,6,14,468,468,462,462
Siskiyou,4,2022-01-15,159,159,108,51,1051,1051,712,339,3,1,1,2,65,65,64,64
Solano,4,2022-01-15,7034,7042,4524,2518,38523,38574,24759,13815,111,5,5,18,404,404,399,399
Sonoma,4,2022-01-15,8152,8163,5270,2893,46854,46914,30283,16631,77,9,9,14,442,442,433,433
Stanislaus,4,2022-01-15,7667,7678,4097,3581,30906,30947,16490,14457,188,9,9,31,1475,1475,1466,1466
Sutter,4,2022-01-15,1368,1368,869,499,5157,5162,3277,1885,0,4,4,0,201,201,197,197
Tehama,4,2022-01-15,630,630,344,286,2607,2612,1421,1191,13,4,4,2,172,172,168,168
Trinity,4,2022-01-15,43,43,23,20,272,272,147,125,0,1,1,0,20,20,19,19
Tulare,4,2022-01-15,7528,7539,3993,3546,28156,28193,14908,13285,86,14,14,10,1345,1345,1331,1331
Tuolumne,4,2022-01-15,943,943,551,392,4435,4440,2590,1850,8,8,8,1,164,164,156,156
Ventura,4,2022-01-15,13843,13860,9999,3861,76347,76447,55174,21273,286,34,34,52,1276,1276,1242,1242
Yolo,4,2022-01-15,3148,3153,2093,1060,43890,43947,29211,14736,13,4,4,5,279,279,275,275
Yuba,4,2022-01-15,1105,1105,720,385,4012,4017,2614,1403,32,1,1,5,104,104,103,103
Alameda,5,2022-01-22,20551,20579,15255,5324,161602,161818,120066,41752,378,44,44,68,1637,1637,1593,1593
Amador,5,2022-01-22,560,560,357,203,4339,4344,2775,1569,7,0,0,4,73,73,73,73
Butte,5,2022-01-22,1966,1968,1532,436,8699,8711,6784,1927,76,11,11,12,377,377,366,366
Calaveras,5,2022-01-22,594,594,398,196,2441,2445,1637,808,5,1,1,2,98,98,97,97
Colusa,5,2022-01-22,161,161,114,47,811,811,573,238,5,0,0,0,21,21,21,21
Contra Costa,5,2022-01-22,13505,13524,8515,5009,81311,81420,51351,30069,241,20,20,61,1138,1138,1118,1118
Del Norte,5,2022-01-22,297,297,206,91,3830,3836,2652,1184,2,0,0,0,42,42,42,42
El Dorado,5,2022-01-22,1544,1545,1036,509,7234,7243,4859,2384,22,1,1,6,193,193,192,192
Fresno,5,2022-01-22,17664,17689,11393,6296,67771,67862,43734,24128,471,34,34,83,2516,2516,2482,2482
Glenn,5,2022-01-22,253,253,171,82,927,927,626,301,0,1,1,0,41,41,40,40
Humboldt,5,2022-01-22,975,975,671,304,7463,7473,5150,2323,18,3,3,4,130,130,127,127
Imperial,5,2022-01-22,3536,3541,2363,1178,12742,12759,8514,4245,60,16,16,25,873,873,857,857
Inyo,5,2022-01-22,158,158,111,47,610,610,429,181,0,1,1,1,53,53,52,52
Kern,5,2022-01-22,10689,10703,7601,3102,50519,50586,35943,14643,270,48,48,49,2144,2144,2096,2096
Kings,5,2022-01-22,4078,4083,2733,1350,16944,16967,11370,5597,40,5,5,3,399,399,394,394
Lake,5,2022-01-22,685,685,438,247,3183,3188,2033,1155,6,2,2,3,122,122,120,120
Lassen,5,2022-01-22,421,421,306,115,3492,3496,2532,964,1,0,0,0,54,54,54,54
Los Angeles,5,2022-01-22,171709,171938,151066,20872,1532846,1534898,1349639,185259,3795,574,574,774,28840,28840,28266,28266
Madera,5,2022-01-22,2747,2751,1766,985,11431,11446,7335,4111,43,7,7,11,349,349,342,342
Marin,5,2022-01-22,1955,1956,1268,688,17013,17035,11063,5972,41,5,5,10,268,268,263,263
Mariposa,5,2022-01-22,149,149,94,55,940,940,594,346,0,0,0,0,22,22,22,22
Mendocino,5,2022-01-22,962,962,552,410,4824,4830,2774,2056,18,2,2,4,110,110,108,108
Merced,5,2022-01-22,3181,3186,2235,951,12390,12408,8714,3694,49,12,12,12,745,745,733,733
Modoc,5,2022-01-22,16,16,11,5,104,104,74,30,0,1,1,0,7,7,6,6
Mono,5,2022-01-22,97,97,52,45,462,462,245,217,1,0,0,0,5,5,5,5
Monterey,5,2022-01-22,5316,5323,2828,2495,31401,31445,16732,14713,83,6,6,19,666,666,660,660
Napa,5,2022-01-22,1705,1705,1242,463,11817,11834,8629,3205,20,4,4,4,115,115,111,111
Nevada,5,2022-01-22,1043,1043,673,370,4755,4761,3067,1694,19,0,0,7,115,115,115,115
Orange,5,2022-01-22,29909,29948,22596,7352,225914,226216,171020,55196,958,155,155,204,6396,6396,6241,6241
Placer,5,2022-01-22,3815,3821,2379,1442,18218,18242,11357,6885,215,9,9,42,544,544,535,535
Plumas,5,2022-01-22,220,220,144,76,883,883,578,305,6,0,0,0,12,12,12,12
Riverside,5,2022-01-22,33717,33762,23505,10257,156254,156463,109038,47425,875,126,126,173,5883,5883,5757,5757
Sacramento,5,2022-01-22,17911,17935,12201,5734,94867,94994,64681,30313,497,67,67,117,2683,2683,2616,2616
San Benito,5,2022-01-22,853,853,615,238,3959,3964,2864,1100,5,1,1,3,88,88,87,87
San Bernardino,5,2022-01-22,29359,29398,21757,7641,148052,148250,109857,38393,989,171,171,218,7071,7071,6900,6900
San Diego,5,2022-01-22,53837,53910,47037,6873,247142,247472,216012,31460,1098,118,118,211,4790,4790,4672,4672
San Francisco,5,2022-01-22,8888,8900,4517,4383,86764,86880,44250,42630,242,16,16,36,735,735,719,719
San Joaquin,5,2022-01-22,11251,11267,7424,3843,56102,56177,37018,19159,229,31,31,67,2060,2060,2029,2029
San Luis Obispo,5,2022-01-22,3593,3598,2567,1031,20593,20621,14726,5895,40,12,12,11,399,399,387,387
San Mateo,5,2022-01-22,9270,9283,6995,2288,90618,90739,68517,22222,123,14,14,31,630,630,616,616
Santa Barbara,5,2022-01-22,6561,6570,4535,2035,41116,41170,28438,12732,125,14,14,16,612,612,598,598
Santa Clara,5,2022-01-22,23324,23355,20214,3141,220131,220426,190879,29547,422,50,50,93,2087,2087,2037,2037
Santa Cruz,5,2022-01-22,5309,5316,3867,1449,48518,48583,35396,13187,41,3,3,2,241,241,238,238
Shasta,5,2022-01-22,1453,1453,990,463,9453,9466,6445,3021,71,6,6,10,474,474,468,468
Siskiyou,5,2022-01-22,157,157,114,43,821,821,599,222,4,3,3,2,68,68,65,65
Solano,5,2022-01-22,5048,5054,3523,1531,30911,30952,21577,9375,130,14,14,25,418,418,404,404
Sonoma,5,2022-01-22,7203,7212,5055,2157,41260,41315,28967,12348,90,8,8,16,450,450,442,442
Stanislaus,5,2022-01-22,6687,6696,3982,2714,27833,27871,16574,11297,271,21,21,32,1496,1496,1475,1475
Sutter,5,2022-01-22,1109,1109,766,343,4983,4988,3448,1540,0,3,3,0,204,204,201,201
Tehama,5,2022-01-22,575,575,348,227,2445,2449,1484,965,15,4,4,5,176,176,172,172
Trinity,5,2022-01-22,66,66,40,26,311,311,187,124,0,0,0,0,20,20,20,20
Tulare,5,2022-01-22,7778,7789,4597,3192,28375,28413,16778,11635,117,11,11,13,1356,1356,1345,1345
Tuolumne,5,2022-01-22,897,897,577,320,3586,3591,2312,1279,15,3,3,2,167,167,164,164
Ventura,5,2022-01-22,9889,9902,7621,2281,64479,64565,49752,14813,295,36,36,60,1312,1312,1276,1276
Yolo,5,2022-01-22,2316,2319,1663,656,38303,38354,27571,10783,16,9,9,8,288,288,279,279
Yuba,5,2022-01-22,938,938,661,277,3728,3733,2635,1098,57,2,2,8,106,106,104,104
Alameda,6,2022-01-29,12580,12597,9886,2711,143303,143502,112703,30799,338,46,46,79,1683,1683,1637,1637
Amador,6,2022-01-29,365,365,252,113,3261,3265,2261,1004,13,1,1,5,74,74,73,73
Butte,6,2022-01-29,1274,1274,1042,232,7910,7922,6478,1444,94,6,6,7,383,383,377,377
Calaveras,6,2022-01-29,283,283,203,80,1917,1919,1382,537,1,5,5,3,103,103,98,98
Colusa,6,2022-01-29,118,118,89,29,686,686,517,169,2,0,0,0,21,21,21,21
Contra Costa,6,2022-01-29,8382,8394,5735,2659,72238,72337,49544,22793,230,34,34,55,1172,1172,1138,1138
Del Norte,6,2022-01-29,363,363,269,94,4134,4139,3066,1073,6,2,2,3,44,44,42,42
El Dorado,6,2022-01-29,839,839,605,234,6177,6185,4469,1716,15,5,5,5,198,198,193,193
Fresno,6,2022-01-29,12137,12153,8479,3674,58373,58455,40799,17656,481,44,44,105,2560,2560,2516,2516
Glenn,6,2022-01-29,208,208,151,57,762,762,554,208,4,0,0,0,41,41,41,41
Humboldt,6,2022-01-29,616,616,455,161,6162,6169,4556,1613,24,3,3,2,133,133,130,130
Imperial,6,2022-01-29,2539,2542,1823,719,12224,12242,8796,3446,76,16,16,27,889,889,873,873
Inyo,6,2022-01-29,67,67,50,17,508,508,381,127,3,2,2,1,55,55,53,53
Kern,6,2022-01-29,6430,6439,4873,1566,43967,44028,33353,10675,258,44,44,46,2188,2188,2144,2144
Kings,6,2022-01-29,2761,2765,1990,775,15068,15089,10868,4221,48,4,4,4,403,403,399,399
Lake,6,2022-01-29,560,560,387,173,3393,3398,2354,1044,6,4,4,4,126,126,122,122
Lassen,6,2022-01-29,349,349,270,79,3643,3649,2808,841,5,1,1,0,55,55,54,54
Los Angeles,6,2022-01-29,88238,88361,79697,8664,1339379,1341233,1210547,130686,3093,611,611,759,29451,29451,28840,28840
Madera,6,2022-01-29,1810,1811,1258,553,9843,9858,6841,3017,44,4,4,8,353,353,349,349
Marin,6,2022-01-29,1228,1228,861,367,14253,14272,10024,4248,35,3,3,13,271,271,268,268
Mariposa,6,2022-01-29,106,106,73,33,867,867,596,271,0,1,1,0,23,23,22,22
Mendocino,6,2022-01-29,540,540,341,199,3602,3607,2281,1326,12,4,4,2,114,114,110,110
Merced,6,2022-01-29,2307,2311,1732,579,10962,10976,8236,2740,51,11,11,13,756,756,745,745
Modoc,6,2022-01-29,12,12,9,3,98,98,74,24,2,0,0,0,7,7,7,7
Mono,6,2022-01-29,42,42,25,17,344,344,204,140,0,0,0,0,5,5,5,5
Monterey,6,2022-01-29,3857,3862,2284,1578,26893,26930,15944,10986,97,7,7,16,673,673,666,666
Napa,6,2022-01-29,1124,1124,870,254,9857,9871,7641,2230,18,5,5,4,120,120,115,115
Nevada,6,2022-01-29,673,673,469,204,4136,4142,2889,1253,25,4,4,5,119,119,115,115
Orange,6,2022-01-29,14339,14359,11441,2918,185349,185606,148091,37515,794,174,174,173,6570,6570,6396,6396
Placer,6,2022-01-29,2581,2584,1749,835,15852,15873,10758,5115,171,16,16,44,560,560,544,544
Plumas,6,2022-01-29,152,152,107,45,750,750,530,220,2,0,0,0,12,12,12,12
Riverside,6,2022-01-29,19195,19222,14305,4917,127230,127406,94995,32411,786,108,108,166,5991,5991,5883,5883
Sacramento,6,2022-01-29,11765,11781,8601,3180,81485,81598,59658,21940,490,88,88,98,2771,2771,2683,2683
San Benito,6,2022-01-29,524,524,402,122,3368,3373,2593,780,4,0,0,3,88,88,88,88
San Bernardino,6,2022-01-29,15865,15887,12448,3439,122565,122735,96348,26387,783,186,186,221,7257,7257,7071,7071
San Diego,6,2022-01-29,29139,29180,26169,3011,193264,193531,173648,19883,1000,118,118,210,4908,4908,4790,4790
San Francisco,6,2022-01-29,4940,4947,2804,2143,75165,75268,42882,32386,212,20,20,47,755,755,735,735
San Joaquin,6,2022-01-29,6499,6507,4624,1883,45320,45383,32260,13123,235,39,39,71,2099,2099,2060,2060
San Luis Obispo,6,2022-01-29,2307,2309,1754,555,17212,17236,13112,4124,57,11,11,10,410,410,399,399
San Mateo,6,2022-01-29,5103,5111,4067,1044,79522,79632,63466,16166,125,13,13,30,643,643,630,630
Santa Barbara,6,2022-01-29,4281,4288,3166,1122,36541,36593,27066,9527,95,19,19,17,631,631,612,612
Santa Clara,6,2022-01-29,15792,15815,14096,1719,209809,210098,187400,22698,422,45,45,96,2132,2132,2087,2087
Santa Cruz,6,2022-01-29,3558,3563,2749,814,46910,46974,36349,10625,45,5,5,0,246,246,241,241
Shasta,6,2022-01-29,1055,1055,771,284,8675,8688,6349,2339,74,14,14,8,488,488,474,474
Siskiyou,6,2022-01-29,123,123,95,28,699,699,542,157,10,1,1,3,69,69,68,68
Solano,6,2022-01-29,4161,4167,3113,1054,30007,30049,22431,7618,133,8,8,32,426,426,418,418
Sonoma,6,2022-01-29,4212,4218,3155,1063,33728,33775,25293,8482,89,10,10,12,460,460,450,450
Stanislaus,6,2022-01-29,4105,4111,2676,1435,22824,22855,14896,7959,273,33,33,48,1529,1529,1496,1496
Sutter,6,2022-01-29,704,704,521,183,3938,3943,2919,1024,0,1,1,0,205,205,204,204
Tehama,6,2022-01-29,404,404,267,137,2160,2163,1431,732,17,2,2,5,178,178,176,176
Trinity,6,2022-01-29,39,39,26,13,221,221,145,76,0,0,0,0,20,20,20,20
Tulare,6,2022-01-29,5324,5331,3450,1881,24541,24576,15917,8659,130,17,17,19,1373,1373,1356,1356
Tuolumne,6,2022-01-29,832,832,578,254,3418,3423,2385,1038,16,2,2,3,169,169,167,167
Ventura,6,2022-01-29,5565,5573,4510,1063,55446,55523,44984,10539,260,33,33,52,1345,1345,1312,1312
Yolo,6,2022-01-29,1577,1578,1204,374,37776,37828,28963,8865,14,3,3,7,291,291,288,288
Yuba,6,2022-01-29,606,606,456,150,3067,3072,2314,758,68,3,3,7,109,109,106,106
Alameda,7,2022-02-05,6869,6879,5664,1215,121439,121617,100268,21349,282,46,46,65,1729,1729,1683,1683
Amador,7,2022-02-05,237,237,175,62,3060,3065,2272,793,12,3,3,4,77,77,74,74
Butte,7,2022-02-05,874,874,744,130,6580,6591,5615,976,75,7,7,10,390,390,383,383
Calaveras,7,2022-02-05,213,213,163,50,1564,1565,1199,366,1,3,3,1,106,106,103,103
Colusa,7,2022-02-05,85,85,68,17,568,568,452,116,4,0,0,0,21,21,21,21
Contra Costa,7,2022-02-05,4585,4591,3374,1217,57646,57731,42487,15244,183,34,34,56,1206,1206,1172,1172
Del Norte,7,2022-02-05,247,247,194,53,3905,3911,3071,840,5,0,0,2,44,44,44,44
El Dorado,7,2022-02-05,499,499,383,116,5152,5159,3967,1192,24,1,1,5,199,199,198,198
Fresno,7,2022-02-05,7098,7108,5310,1798,45882,45949,34355,11594,468,43,43,93,2603,2603,2560,2560
Glenn,7,2022-02-05,138,138,107,31,641,641,495,146,4,0,0,0,41,41,41,41
Humboldt,7,2022-02-05,493,493,386,107,5028,5034,3944,1090,18,1,1,3,134,134,133,133
Imperial,7,2022-02-05,1288,1288,985,303,8844,8857,6783,2074,53,18,18,28,907,907,889,889
Inyo,7,2022-02-05,52,52,41,11,448,448,356,92,3,1,1,0,56,56,55,55
Kern,7,2022-02-05,3917,3922,3137,785,36335,36388,29117,7271,187,37,37,46,2225,2225,2188,2188
Kings,7,2022-02-05,1511,1513,1160,353,10786,10802,8290,2512,50,10,10,7,413,413,403,403
Lake,7,2022-02-05,385,385,286,99,2746,2751,2044,707,5,2,2,4,128,128,126,126
Lassen,7,2022-02-05,154,154,125,29,3203,3209,2600,609,5,2,2,0,57,57,55,55
Los Angeles,7,2022-02-05,43699,43763,40341,3422,1182313,1184043,1092143,91900,2242,684,684,599,30135,30135,29451,29451
Madera,7,2022-02-05,1230,1230,915,315,8417,8429,6275,2154,35,6,6,16,359,359,353,353
Marin,7,2022-02-05,725,725,545,180,12072,12089,9082,3007,26,8,8,7,279,279,271,271
Mariposa,7,2022-02-05,56,56,41,15,624,624,460,164,0,1,1,0,24,24,23,23
Mendocino,7,2022-02-05,353,353,243,110,2983,2988,2056,932,12,1,1,6,115,115,114,114
Merced,7,2022-02-05,1342,1343,1065,278,8413,8426,6689,1737,53,11,11,11,767,767,756,756
Modoc,7,2022-02-05,22,22,18,4,159,159,128,31,3,0,0,0,7,7,7,7
Mono,7,2022-02-05,46,46,30,16,270,270,175,95,0,0,0,0,5,5,5,5
Monterey,7,2022-02-05,2480,2484,1614,870,23043,23077,14997,8080,84,12,12,12,685,685,673,673
Napa,7,2022-02-05,792,792,645,147,8029,8040,6548,1492,22,7,7,1,127,127,120,120
Nevada,7,2022-02-05,390,390,292,98,3287,3292,2461,831,24,2,2,3,121,121,119,119
Orange,7,2022-02-05,7340,7351,6134,1217,156213,156442,130658,25784,507,127,127,120,6697,6697,6570,6570
Placer,7,2022-02-05,1511,1511,1101,410,12790,12809,9336,3473,145,21,21,39,581,581,560,560
Plumas,7,2022-02-05,100,100,75,25,575,575,433,142,1,1,1,0,13,13,12,12
Riverside,7,2022-02-05,9477,9491,7489,2002,100188,100336,79240,21096,595,109,109,125,6100,6100,5991,5991
Sacramento,7,2022-02-05,6911,6921,5377,1544,66305,66402,51613,14789,410,74,74,92,2845,2845,2771,2771
San Benito,7,2022-02-05,335,335,271,64,2816,2821,2284,537,4,2,2,4,90,90,88,88
San Bernardino,7,2022-02-05,8083,8096,6662,1434,94420,94558,77901,16657,555,163,163,165,7420,7420,7257,7257
San Diego,7,2022-02-05,15608,15631,14347,1284,158246,158478,145520,12958,809,108,108,182,5016,5016,4908,4908
San Francisco,7,2022-02-05,2642,2646,1664,982,57597,57682,36344,21338,184,32,32,41,787,787,755,755
San Joaquin,7,2022-02-05,3806,3811,2894,917,38100,38155,28979,9176,182,36,36,68,2135,2135,2099,2099
San Luis Obispo,7,2022-02-05,1427,1428,1146,282,13339,13359,10732,2627,33,14,14,7,424,424,410,410
San Mateo,7,2022-02-05,2849,2854,2379,475,64197,64292,53644,10648,108,15,15,17,658,658,643,643
Santa Barbara,7,2022-02-05,2701,2706,2122,584,33543,33591,26369,7222,85,16,16,17,647,647,631,631
Santa Clara,7,2022-02-05,9073,9086,8297,789,178960,179222,163727,15495,374,35,35,78,2167,2167,2132,2132
Santa Cruz,7,2022-02-05,2103,2106,1710,396,39284,39341,31947,7394,32,3,3,6,249,249,246,246
Shasta,7,2022-02-05,730,730,568,162,7220,7231,5615,1616,62,16,16,13,504,504,488,488
Siskiyou,7,2022-02-05,103,103,84,19,704,704,573,131,8,3,3,0,72,72,69,69
Solano,7,2022-02-05,2537,2540,2004,536,24740,24776,19567,5209,96,6,6,25,432,432,426,426
Sonoma,7,2022-02-05,2315,2318,1838,480,28050,28091,22275,5816,69,9,9,10,469,469,460,460
Stanislaus,7,2022-02-05,2796,2801,1976,825,19673,19701,13898,5803,245,46,46,40,1575,1575,1529,1529
Sutter,7,2022-02-05,429,429,337,92,3474,3479,2731,748,0,7,7,0,212,212,205,205
Tehama,7,2022-02-05,328,328,234,94,1720,1722,1229,493,19,2,2,5,180,180,178,178
Trinity,7,2022-02-05,24,24,17,7,151,151,107,44,0,0,0,0,20,20,20,20
Tulare,7,2022-02-05,3102,3107,2179,928,18704,18731,13150,5581,142,31,31,22,1404,1404,1373,1373
Tuolumne,7,2022-02-05,404,404,301,103,2680,2685,2004,681,12,3,3,1,172,172,169,169
Ventura,7,2022-02-05,3003,3008,2543,465,43500,43564,36837,6727,200,42,42,44,1387,1387,1345,1345
Yolo,7,2022-02-05,976,976,786,190,32573,32621,26315,6306,8,10,10,6,301,301,291,291
Yuba,7,2022-02-05,388,388,309,79,2521,2525,2011,514,45,4,4,13,113,113,109,109
Alameda,8,2022-02-12,4022,4028,3451,577,103067,103222,88530,14692,195,48,48,61,1777,1777,1729,1729
Amador,8,2022-02-12,114,114,89,25,2427,2432,1913,519,11,2,2,4,79,79,77,77
Butte,8,2022-02-12,544,544,479,65,5547,5555,4892,663,68,11,11,8,401,401,390,390
Calaveras,8,2022-02-12,111,111,89,22,1319,1319,1066,253,5,2,2,1,108,108,106,106
Colusa,8,2022-02-12,47,47,39,8,517,517,430,87,3,0,0,0,21,21,21,21
Contra Costa,8,2022-02-12,2732,2737,2137,600,46547,46618,36441,10177,142,25,25,30,1231,1231,1206,1206
Del Norte,8,2022-02-12,256,256,210,46,3687,3693,3039,654,8,0,0,1,44,44,44,44
El Dorado,8,2022-02-12,303,303,245,58,4674,4681,3792,889,23,4,4,2,203,203,199,199
Fresno,8,2022-02-12,4281,4287,3392,895,37019,37075,29354,7721,383,38,38,76,2641,2641,2603,2603
Glenn,8,2022-02-12,61,61,50,11,480,480,390,90,4,1,1,0,42,42,41,41
Humboldt,8,2022-02-12,395,395,325,70,4492,4498,3700,798,17,1,1,2,135,135,134,134
Imperial,8,2022-02-12,692,692,558,134,6635,6645,5365,1280,48,13,13,20,920,920,907,907
Inyo,8,2022-02-12,29,29,24,5,409,409,340,69,2,0,0,0,56,56,56,56
Kern,8,2022-02-12,2412,2416,2022,394,30146,30191,25272,4919,161,30,30,44,2255,2255,2225,2225
Kings,8,2022-02-12,916,916,740,176,8410,8423,6810,1613,46,13,13,6,426,426,413,413
Lake,8,2022-02-12,260,260,205,55,2426,2430,1913,517,5,0,0,5,128,128,128,128
Lassen,8,2022-02-12,137,137,116,21,3018,3022,2557,465,3,2,2,0,59,59,57,57
Los Angeles,8,2022-02-12,24994,25033,23484,1549,1084961,1086610,1019724,66886,1647,523,523,439,30658,30658,30135,30135
Madera,8,2022-02-12,706,706,557,149,7089,7100,5600,1500,36,2,2,8,361,361,359,359
Marin,8,2022-02-12,424,424,337,87,10393,10409,8278,2131,23,7,7,5,286,286,279,279
Mariposa,8,2022-02-12,28,28,22,6,436,436,341,95,0,0,0,0,24,24,24,24
Mendocino,8,2022-02-12,233,233,172,61,2483,2487,1837,650,11,2,2,7,117,117,115,115
Merced,8,2022-02-12,850,850,707,143,7271,7283,6057,1226,40,11,11,7,778,778,767,767
Modoc,8,2022-02-12,20,20,17,3,189,189,158,31,0,0,0,0,7,7,7,7
Mono,8,2022-02-12,14,14,10,4,180,180,126,54,0,0,0,0,5,5,5,5
Monterey,8,2022-02-12,1443,1444,1016,428,18800,18827,13243,5584,72,13,13,16,698,698,685,685
Napa,8,2022-02-12,471,471,399,72,6888,6897,5856,1041,15,2,2,2,129,129,127,127
Nevada,8,2022-02-12,208,208,164,44,2700,2704,2138,566,18,1,1,2,122,122,121,121
Orange,8,2022-02-12,4472,4479,3880,599,136341,136547,118280,18267,360,120,120,96,6817,6817,6697,6697
Placer,8,2022-02-12,762,762,590,172,10561,10577,8200,2377,113,15,15,28,596,596,581,581
Plumas,8,2022-02-12,48,48,38,10,440,440,350,90,2,0,0,0,13,13,13,13
Riverside,8,2022-02-12,5385,5393,4464,929,79674,79795,66091,13704,409,92,92,94,6192,6192,6100,6100
Sacramento,8,2022-02-12,3925,3931,3211,720,55897,55982,45760,10222,357,60,60,70,2905,2905,2845,2845
San Benito,8,2022-02-12,212,212,179,33,2309,2312,1954,358,4,1,1,3,91,91,90,90
San Bernardino,8,2022-02-12,4477,4483,3838,645,77455,77574,66491,11083,387,104,104,124,7524,7524,7420,7420
San Diego,8,2022-02-12,9380,9394,8781,613,132367,132568,123959,8609,602,96,96,149,5112,5112,5016,5016
San Francisco,8,2022-02-12,1825,1827,1249,578,49114,49188,33734,15454,139,22,22,44,809,809,787,787
San Joaquin,8,2022-02-12,2301,2304,1848,456,32466,32517,26071,6446,134,37,37,55,2172,2172,2135,2135
San Luis Obispo,8,2022-02-12,879,879,738,141,10564,10581,8887,1694,23,11,11,7,435,435,424,424
San Mateo,8,2022-02-12,1563,1564,1353,211,56905,56991,49355,7636,62,18,18,13,676,676,658,658
Santa Barbara,8,2022-02-12,1287,1287,1060,227,23530,23566,19431,4135,65,9,9,13,656,656,647,647
Santa Clara,8,2022-02-12,5401,5409,5036,373,159895,160138,149140,10998,306,30,30,60,2197,2197,2167,2167
Santa Cruz,8,2022-02-12,1175,1175,994,181,34165,34218,28974,5244,28,4,4,5,253,253,249,249
Shasta,8,2022-02-12,501,501,409,92,6175,6184,5049,1135,65,11,11,13,515,515,504,504
Siskiyou,8,2022-02-12,79,79,67,12,589,589,500,89,3,1,1,2,73,73,72,72
Solano,8,2022-02-12,1373,1373,1137,236,20393,20423,16911,3512,77,1,1,19,433,433,432,432
Sonoma,8,2022-02-12,1369,1370,1137,233,23424,23460,19485,3975,44,9,9,16,478,478,469,469
Stanislaus,8,2022-02-12,1640,1641,1237,404,16392,16417,12383,4034,198,24,24,44,1599,1599,1575,1575
Sutter,8,2022-02-12,246,246,203,43,2987,2992,2467,525,0,3,3,0,215,215,212,212
Tehama,8,2022-02-12,197,197,150,47,1453,1454,1109,345,14,7,7,5,187,187,180,180
Trinity,8,2022-02-12,21,21,16,5,162,162,123,39,0,0,0,0,20,20,20,20
Tulare,8,2022-02-12,1773,1775,1332,443,16308,16332,12283,4049,122,21,21,24,1425,1425,1404,1404
Tuolumne,8,2022-02-12,224,224,177,47,2349,2353,1861,492,11,3,3,1,175,175,172,172
Ventura,8,2022-02-12,1813,1814,1587,227,38416,38474,33679,4795,160,42,42,30,1429,1429,1387,1387
Yolo,8,2022-02-12,596,596,501,95,28976,29019,24463,4556,13,8,8,2,309,309,301,301
Yuba,8,2022-02-12,248,248,207,41,2191,2195,1830,365,27,1,1,14,114,114,113,113
Alameda,9,2022-02-19,2239,2242,1984,258,90486,90627,80239,10388,155,23,23,36,1800,1800,1777,1777
Amador,9,2022-02-19,89,89,73,16,2160,2163,1785,378,7,4,4,2,83,83,79,79
Butte,9,2022-02-19,309,309,279,30,4630,4636,4194,442,61,11,11,10,412,412,401,401
Calaveras,9,2022-02-19,51,51,43,8,957,957,808,149,4,4,4,2,112,112,108,108
Colusa,9,2022-02-19,26,26,22,4,380,380,329,51,6,0,0,0,21,21,21,21
Contra Costa,9,2022-02-19,1634,1635,1341,294,39869,39932,32779,7153,93,16,16,24,1247,1247,1231,1231
Del Norte,9,2022-02-19,155,155,133,22,3075,3080,2638,442,8,0,0,1,44,44,44,44
El Dorado,9,2022-02-19,171,171,145,26,4003,4008,3390,618,7,1,1,3,204,204,203,203
Fresno,9,2022-02-19,2446,2450,2032,418,30198,30244,25099,5145,293,32,32,67,2673,2673,2641,2641
Glenn,9,2022-02-19,33,33,28,5,405,405,343,62,2,0,0,0,42,42,42,42
Humboldt,9,2022-02-19,237,237,203,34,3787,3792,3248,544,17,3,3,3,138,138,135,135
Imperial,9,2022-02-19,451,451,380,71,5305,5314,4485,829,37,6,6,10,926,926,920,920
Inyo,9,2022-02-19,14,14,12,2,379,379,327,52,1,0,0,0,56,56,56,56
Kern,9,2022-02-19,1410,1411,1225,186,25890,25930,22531,3399,94,25,25,30,2280,2280,2255,2255
Kings,9,2022-02-19,570,570,482,88,7347,7359,6221,1138,28,4,4,5,430,430,426,426
Lake,9,2022-02-19,226,226,186,40,2194,2197,1816,381,7,3,3,2,131,131,128,128
Lassen,9,2022-02-19,135,135,118,17,2380,2384,2087,297,4,0,0,0,59,59,59,59
Los Angeles,9,2022-02-19,14094,14117,13427,690,986496,988042,940016,48026,1090,344,344,301,31002,31002,30658,30658
Madera,9,2022-02-19,415,415,343,72,5895,5904,4884,1020,27,3,3,8,364,364,361,361
Marin,9,2022-02-19,261,261,217,44,9932,9948,8287,1661,15,3,3,5,289,289,286,286
Mariposa,9,2022-02-19,20,20,16,4,408,408,335,73,0,1,1,0,25,25,24,24
Mendocino,9,2022-02-19,138,138,108,30,2245,2250,1764,486,7,2,2,3,119,119,117,117
Merced,9,2022-02-19,549,549,474,75,5975,5983,5168,815,2,14,14,6,792,792,778,778
Modoc,9,2022-02-19,10,10,9,1,72,72,62,10,1,0,0,0,7,7,7,7
Mono,9,2022-02-19,8,8,6,2,172,172,129,43,0,1,1,0,6,6,5,5
Monterey,9,2022-02-19,897,897,676,221,14923,14946,11260,3686,54,6,6,7,704,704,698,698
Napa,9,2022-02-19,303,303,266,37,5768,5777,5075,702,7,4,4,3,133,133,129,129
Nevada,9,2022-02-19,129,129,107,22,2372,2376,1970,406,18,3,3,3,125,125,122,122
Orange,9,2022-02-19,2855,2860,2552,308,127030,127228,113566,13662,273,82,82,79,6899,6899,6817,6817
Placer,9,2022-02-19,378,378,308,70,9378,9393,7665,1728,96,10,10,18,606,606,596,596
Plumas,9,2022-02-19,24,24,20,4,384,384,320,64,1,0,0,0,13,13,13,13
Riverside,9,2022-02-19,2937,2943,2531,412,67166,67272,57934,9338,283,61,61,68,6253,6253,6192,6192
Sacramento,9,2022-02-19,2374,2378,2024,354,48734,48811,41577,7234,270,41,41,49,2946,2946,2905,2905
San Benito,9,2022-02-19,134,134,117,17,2050,2054,1798,256,2,0,0,2,91,91,91,91
San Bernardino,9,2022-02-19,2254,2257,1996,261,66093,66197,58609,7588,277,108,108,89,7632,7632,7524,7524
San Diego,9,2022-02-19,5346,5356,5080,276,111149,111324,105601,5723,475,68,68,114,5180,5180,5112,5112
San Francisco,9,2022-02-19,1131,1131,832,299,45333,45404,33464,11940,116,11,11,24,820,820,809,809
San Joaquin,9,2022-02-19,1297,1297,1087,210,27648,27691,23221,4470,89,25,25,40,2197,2197,2172,2172
San Luis Obispo,9,2022-02-19,579,579,504,75,8985,8999,7835,1164,24,13,13,2,448,448,435,435
San Mateo,9,2022-02-19,886,886,790,96,49776,49854,44483,5371,52,6,6,8,682,682,676,676
Santa Barbara,9,2022-02-19,748,748,641,107,21656,21690,18597,3093,44,9,9,12,665,665,656,656
Santa Clara,9,2022-02-19,2987,2993,2830,163,139675,139894,132285,7609,240,23,23,56,2220,2220,2197,2197
Santa Cruz,9,2022-02-19,664,664,581,83,28325,28369,24872,3497,20,1,1,4,254,254,253,253
Shasta,9,2022-02-19,323,323,275,48,5417,5425,4617,808,50,11,11,15,526,526,515,515
Siskiyou,9,2022-02-19,54,54,47,7,535,535,470,65,8,2,2,3,75,75,73,73
Solano,9,2022-02-19,778,778,669,109,16743,16768,14437,2331,53,5,5,17,438,438,433,433
Sonoma,9,2022-02-19,782,782,674,108,18946,18976,16376,2600,33,2,2,7,480,480,478,478
Stanislaus,9,2022-02-19,912,912,726,186,13534,13556,10816,2740,153,34,34,34,1633,1633,1599,1599
Sutter,9,2022-02-19,154,154,132,22,2405,2409,2065,344,0,2,2,0,217,217,215,215
Tehama,9,2022-02-19,118,118,95,23,1255,1255,1010,245,10,4,4,4,191,191,187,187
Trinity,9,2022-02-19,16,16,13,3,224,224,179,45,0,0,0,0,20,20,20,20
Tulare,9,2022-02-19,955,955,758,197,12432,12451,9897,2554,89,19,19,10,1444,1444,1425,1425
Tuolumne,9,2022-02-19,121,121,100,21,1957,1960,1624,336,6,5,5,1,180,180,175,175
Ventura,9,2022-02-19,1018,1018,916,102,30908,30956,27866,3090,107,18,18,24,1447,1447,1429,1429
Yolo,9,2022-02-19,335,335,292,43,24102,24139,21085,3054,7,4,4,3,313,313,309,309
Yuba,9,2022-02-19,158,158,137,21,1792,1794,1553,241,20,1,1,9,115,115,114,114
Alameda,10,2022-02-26,1486,1486,1350,136,68978,69090,62822,6268,118,21,21,26,1821,1821,1800,1800
Amador,10,2022-02-26,66,66,57,9,1995,1999,1719,280,8,1,1,2,84,84,83,83
Butte,10,2022-02-26,190,190,176,14,3990,3996,3694,302,45,7,7,3,419,419,412,412
Calaveras,10,2022-02-26,34,34,30,4,1064,1064,931,133,0,4,4,0,116,116,112,112
Colusa,10,2022-02-26,11,11,10,1,362,362,323,39,3,0,0,0,21,21,21,21
Contra Costa,10,2022-02-26,963,963,823,140,31617,31668,27105,4563,67,16,16,18,1263,1263,1247,1247
Del Norte,10,2022-02-26,87,87,77,10,2693,2697,2387,310,5,2,2,1,46,46,44,44
El Dorado,10,2022-02-26,117,117,102,15,3361,3366,2949,417,5,2,2,4,206,206,204,204
Fresno,10,2022-02-26,1326,1327,1144,183,25116,25156,21706,3450,211,27,27,57,2700,2700,2673,2673
Glenn,10,2022-02-26,21,21,18,3,376,376,330,46,0,0,0,0,42,42,42,42
Humboldt,10,2022-02-26,137,137,121,16,2759,2764,2446,318,7,0,0,1,138,138,138,138
Imperial,10,2022-02-26,270,270,236,34,4507,4513,3945,568,14,7,7,10,933,933,926,926
Inyo,10,2022-02-26,9,9,8,1,327,327,291,36,0,0,0,0,56,56,56,56
Kern,10,2022-02-26,860,860,769,91,22370,22407,20054,2353,80,18,18,21,2298,2298,2280,2280
Kings,10,2022-02-26,256,256,224,32,5893,5902,5165,737,18,6,6,3,436,436,430,430
Lake,10,2022-02-26,128,128,110,18,1809,1812,1558,254,2,4,4,1,135,135,131,131
Lassen,10,2022-02-26,59,59,53,6,1996,1999,1799,200,1,2,2,0,61,61,59,59
Los Angeles,10,2022-02-26,8481,8494,8168,326,926092,927594,892459,35135,787,249,249,188,31251,31251,31002,31002
Madera,10,2022-02-26,201,201,173,28,4161,4167,3588,579,20,2,2,6,366,366,364,364
Marin,10,2022-02-26,145,145,125,20,7103,7115,6156,959,12,2,2,2,291,291,289,289
Mariposa,10,2022-02-26,34,34,29,5,324,324,277,47,0,0,0,0,25,25,25,25
Mendocino,10,2022-02-26,79,79,65,14,1715,1716,1414,302,6,1,1,4,120,120,119,119
Merced,10,2022-02-26,282,282,251,31,4721,4727,4212,515,28,8,8,3,800,800,792,792
Modoc,10,2022-02-26,6,6,5,1,50,50,45,5,1,0,0,0,7,7,7,7
Mono,10,2022-02-26,5,5,4,1,166,166,132,34,0,0,0,0,6,6,6,6
Monterey,10,2022-02-26,415,415,330,85,12743,12763,10178,2585,25,9,9,7,713,713,704,704
Napa,10,2022-02-26,173,173,156,17,4942,4950,4472,478,7,4,4,1,137,137,133,133
Nevada,10,2022-02-26,78,78,67,11,1985,1988,1715,273,9,0,0,3,125,125,125,125
Orange,10,2022-02-26,1849,1851,1692,159,114704,114890,105158,9732,212,53,53,40,6952,6952,6899,6899
Placer,10,2022-02-26,270,270,230,40,7934,7947,6761,1186,87,5,5,12,611,611,606,606
Plumas,10,2022-02-26,26,26,23,3,342,342,296,46,0,0,0,0,13,13,13,13
Riverside,10,2022-02-26,1774,1775,1577,198,59498,59594,52964,6630,209,36,36,49,6289,6289,6253,6253
Sacramento,10,2022-02-26,1202,1202,1058,144,41212,41279,36380,4899,191,29,29,33,2975,2975,2946,2946
San Benito,10,2022-02-26,60,60,54,6,1584,1586,1429,157,0,0,0,1,91,91,91,91
San Bernardino,10,2022-02-26,1270,1270,1153,117,56742,56835,51646,5189,172,66,66,49,7698,7698,7632,7632
San Diego,10,2022-02-26,3259,3265,3133,132,93933,94085,90294,3791,364,42,42,86,5222,5222,5180,5180
San Francisco,10,2022-02-26,864,864,676,188,36455,36515,28608,7907,78,17,17,21,837,837,820,820
San Joaquin,10,2022-02-26,720,720,626,94,23393,23431,20390,3041,66,14,14,24,2211,2211,2197,2197
San Luis Obispo,10,2022-02-26,316,316,283,33,7522,7534,6759,775,13,10,10,3,458,458,448,448
San Mateo,10,2022-02-26,548,548,501,47,35222,35279,32272,3007,37,8,8,9,690,690,682,682
Santa Barbara,10,2022-02-26,411,411,364,47,19324,19356,17148,2208,34,5,5,10,670,670,665,665
Santa Clara,10,2022-02-26,1758,1759,1684,75,83553,83689,80132,3557,197,26,26,44,2246,2246,2220,2220
Santa Cruz,10,2022-02-26,479,479,432,47,23773,23813,21483,2330,16,1,1,3,255,255,254,254
Shasta,10,2022-02-26,170,170,150,20,4569,4576,4028,548,41,9,9,8,535,535,526,526
Siskiyou,10,2022-02-26,29,29,26,3,396,396,357,39,4,4,4,2,79,79,75,75
Solano,10,2022-02-26,485,485,431,54,14232,14256,12672,1584,49,2,2,16,440,440,438,438
Sonoma,10,2022-02-26,456,456,406,50,15037,15060,13413,1647,21,2,2,4,482,482,480,480
Stanislaus,10,2022-02-26,511,511,427,84,11915,11934,9975,1959,130,16,16,24,1649,1649,1633,1633
Sutter,10,2022-02-26,101,101,89,12,2203,2206,1955,251,0,1,1,0,218,218,217,217
Tehama,10,2022-02-26,59,59,50,9,1108,1108,932,176,8,7,7,2,198,198,191,191
Trinity,10,2022-02-26,6,6,5,1,111,111,93,18,0,0,0,0,20,20,20,20
Tulare,10,2022-02-26,492,492,410,82,11093,11112,9263,1849,72,16,16,10,1460,1460,1444,1444
Tuolumne,10,2022-02-26,81,81,70,11,1430,1430,1232,198,6,4,4,1,184,184,180,180
Ventura,10,2022-02-26,613,613,564,49,27342,27386,25220,2166,75,17,17,17,1464,1464,1447,1447
Yolo,10,2022-02-26,215,215,193,22,22508,22544,20280,2264,5,2,2,4,315,315,313,313
Yuba,10,2022-02-26,77,77,69,8,1703,1704,1520,184,14,1,1,6,116,116,115,115
Alameda,11,2022-03-05,1160,1160,1075,85,73829,73953,68564,5389,82,9,9,26,1830,1830,1821,1821
Amador,11,2022-03-05,75,75,66,9,1385,1386,1227,159,5,2,2,1,86,86,84,84
Butte,11,2022-03-05,132,132,124,8,3668,3674,3453,221,28,5,5,3,424,424,419,419
Calaveras,11,2022-03-05,29,29,26,3,1121,1121,1008,113,1,2,2,0,118,118,116,116
Colusa,11,2022-03-05,10,10,9,1,344,344,314,30,6,0,0,0,21,21,21,21
Contra Costa,11,2022-03-05,651,651,575,76,31788,31841,28123,3718,54,11,11,12,1274,1274,1263,1263
Del Norte,11,2022-03-05,54,54,49,5,1862,1865,1693,172,5,1,1,1,47,47,46,46
El Dorado,11,2022-03-05,91,91,82,9,3261,3266,2940,326,4,3,3,2,209,209,206,206
Fresno,11,2022-03-05,953,953,847,106,22822,22859,20327,2532,143,21,21,32,2721,2721,2700,2700
Glenn,11,2022-03-05,12,12,11,1,367,367,331,36,1,0,0,0,42,42,42,42
Humboldt,11,2022-03-05,112,112,101,11,3066,3071,2788,283,5,3,3,3,141,141,138,138
Imperial,11,2022-03-05,168,168,151,17,4516,4523,4065,458,9,5,5,12,938,938,933,933
Inyo,11,2022-03-05,9,9,8,1,371,371,338,33,1,0,0,0,56,56,56,56
Kern,11,2022-03-05,512,512,469,43,21663,21700,19870,1830,62,10,10,16,2308,2308,2298,2298
Kings,11,2022-03-05,165,165,148,17,5084,5092,4580,512,12,4,4,1,440,440,436,436
Lake,11,2022-03-05,66,66,58,8,1824,1827,1620,207,4,3,3,1,138,138,135,135
Lassen,11,2022-03-05,83,83,76,7,1825,1827,1680,147,0,1,1,0,62,62,61,61
Los Angeles,11,2022-03-05,6145,6155,5969,186,888923,890398,863611,26787,624,182,182,131,31433,31433,31251,31251
Madera,11,2022-03-05,129,129,114,15,4124,4130,3665,465,13,1,1,1,367,367,366,366
Marin,11,2022-03-05,171,171,152,19,7697,7709,6869,840,9,1,1,2,292,292,291,291
Mariposa,11,2022-03-05,14,14,12,2,304,304,268,36,0,2,2,0,27,27,25,25
Mendocino,11,2022-03-05,73,73,63,10,1772,1774,1519,255,8,1,1,2,121,121,120,120
Merced,11,2022-03-05,203,203,185,18,4667,4674,4266,408,20,8,8,5,808,808,800,800
Modoc,11,2022-03-05,1,1,1,0,52,52,48,4,0,0,0,0,7,7,7,7
Mono,11,2022-03-05,3,3,2,1,130,130,108,22,0,0,0,1,6,6,6,6
Monterey,11,2022-03-05,269,269,224,45,11527,11546,9624,1922,18,7,7,3,720,720,713,713
Napa,11,2022-03-05,199,199,184,15,5017,5024,4634,390,6,1,1,3,138,138,137,137
Nevada,11,2022-03-05,47,47,42,5,1755,1758,1563,195,5,1,1,0,126,126,125,125
Orange,11,2022-03-05,1325,1325,1235,90,109653,109835,102383,7452,150,31,31,39,6983,6983,6952,6952
Placer,11,2022-03-05,174,174,153,21,7853,7866,6918,948,66,2,2,11,613,613,611,611
Plumas,11,2022-03-05,4,4,4,0,274,274,244,30,0,0,0,0,13,13,13,13
Riverside,11,2022-03-05,1090,1090,992,98,55300,55393,50445,4948,137,37,37,32,6326,6326,6289,6289
Sacramento,11,2022-03-05,851,851,769,82,40180,40245,36398,3847,136,19,19,25,2994,2994,2975,2975
San Benito,11,2022-03-05,38,38,35,3,1538,1540,1417,123,0,1,1,2,92,92,91,91
San Bernardino,11,2022-03-05,881,881,816,65,54348,54438,50462,3976,98,41,41,47,7739,7739,7698,7698
San Diego,11,2022-03-05,2452,2457,2379,78,96826,96986,93899,3087,253,33,33,61,5255,5255,5222,5222
San Francisco,11,2022-03-05,690,690,566,124,38181,38244,31418,6826,58,8,8,11,845,845,837,837
San Joaquin,11,2022-03-05,455,455,408,47,21391,21426,19179,2247,42,10,10,18,2221,2221,2211,2211
San Luis Obispo,11,2022-03-05,303,303,278,25,7388,7400,6788,612,8,5,5,1,463,463,458,458
San Mateo,11,2022-03-05,563,563,525,38,41691,41760,38902,2858,33,1,1,4,691,691,690,690
Santa Barbara,11,2022-03-05,215,215,195,20,18202,18232,16555,1677,17,4,4,9,674,674,670,670
Santa Clara,11,2022-03-05,1507,1507,1456,51,116403,116597,112657,3940,151,11,11,46,2257,2257,2246,2246
Santa Cruz,11,2022-03-05,348,348,321,27,25055,25097,23118,1979,11,1,1,6,256,256,255,255
Shasta,11,2022-03-05,146,146,132,14,4962,4970,4492,478,36,10,10,5,545,545,535,535
Siskiyou,11,2022-03-05,19,19,18,1,417,417,384,33,1,0,0,0,79,79,79,79
Solano,11,2022-03-05,387,387,352,35,13969,13992,12738,1254,49,4,4,11,444,444,440,440
Sonoma,11,2022-03-05,379,379,346,33,15513,15538,14172,1366,24,4,4,5,486,486,482,482
Stanislaus,11,2022-03-05,308,308,267,41,11173,11192,9694,1498,101,11,11,14,1660,1660,1649,1649
Sutter,11,2022-03-05,87,87,79,8,2020,2024,1838,186,0,3,3,0,221,221,218,218
Tehama,11,2022-03-05,49,49,43,6,1201,1202,1047,155,6,0,0,2,198,198,198,198
Trinity,11,2022-03-05,6,6,5,1,111,111,96,15,0,0,0,0,20,20,20,20
Tulare,11,2022-03-05,338,338,292,46,10311,10328,8933,1395,41,8,8,5,1468,1468,1460,1460
Tuolumne,11,2022-03-05,54,54,48,6,1285,1285,1142,143,1,1,1,2,185,185,184,184
Ventura,11,2022-03-05,413,413,387,26,27253,27297,25576,1721,40,3,3,15,1467,1467,1464,1464
Yolo,11,2022-03-05,170,170,156,14,22592,22629,20793,1836,3,2,2,3,317,317,315,315
Yuba,11,2022-03-05,69,69,63,6,1619,1621,1481,140,12,0,0,6,116,116,116,116
Alameda,12,2022-03-12,959,959,903,56,68659,68777,64810,3967,71,13,13,7,1843,1843,1830,1830
Amador,12,2022-03-12,32,32,29,3,1460,1461,1327,134,5,0,0,0,86,86,86,86
Butte,12,2022-03-12,75,75,71,4,3445,3450,3286,164,18,2,2,1,426,426,424,424
Calaveras,12,2022-03-12,16,16,15,1,1052,1052,967,85,1,1,1,0,119,119,118,118
Colusa,12,2022-03-12,6,6,6,0,253,253,235,18,2,0,0,0,21,21,21,21
Contra Costa,12,2022-03-12,590,590,535,55,29189,29238,26510,2728,21,4,4,10,1278,1278,1274,1274
Del Norte,12,2022-03-12,45,45,42,3,1468,1470,1362,108,5,2,2,0,49,49,47,47
El Dorado,12,2022-03-12,52,52,48,4,3049,3054,2811,243,4,0,0,3,209,209,209,209
Fresno,12,2022-03-12,608,608,554,54,21799,21837,19907,1930,124,10,10,21,2731,2731,2721,2721
Glenn,12,2022-03-12,17,17,16,1,320,320,295,25,1,0,0,0,42,42,42,42
Humboldt,12,2022-03-12,62,62,57,5,2779,2784,2579,205,2,2,2,2,143,143,141,141
Imperial,12,2022-03-12,86,86,79,7,4652,4659,4282,377,5,1,1,8,939,939,938,938
Inyo,12,2022-03-12,9,9,8,1,165,165,154,11,0,0,0,0,56,56,56,56
Kern,12,2022-03-12,317,317,296,21,20236,20270,18917,1353,47,13,13,13,2321,2321,2308,2308
Kings,12,2022-03-12,219,219,201,18,4836,4844,4457,387,15,3,3,1,443,443,440,440
Lake,12,2022-03-12,65,65,59,6,1599,1602,1457,145,0,1,1,0,139,139,138,138
Lassen,12,2022-03-12,24,24,22,2,1502,1503,1406,97,0,0,0,0,62,62,62,62
Los Angeles,12,2022-03-12,4321,4329,4226,103,848825,850276,830218,20058,412,148,148,108,31581,31581,31433,31433
Madera,12,2022-03-12,83,83,75,8,3716,3721,3387,334,13,0,0,2,367,367,367,367
Marin,12,2022-03-12,159,159,145,14,6638,6649,6071,578,6,2,2,0,294,294,292,292
Mariposa,12,2022-03-12,8,8,7,1,223,223,202,21,0,0,0,0,27,27,27,27
Mendocino,12,2022-03-12,39,39,34,5,1482,1483,1312,171,4,0,0,1,121,121,121,121
Merced,12,2022-03-12,142,142,132,10,4214,4221,3929,292,21,2,2,4,810,810,808,808
Modoc,12,2022-03-12,3,3,3,0,56,56,52,4,1,0,0,0,7,7,7,7
Mono,12,2022-03-12,2,2,2,0,106,106,91,15,0,0,0,0,6,6,6,6
Monterey,12,2022-03-12,177,177,153,24,10339,10357,8961,1396,15,3,3,2,723,723,720,720
Napa,12,2022-03-12,150,150,141,9,4290,4296,4031,265,4,1,1,3,139,139,138,138
Nevada,12,2022-03-12,52,52,47,5,1588,1590,1449,141,2,0,0,1,126,126,126,126
Orange,12,2022-03-12,919,919,869,50,102448,102623,97121,5502,122,29,29,28,7012,7012,6983,6983
Placer,12,2022-03-12,157,157,142,15,7555,7568,6839,729,63,5,5,5,618,618,613,613
Plumas,12,2022-03-12,10,10,9,1,313,313,286,27,0,0,0,0,13,13,13,13
Riverside,12,2022-03-12,776,776,721,55,51481,51568,47910,3658,96,14,14,20,6340,6340,6326,6326
Sacramento,12,2022-03-12,624,624,576,48,37201,37266,34428,2838,114,16,16,20,3010,3010,2994,2994
San Benito,12,2022-03-12,26,26,24,2,1448,1450,1358,92,0,1,1,2,93,93,92,92
San Bernardino,12,2022-03-12,602,602,567,35,51277,51364,48391,2973,85,30,30,34,7769,7769,7739,7739
San Diego,12,2022-03-12,1966,1969,1920,49,96870,97035,94608,2427,174,20,20,51,5275,5275,5255,5255
San Francisco,12,2022-03-12,613,613,524,89,35050,35110,30029,5081,34,6,6,7,851,851,845,845
San Joaquin,12,2022-03-12,312,312,286,26,20439,20474,18762,1712,22,7,7,19,2228,2228,2221,2221
San Luis Obispo,12,2022-03-12,168,168,157,11,6927,6940,6483,457,5,7,7,1,470,470,463,463
San Mateo,12,2022-03-12,464,464,439,25,37440,37505,35479,2026,25,1,1,4,692,692,691,691
Santa Barbara,12,2022-03-12,192,192,178,14,17596,17626,16339,1287,17,5,5,3,679,679,674,674
Santa Clara,12,2022-03-12,1134,1134,1104,30,101379,101553,98863,2690,101,16,16,30,2273,2273,2257,2257
Santa Cruz,12,2022-03-12,245,245,230,15,23060,23100,21655,1445,9,3,3,2,259,259,256,256
Shasta,12,2022-03-12,103,103,95,8,4938,4946,4567,379,18,7,7,3,552,552,545,545
Siskiyou,12,2022-03-12,17,17,16,1,400,400,375,25,0,3,3,0,82,82,79,79
Solano,12,2022-03-12,245,245,227,18,12997,13019,12090,929,35,1,1,9,445,445,444,444
Sonoma,12,2022-03-12,233,233,217,16,13968,13991,13013,978,12,0,0,4,486,486,486,486
Stanislaus,12,2022-03-12,241,241,215,26,10206,10222,9124,1098,92,9,9,14,1669,1669,1660,1660
Sutter,12,2022-03-12,55,55,51,4,1805,1807,1675,132,0,0,0,0,221,221,221,221
Tehama,12,2022-03-12,27,27,24,3,997,997,894,103,0,2,2,1,200,200,198,198
Trinity,12,2022-03-12,2,2,2,0,97,97,87,10,0,0,0,0,20,20,20,20
Tulare,12,2022-03-12,205,205,183,22,9777,9794,8729,1065,34,6,6,3,1474,1474,1468,1468
Tuolumne,12,2022-03-12,28,28,25,3,1246,1246,1135,111,2,0,0,0,185,185,185,185
Ventura,12,2022-03-12,352,352,334,18,25166,25209,23951,1258,32,6,6,8,1473,1473,1467,1467
Yolo,12,2022-03-12,133,133,124,9,21590,21626,20235,1391,3,1,1,1,318,318,317,317
Yuba,12,2022-03-12,42,42,39,3,1445,1446,1347,99,9,0,0,3,116,116,116,116
Alameda,13,2022-03-19,691,691,660,31,67209,67327,64260,3067,56,8,8,2,1851,1851,1843,1843
Amador,13,2022-03-19,29,29,27,2,1388,1389,1288,101,2,0,0,0,86,86,86,86
Butte,13,2022-03-19,84,84,81,3,2985,2990,2878,112,16,0,0,1,426,426,426,426
Calaveras,13,2022-03-19,14,14,13,1,655,655,613,42,0,0,0,0,119,119,119,119
Colusa,13,2022-03-19,1,1,1,0,241,241,228,13,2,0,0,0,21,21,21,21
Contra Costa,13,2022-03-19,466,466,431,35,27737,27785,25720,2065,33,6,6,8,1284,1284,1278,1278
Del Norte,13,2022-03-19,19,19,18,1,1284,1285,1210,75,1,0,0,1,49,49,49,49
El Dorado,13,2022-03-19,41,41,38,3,2826,2831,2652,179,2,2,2,0,211,211,209,209
Fresno,13,2022-03-19,348,348,324,24,19950,19985,18580,1405,89,14,14,12,2745,2745,2731,2731
Glenn,13,2022-03-19,8,8,7,1,339,339,318,21,1,0,0,0,42,42,42,42
Humboldt,13,2022-03-19,37,37,35,2,2379,2384,2246,138,5,0,0,2,143,143,143,143
Imperial,13,2022-03-19,62,62,58,4,4043,4049,3789,260,5,2,2,4,941,941,939,939
Inyo,13,2022-03-19,1,1,1,0,156,156,147,9,0,0,0,0,56,56,56,56
Kern,13,2022-03-19,217,217,205,12,19518,19551,18517,1034,30,7,7,10,2328,2328,2321,2321
Kings,13,2022-03-19,77,77,72,5,4410,4417,4137,280,5,1,1,1,444,444,443,443
Lake,13,2022-03-19,19,19,18,1,1447,1450,1345,105,0,0,0,0,139,139,139,139
Lassen,13,2022-03-19,10,10,10,0,1528,1529,1451,78,0,0,0,0,62,62,62,62
Los Angeles,13,2022-03-19,4011,4018,3944,74,827183,828634,813313,15321,351,72,72,71,31653,31653,31581,31581
Madera,13,2022-03-19,48,48,45,3,3420,3425,3181,244,11,1,1,2,368,368,367,367
Marin,13,2022-03-19,147,147,137,10,6358,6369,5928,441,7,0,0,0,294,294,294,294
Mariposa,13,2022-03-19,8,8,7,1,246,246,228,18,0,0,0,0,27,27,27,27
Mendocino,13,2022-03-19,31,31,28,3,1498,1500,1363,137,4,2,2,1,123,123,121,121
Merced,13,2022-03-19,99,99,94,5,3903,3908,3694,214,12,4,4,4,814,814,810,810
Modoc,13,2022-03-19,2,2,2,0,51,51,48,3,0,0,0,0,7,7,7,7
Mono,13,2022-03-19,2,2,2,0,131,131,117,14,1,0,0,0,6,6,6,6
Monterey,13,2022-03-19,151,151,135,16,10215,10232,9126,1106,18,1,1,1,724,724,723,723
Napa,13,2022-03-19,63,63,60,3,3532,3538,3365,173,6,1,1,2,140,140,139,139
Nevada,13,2022-03-19,25,25,23,2,1539,1541,1433,108,1,0,0,0,126,126,126,126
Orange,13,2022-03-19,744,744,713,31,98351,98524,94357,4167,107,17,17,25,7029,7029,7012,7012
Placer,13,2022-03-19,112,112,103,9,6551,6564,6060,504,35,1,1,5,619,619,618,618
Plumas,13,2022-03-19,2,2,2,0,223,223,207,16,0,0,0,0,13,13,13,13
Riverside,13,2022-03-19,667,667,629,38,54724,54821,51737,3084,79,11,11,19,6351,6351,6340,6340
Sacramento,13,2022-03-19,471,471,443,28,32735,32790,30816,1974,101,11,11,12,3021,3021,3010,3010
San Benito,13,2022-03-19,26,26,25,1,1401,1403,1333,70,0,1,1,2,94,94,93,93
San Bernardino,13,2022-03-19,482,482,460,22,51531,51621,49264,2357,58,21,21,28,7790,7790,7769,7769
San Diego,13,2022-03-19,1498,1500,1470,30,88378,88534,86798,1736,168,13,13,35,5288,5288,5275,5275
San Francisco,13,2022-03-19,654,654,578,76,33553,33610,29698,3912,36,3,3,4,854,854,851,851
San Joaquin,13,2022-03-19,230,230,215,15,15544,15571,14538,1033,26,7,7,8,2235,2235,2228,2228
San Luis Obispo,13,2022-03-19,115,115,109,6,6612,6626,6282,344,2,5,5,1,475,475,470,470
San Mateo,13,2022-03-19,384,384,368,16,34156,34215,32760,1455,27,1,1,1,693,693,692,692
Santa Barbara,13,2022-03-19,180,180,170,10,16151,16181,15245,936,13,4,4,4,683,683,679,679
Santa Clara,13,2022-03-19,1023,1023,1002,21,94814,94980,93013,1967,100,1,1,25,2274,2274,2273,2273
Santa Cruz,13,2022-03-19,213,213,202,11,20687,20724,19699,1025,7,0,0,3,259,259,259,259
Shasta,13,2022-03-19,57,57,53,4,4332,4340,4076,264,1,6,6,0,558,558,552,552
Siskiyou,13,2022-03-19,9,9,9,0,360,360,342,18,1,1,1,0,83,83,82,82
Solano,13,2022-03-19,197,197,186,11,11641,11661,11004,657,19,0,0,3,445,445,445,445
Sonoma,13,2022-03-19,220,220,208,12,13338,13362,12626,736,12,3,3,2,489,489,486,486
Stanislaus,13,2022-03-19,154,154,141,13,8611,8625,7888,737,63,12,12,9,1681,1681,1669,1669
Sutter,13,2022-03-19,30,30,28,2,1488,1490,1404,86,0,1,1,0,222,222,221,221
Tehama,13,2022-03-19,9,9,8,1,926,926,850,76,1,2,2,0,202,202,200,200
Trinity,13,2022-03-19,1,1,1,0,96,96,88,8,0,0,0,0,20,20,20,20
Tulare,13,2022-03-19,120,120,110,10,8468,8484,7749,735,26,4,4,4,1478,1478,1474,1474
Tuolumne,13,2022-03-19,18,18,17,1,1167,1167,1084,83,2,0,0,0,185,185,185,185
Ventura,13,2022-03-19,291,291,280,11,23884,23926,22986,940,32,5,5,3,1478,1478,1473,1473
Yolo,13,2022-03-19,106,106,101,5,22353,22391,21253,1138,3,1,1,1,319,319,318,318
Yuba,13,2022-03-19,34,34,32,2,1326,1326,1254,72,7,0,0,0,116,116,116,116
Alameda,14,2022-03-26,872,872,841,31,59348,59454,57321,2133,47,3,3,5,1854,1854,1851,1851
Amador,14,2022-03-26,11,11,10,1,1311,1311,1235,76,3,0,0,0,86,86,86,86
Butte,14,2022-03-26,70,70,68,2,2735,2740,2659,81,13,0,0,1,426,426,426,426
Calaveras,14,2022-03-26,11,11,10,1,599,599,569,30,0,0,0,0,119,119,119,119
Colusa,14,2022-03-26,4,4,4,0,197,197,188,9,0,0,0,0,21,21,21,21
Contra Costa,14,2022-03-26,503,503,474,29,24836,24881,23418,1463,29,3,3,3,1287,1287,1284,1284
Del Norte,14,2022-03-26,18,18,17,1,1037,1037,989,48,0,0,0,0,49,49,49,49
El Dorado,14,2022-03-26,51,51,48,3,2778,2783,2644,139,0,1,1,0,212,212,211,211
Fresno,14,2022-03-26,304,304,287,17,18560,18594,17559,1035,84,6,6,11,2751,2751,2745,2745
Glenn,14,2022-03-26,7,7,7,0,308,308,293,15,0,0,0,0,42,42,42,42
Humboldt,14,2022-03-26,27,27,26,1,2596,2601,2481,120,3,1,1,2,144,144,143,143
Imperial,14,2022-03-26,55,55,52,3,3698,3704,3516,188,4,3,3,3,944,944,941,941
Inyo,14,2022-03-26,3,3,3,0,164,164,157,7,1,0,0,0,56,56,56,56
Kern,14,2022-03-26,152,152,146,6,18575,18609,17832,777,17,5,5,9,2333,2333,2328,2328
Kings,14,2022-03-26,63,63,60,3,4404,4412,4191,221,2,2,2,0,446,446,444,444
Lake,14,2022-03-26,13,13,12,1,1149,1149,1083,66,0,0,0,0,139,139,139,139
Lassen,14,2022-03-26,6,6,6,0,1361,1363,1308,55,0,0,0,0,62,62,62,62
Los Angeles,14,2022-03-26,4370,4378,4315,63,789079,790503,779071,11432,282,61,61,59,31714,31714,31653,31653
Madera,14,2022-03-26,22,22,21,1,3366,3371,3181,190,3,0,0,1,368,368,368,368
Marin,14,2022-03-26,166,166,157,9,5897,5909,5586,323,3,1,1,0,295,295,294,294
Mariposa,14,2022-03-26,6,6,6,0,178,178,167,11,0,0,0,0,27,27,27,27
Mendocino,14,2022-03-26,30,30,28,2,1291,1292,1197,95,0,1,1,0,124,124,123,123
Merced,14,2022-03-26,65,65,62,3,3338,3343,3198,145,11,2,2,1,816,816,814,814
Modoc,14,2022-03-26,2,2,2,0,52,52,50,2,0,0,0,0,7,7,7,7
Mono,14,2022-03-26,3,3,3,0,132,132,120,12,0,0,0,0,6,6,6,6
Monterey,14,2022-03-26,164,164,150,14,9443,9459,8644,815,19,0,0,0,724,724,724,724
Napa,14,2022-03-26,62,62,60,2,3332,3338,3210,128,1,1,1,0,141,141,140,140
Nevada,14,2022-03-26,25,25,24,1,1476,1478,1396,82,1,0,0,0,126,126,126,126
Orange,14,2022-03-26,796,796,770,26,90213,90375,87371,3004,80,15,15,20,7044,7044,7029,7029
Placer,14,2022-03-26,111,111,104,7,6158,6171,5795,376,26,4,4,7,623,623,619,619
Plumas,14,2022-03-26,2,2,2,0,272,272,257,15,0,0,0,0,13,13,13,13
Riverside,14,2022-03-26,514,514,491,23,44711,44790,42808,1982,61,9,9,14,6360,6360,6351,6351
Sacramento,14,2022-03-26,459,459,437,22,31684,31741,30230,1511,81,6,6,15,3027,3027,3021,3021
San Benito,14,2022-03-26,10,10,10,0,1305,1306,1255,51,0,0,0,0,94,94,94,94
San Bernardino,14,2022-03-26,492,492,474,18,41454,41529,40036,1493,44,23,23,25,7813,7813,7790,7790
San Diego,14,2022-03-26,1286,1286,1266,20,74094,74228,73089,1139,124,10,10,31,5298,5298,5288,5288
San Francisco,14,2022-03-26,771,771,699,72,32743,32802,29750,3052,26,2,2,4,856,856,854,854
San Joaquin,14,2022-03-26,191,191,181,10,16607,16637,15766,871,25,6,6,6,2241,2241,2235,2235
San Luis Obispo,14,2022-03-26,99,99,95,4,5796,5807,5570,237,4,2,2,1,477,477,475,475
San Mateo,14,2022-03-26,514,514,497,17,34368,34430,33277,1153,23,2,2,5,695,695,693,693
Santa Barbara,14,2022-03-26,118,118,113,5,8889,8905,8500,405,18,4,4,3,687,687,683,683
Santa Clara,14,2022-03-26,1221,1221,1201,20,91035,91200,89724,1476,83,9,9,19,2283,2283,2274,2274
Santa Cruz,14,2022-03-26,136,136,131,5,18710,18743,18015,728,5,0,0,2,259,259,259,259
Shasta,14,2022-03-26,42,42,40,2,3902,3909,3721,188,5,3,3,3,561,561,558,558
Siskiyou,14,2022-03-26,8,8,8,0,305,305,293,12,0,0,0,0,83,83,83,83
Solano,14,2022-03-26,158,158,151,7,10938,10957,10469,488,20,1,1,6,446,446,445,445
Sonoma,14,2022-03-26,233,233,223,10,8214,8228,7871,357,13,0,0,1,489,489,489,489
Stanislaus,14,2022-03-26,125,125,116,9,8023,8038,7492,546,35,5,5,6,1686,1686,1681,1681
Sutter,14,2022-03-26,27,27,26,1,1516,1518,1449,69,0,1,1,0,223,223,222,222
Tehama,14,2022-03-26,15,15,14,1,808,808,755,53,2,0,0,0,202,202,202,202
Trinity,14,2022-03-26,0,0,0,0,102,102,95,7,0,0,0,0,20,20,20,20
Tulare,14,2022-03-26,93,93,87,6,7872,7886,7343,543,18,4,4,1,1482,1482,1478,1478
Tuolumne,14,2022-03-26,10,10,9,1,1114,1114,1051,63,3,0,0,0,185,185,185,185
Ventura,14,2022-03-26,329,329,319,10,21769,21809,21137,672,21,6,6,2,1484,1484,1478,1478
Yolo,14,2022-03-26,103,103,99,4,17167,17198,16511,687,3,2,2,0,321,321,319,319
Yuba,14,2022-03-26,35,35,34,1,1253,1253,1199,54,2,2,2,1,118,118,116,116
Alameda,15,2022-04-02,971,971,944,27,58381,58492,56845,1647,34,4,4,3,1858,1858,1854,1854
Amador,15,2022-04-02,4,4,4,0,1182,1183,1128,55,1,0,0,0,86,86,86,86
Butte,15,2022-04-02,50,50,49,1,2487,2492,2434,58,9,1,1,1,427,427,426,426
Calaveras,15,2022-04-02,12,12,12,0,586,586,563,23,0,0,0,0,119,119,119,119
Colusa,15,2022-04-02,4,4,4,0,200,200,193,7,0,0,0,0,21,21,21,21
Contra Costa,15,2022-04-02,547,547,522,25,24570,24617,23473,1144,15,1,1,5,1288,1288,1287,1287
Del Norte,15,2022-04-02,10,10,10,0,1126,1127,1086,41,0,0,0,0,49,49,49,49
El Dorado,15,2022-04-02,53,53,51,2,2782,2787,2678,109,2,1,1,0,213,213,212,212
Fresno,15,2022-04-02,197,197,188,9,17050,17082,16332,750,62,4,4,13,2755,2755,2751,2751
Glenn,15,2022-04-02,5,5,5,0,262,262,252,10,0,0,0,0,42,42,42,42
Humboldt,15,2022-04-02,21,21,20,1,2511,2516,2425,91,2,0,0,3,144,144,144,144
Imperial,15,2022-04-02,52,52,50,2,3478,3483,3344,139,3,0,0,3,944,944,944,944
Inyo,15,2022-04-02,8,8,8,0,182,182,176,6,0,0,0,0,56,56,56,56
Kern,15,2022-04-02,164,164,159,5,17316,17348,16778,570,19,2,2,4,2335,2335,2333,2333
Kings,15,2022-04-02,48,48,46,2,4155,4163,3999,164,3,0,0,0,446,446,446,446
Lake,15,2022-04-02,12,12,11,1,987,988,944,44,0,0,0,0,139,139,139,139
Lassen,15,2022-04-02,4,4,4,0,1218,1220,1182,38,0,0,0,0,62,62,62,62
Los Angeles,15,2022-04-02,5039,5050,4993,57,734266,735652,727393,8259,247,50,50,41,31764,31764,31714,31714
Madera,15,2022-04-02,29,29,28,1,3277,3282,3136,146,2,0,0,3,368,368,368,368
Marin,15,2022-04-02,156,156,149,7,6554,6566,6283,283,2,0,0,0,295,295,295,295
Mariposa,15,2022-04-02,5,5,5,0,215,215,205,10,0,1,1,0,28,28,27,27
Mendocino,15,2022-04-02,25,25,24,1,1254,1255,1182,73,0,0,0,0,124,124,124,124
Merced,15,2022-04-02,56,56,54,2,3287,3292,3180,112,4,2,2,0,818,818,816,816
Modoc,15,2022-04-02,4,4,4,0,42,42,41,1,0,0,0,0,7,7,7,7
Mono,15,2022-04-02,1,1,1,0,154,154,143,11,0,0,0,0,6,6,6,6
Monterey,15,2022-04-02,126,126,117,9,7545,7559,7042,517,11,4,4,0,728,728,724,724
Napa,15,2022-04-02,61,61,59,2,3254,3260,3162,98,2,1,1,1,142,142,141,141
Nevada,15,2022-04-02,28,28,27,1,1403,1405,1343,62,0,2,2,0,128,128,126,126
Orange,15,2022-04-02,893,893,870,23,88615,88782,86463,2319,59,14,14,13,7058,7058,7044,7044
Placer,15,2022-04-02,122,122,116,6,6578,6591,6275,316,24,1,1,5,624,624,623,623
Plumas,15,2022-04-02,4,4,4,0,233,233,223,10,0,0,0,0,13,13,13,13
Riverside,15,2022-04-02,614,614,593,21,39333,39408,38032,1376,40,6,6,11,6366,6366,6360,6360
Sacramento,15,2022-04-02,430,430,414,16,32801,32863,31630,1233,52,7,7,11,3034,3034,3027,3027
San Benito,15,2022-04-02,13,13,13,0,1229,1231,1193,38,0,0,0,0,94,94,94,94
San Bernardino,15,2022-04-02,591,591,574,17,41785,41863,40680,1183,22,10,10,13,7823,7823,7813,7813
San Diego,15,2022-04-02,1478,1478,1460,18,66041,66166,65372,794,100,4,4,33,5302,5302,5298,5298
San Francisco,15,2022-04-02,956,956,885,71,28745,28801,26661,2140,21,4,4,4,860,860,856,856
San Joaquin,15,2022-04-02,208,208,199,9,16045,16076,15409,667,10,3,3,6,2244,2244,2241,2241
San Luis Obispo,15,2022-04-02,101,101,98,3,5549,5561,5382,179,4,0,0,0,477,477,477,477
San Mateo,15,2022-04-02,643,643,626,17,29623,29679,28898,781,15,1,1,1,696,696,695,695
Santa Barbara,15,2022-04-02,179,179,173,6,15230,15259,14712,547,9,2,2,2,689,689,687,687
Santa Clara,15,2022-04-02,1398,1398,1380,18,91298,91470,90307,1163,81,7,7,21,2290,2290,2283,2283
Santa Cruz,15,2022-04-02,188,188,182,6,20066,20104,19487,617,3,0,0,2,259,259,259,259
Shasta,15,2022-04-02,23,23,22,1,3528,3534,3400,134,3,1,1,2,562,562,561,561
Siskiyou,15,2022-04-02,4,4,4,0,313,313,303,10,0,0,0,0,83,83,83,83
Solano,15,2022-04-02,164,164,158,6,10420,10440,10073,367,18,1,1,8,447,447,446,446
Sonoma,15,2022-04-02,286,286,276,10,10645,10666,10302,364,7,1,1,2,490,490,489,489
Stanislaus,15,2022-04-02,100,100,95,5,7808,7823,7401,422,23,1,1,2,1687,1687,1686,1686
Sutter,15,2022-04-02,23,23,22,1,1272,1273,1227,46,0,0,0,0,223,223,223,223
Tehama,15,2022-04-02,3,3,3,0,746,746,708,38,0,2,2,0,204,204,202,202
Trinity,15,2022-04-02,1,1,1,0,77,77,73,4,0,0,0,0,20,20,20,20
Tulare,15,2022-04-02,54,54,51,3,7608,7623,7207,416,14,4,4,1,1486,1486,1482,1482
Tuolumne,15,2022-04-02,9,9,9,0,971,971,928,43,1,1,1,0,186,186,185,185
Ventura,15,2022-04-02,292,292,285,7,20939,20978,20471,507,20,4,4,2,1488,1488,1484,1484
Yolo,15,2022-04-02,101,101,98,3,28273,28325,27429,896,1,0,0,0,321,321,321,321
Yuba,15,2022-04-02,12,12,12,0,1023,1023,989,34,3,0,0,1,118,118,118,118
Alameda,16,2022-04-09,1337,1338,1309,29,48812,48909,47831,1078,47,5,5,2,1863,1863,1858,1858
Amador,16,2022-04-09,8,8,8,0,1101,1101,1061,40,1,0,0,0,86,86,86,86
Butte,16,2022-04-09,37,37,36,1,2089,2094,2056,38,7,1,1,1,428,428,427,427
Calaveras,16,2022-04-09,10,10,10,0,643,643,623,20,0,0,0,0,119,119,119,119
Colusa,16,2022-04-09,4,4,4,0,196,196,191,5,0,0,0,0,21,21,21,21
Contra Costa,16,2022-04-09,622,622,599,23,19617,19656,18939,717,18,1,1,5,1289,1289,1288,1288
Del Norte,16,2022-04-09,6,6,6,0,982,982,954,28,0,0,0,1,49,49,49,49
El Dorado,16,2022-04-09,51,51,49,2,2571,2576,2497,79,1,0,0,0,213,213,213,213
Fresno,16,2022-04-09,196,196,189,7,16698,16732,16154,578,57,1,1,7,2756,2756,2755,2755
Glenn,16,2022-04-09,3,3,3,0,229,229,222,7,0,0,0,0,42,42,42,42
Humboldt,16,2022-04-09,38,38,37,1,2331,2336,2270,66,5,1,1,2,145,145,144,144
Imperial,16,2022-04-09,24,24,23,1,3469,3475,3366,109,2,1,1,1,945,945,944,944
Inyo,16,2022-04-09,6,6,6,0,199,199,194,5,0,0,0,0,56,56,56,56
Kern,16,2022-04-09,148,148,144,4,17295,17330,16885,445,15,1,1,5,2336,2336,2335,2335
Kings,16,2022-04-09,32,32,31,1,4206,4214,4083,131,2,0,0,1,446,446,446,446
Lake,16,2022-04-09,19,19,18,1,850,850,820,30,0,0,0,0,139,139,139,139
Lassen,16,2022-04-09,1,1,1,0,1301,1303,1271,32,1,0,0,0,62,62,62,62
Los Angeles,16,2022-04-09,6466,6478,6421,57,752972,754472,747818,6654,221,43,43,41,31807,31807,31764,31764
Madera,16,2022-04-09,26,26,25,1,3153,3158,3047,111,2,0,0,1,368,368,368,368
Marin,16,2022-04-09,189,189,183,6,5482,5494,5308,186,4,0,0,1,295,295,295,295
Mariposa,16,2022-04-09,7,7,7,0,245,245,236,9,0,0,0,0,28,28,28,28
Mendocino,16,2022-04-09,30,30,29,1,1154,1155,1102,53,0,0,0,0,124,124,124,124
Merced,16,2022-04-09,63,63,61,2,3310,3316,3227,89,10,0,0,0,818,818,818,818
Modoc,16,2022-04-09,1,1,1,0,50,50,49,1,0,0,0,0,7,7,7,7
Mono,16,2022-04-09,5,5,5,0,136,136,129,7,0,0,0,0,6,6,6,6
Monterey,16,2022-04-09,114,114,108,6,7163,7177,6789,388,12,2,2,0,730,730,728,728
Napa,16,2022-04-09,107,107,104,3,3084,3090,3017,73,2,0,0,0,142,142,142,142
Nevada,16,2022-04-09,35,35,34,1,1508,1511,1459,52,1,0,0,1,128,128,128,128
Orange,16,2022-04-09,1094,1094,1072,22,54649,54757,53636,1121,65,11,11,14,7069,7069,7058,7058
Placer,16,2022-04-09,114,114,110,4,6232,6245,6008,237,20,3,3,3,627,627,624,624
Plumas,16,2022-04-09,5,5,5,0,260,260,251,9,0,0,0,0,13,13,13,13
Riverside,16,2022-04-09,715,715,695,20,37790,37865,36827,1038,30,5,5,7,6371,6371,6366,6366
Sacramento,16,2022-04-09,475,475,461,14,31276,31338,30413,925,41,11,11,7,3045,3045,3034,3034
San Benito,16,2022-04-09,17,17,17,0,1185,1186,1157,29,0,0,0,0,94,94,94,94
San Bernardino,16,2022-04-09,810,810,792,18,42148,42233,41299,934,27,8,8,5,7831,7831,7823,7823
San Diego,16,2022-04-09,1815,1820,1803,17,73824,73970,73279,691,87,7,7,24,5309,5309,5302,5302
San Francisco,16,2022-04-09,1148,1148,1080,68,30157,30217,28443,1774,23,7,7,4,867,867,860,860
San Joaquin,16,2022-04-09,236,236,228,8,15625,15657,15147,510,14,0,0,5,2244,2244,2244,2244
San Luis Obispo,16,2022-04-09,109,109,106,3,4997,5007,4880,127,2,2,2,0,479,479,477,477
San Mateo,16,2022-04-09,823,823,806,17,30514,30575,29945,630,5,3,3,1,699,699,696,696
Santa Barbara,16,2022-04-09,250,250,243,7,15196,15226,14798,428,8,2,2,1,691,691,689,689
Santa Clara,16,2022-04-09,1600,1603,1587,16,79385,79542,78754,788,76,1,1,13,2291,2291,2290,2290
Santa Cruz,16,2022-04-09,271,271,264,7,8149,8166,7969,197,6,1,1,0,260,260,259,259
Shasta,16,2022-04-09,20,20,19,1,3306,3312,3214,98,2,1,1,1,563,563,562,562
Siskiyou,16,2022-04-09,1,1,1,0,317,317,309,8,0,0,0,0,83,83,83,83
Solano,16,2022-04-09,242,242,235,7,9888,9908,9636,272,14,0,0,3,447,447,447,447
Sonoma,16,2022-04-09,402,402,391,11,10570,10591,10307,284,6,1,1,0,491,491,490,490
Stanislaus,16,2022-04-09,128,128,123,5,7867,7882,7547,335,19,2,2,2,1689,1689,1687,1687
Sutter,16,2022-04-09,24,24,23,1,1324,1326,1288,38,0,1,1,0,224,224,223,223
Tehama,16,2022-04-09,10,10,10,0,759,759,728,31,0,0,0,0,204,204,204,204
Trinity,16,2022-04-09,0,0,0,0,82,82,79,3,0,0,0,0,20,20,20,20
Tulare,16,2022-04-09,49,49,47,2,7910,7926,7584,342,7,4,4,0,1490,1490,1486,1486
Tuolumne,16,2022-04-09,16,16,15,1,1076,1077,1039,38,1,0,0,0,186,186,186,186
Ventura,16,2022-04-09,301,301,295,6,18105,18141,17798,343,18,3,3,2,1491,1491,1488,1488
Yolo,16,2022-04-09,115,115,112,3,18637,18675,18212,463,0,0,0,1,321,321,321,321
Yuba,16,2022-04-09,16,16,16,0,1081,1082,1053,29,4,0,0,0,118,118,118,118
Alameda,17,2022-04-16,1743,1748,1718,30,54579,54693,53749,944,38,2,2,3,1865,1865,1863,1863
Amador,17,2022-04-16,7,7,7,0,1135,1135,1103,32,2,0,0,0,86,86,86,86
Butte,17,2022-04-16,47,47,46,1,2051,2056,2027,29,5,1,1,0,429,429,428,428
Calaveras,17,2022-04-16,15,15,15,0,616,616,601,15,0,1,1,0,120,120,119,119
Colusa,17,2022-04-16,4,4,4,0,169,169,165,4,0,0,0,0,21,21,21,21
Contra Costa,17,2022-04-16,982,982,954,28,25011,25063,24344,719,25,1,1,4,1290,1290,1289,1289
Del Norte,17,2022-04-16,13,13,13,0,1024,1024,1001,23,0,0,0,0,49,49,49,49
El Dorado,17,2022-04-16,60,60,59,1,2362,2367,2310,57,0,0,0,0,213,213,213,213
Fresno,17,2022-04-16,197,197,192,5,13931,13961,13583,378,42,4,4,6,2760,2760,2756,2756
Glenn,17,2022-04-16,3,3,3,0,237,237,231,6,0,0,0,0,42,42,42,42
Humboldt,17,2022-04-16,80,80,78,2,1974,1979,1935,44,4,0,0,2,145,145,145,145
Imperial,17,2022-04-16,43,43,42,1,3350,3357,3274,83,2,0,0,1,945,945,945,945
Inyo,17,2022-04-16,0,0,0,0,152,152,149,3,0,0,0,0,56,56,56,56
Kern,17,2022-04-16,131,131,128,3,13453,13482,13210,272,10,3,3,9,2339,2339,2336,2336
Kings,17,2022-04-16,38,38,37,1,3616,3623,3535,88,2,1,1,0,447,447,446,446
Lake,17,2022-04-16,19,19,18,1,815,815,792,23,0,0,0,2,139,139,139,139
Lassen,17,2022-04-16,2,2,2,0,1317,1319,1293,26,0,0,0,0,62,62,62,62
Los Angeles,17,2022-04-16,7638,7655,7602,53,373615,374392,371803,2589,184,41,41,29,31848,31848,31807,31807
Madera,17,2022-04-16,23,23,22,1,2604,2609,2537,72,1,0,0,2,368,368,368,368
Marin,17,2022-04-16,280,280,273,7,6106,6119,5956,163,4,0,0,1,295,295,295,295
Mariposa,17,2022-04-16,11,11,11,0,257,257,250,7,0,0,0,0,28,28,28,28
Mendocino,17,2022-04-16,42,42,41,1,1303,1305,1258,47,3,1,1,1,125,125,124,124
Merced,17,2022-04-16,64,64,63,1,3157,3162,3096,66,9,2,2,0,820,820,818,818
Modoc,17,2022-04-16,1,1,1,0,36,36,35,1,0,0,0,0,7,7,7,7
Mono,17,2022-04-16,12,12,11,1,170,170,162,8,0,0,0,0,6,6,6,6
Monterey,17,2022-04-16,134,134,128,6,6341,6354,6083,271,6,0,0,0,730,730,730,730
Napa,17,2022-04-16,143,143,140,3,2701,2706,2656,50,1,0,0,0,142,142,142,142
Nevada,17,2022-04-16,42,42,41,1,1240,1241,1207,34,1,0,0,1,128,128,128,128
Orange,17,2022-04-16,1333,1335,1314,21,82453,82625,81298,1327,59,5,5,8,7074,7074,7069,7069
Placer,17,2022-04-16,154,154,149,5,4707,4718,4578,140,22,0,0,3,627,627,627,627
Plumas,17,2022-04-16,6,6,6,0,209,209,203,6,0,0,0,0,13,13,13,13
Riverside,17,2022-04-16,873,873,854,19,37366,37444,36639,805,39,5,5,6,6376,6376,6371,6371
Sacramento,17,2022-04-16,644,644,629,15,27851,27910,27266,644,46,8,8,7,3053,3053,3045,3045
San Benito,17,2022-04-16,24,24,24,0,1181,1183,1161,22,0,0,0,0,94,94,94,94
San Bernardino,17,2022-04-16,1023,1023,1005,18,39608,39690,39000,690,35,6,6,8,7837,7837,7831,7831
San Diego,17,2022-04-16,1891,1896,1882,14,68526,68669,68166,503,77,8,8,19,5317,5317,5309,5309
San Francisco,17,2022-04-16,1328,1328,1266,62,30547,30611,29195,1416,31,2,2,1,869,869,867,867
San Joaquin,17,2022-04-16,221,221,215,6,14846,14879,14499,380,7,0,0,6,2244,2244,2244,2244
San Luis Obispo,17,2022-04-16,139,139,136,3,4861,4871,4775,96,3,2,2,0,481,481,479,479
San Mateo,17,2022-04-16,1036,1036,1019,17,29943,30006,29523,483,9,3,3,2,702,702,699,699
Santa Barbara,17,2022-04-16,328,328,321,7,14861,14892,14564,328,8,0,0,0,691,691,691,691
Santa Clara,17,2022-04-16,2018,2024,2008,16,74309,74464,73885,579,62,7,7,12,2298,2298,2291,2291
Santa Cruz,17,2022-04-16,409,409,401,8,12641,12667,12422,245,3,0,0,1,260,260,260,260
Shasta,17,2022-04-16,27,27,26,1,2836,2841,2775,66,2,0,0,2,563,563,563,563
Siskiyou,17,2022-04-16,4,4,4,0,325,325,319,6,0,0,0,1,83,83,83,83
Solano,17,2022-04-16,236,236,231,5,9188,9208,9010,198,9,1,1,1,448,448,447,447
Sonoma,17,2022-04-16,481,481,471,10,11408,11431,11191,240,13,1,1,2,492,492,491,491
Stanislaus,17,2022-04-16,148,148,143,5,7857,7873,7610,263,17,1,1,2,1690,1690,1689,1689
Sutter,17,2022-04-16,19,19,19,0,1182,1184,1158,26,0,0,0,0,224,224,224,224
Tehama,17,2022-04-16,7,7,7,0,649,649,628,21,1,0,0,0,204,204,204,204
Trinity,17,2022-04-16,0,0,0,0,69,69,67,2,0,0,0,0,20,20,20,20
Tulare,17,2022-04-16,71,71,69,2,6823,6838,6606,232,13,1,1,0,1491,1491,1490,1490
Tuolumne,17,2022-04-16,27,27,26,1,1060,1061,1032,29,0,0,0,0,186,186,186,186
Ventura,17,2022-04-16,358,358,353,5,15826,15859,15623,236,8,1,1,1,1492,1492,1491,1491
Yolo,17,2022-04-16,210,210,206,4,18854,18894,18527,367,1,1,1,1,322,322,321,321
Yuba,17,2022-04-16,20,20,20,0,1004,1004,983,21,1,0,0,0,118,118,118,118
Alameda,18,2022-04-23,2243,2249,2219,30,55760,55881,55129,752,47,7,7,6,1872,1872,1865,1865
Amador,18,2022-04-23,18,18,18,0,1321,1323,1294,29,0,0,0,0,86,86,86,86
Butte,18,2022-04-23,41,41,41,0,2191,2196,2172,24,8,2,2,1,431,431,429,429
Calaveras,18,2022-04-23,22,22,22,0,611,611,599,12,0,0,0,0,120,120,120,120
Colusa,18,2022-04-23,3,3,3,0,175,175,172,3,0,0,0,0,21,21,21,21
Contra Costa,18,2022-04-23,1366,1369,1338,31,25458,25514,24941,573,29,2,2,2,1292,1292,1290,1290
Del Norte,18,2022-04-23,19,19,19,0,1071,1071,1052,19,1,0,0,0,49,49,49,49
El Dorado,18,2022-04-23,99,99,97,2,2666,2671,2620,51,0,0,0,0,213,213,213,213
Fresno,18,2022-04-23,323,323,316,7,15707,15742,15408,334,34,3,3,2,2763,2763,2760,2760
Glenn,18,2022-04-23,4,4,4,0,254,254,249,5,0,0,0,0,42,42,42,42
Humboldt,18,2022-04-23,171,171,168,3,2756,2761,2713,48,2,1,1,2,146,146,145,145
Imperial,18,2022-04-23,57,57,56,1,3346,3353,3288,65,4,0,0,1,945,945,945,945
Inyo,18,2022-04-23,5,5,5,0,182,182,179,3,2,0,0,0,56,56,56,56
Kern,18,2022-04-23,215,215,212,3,17070,17107,16838,269,14,1,1,7,2340,2340,2339,2339
Kings,18,2022-04-23,54,54,53,1,4408,4417,4333,84,2,0,0,0,447,447,447,447
Lake,18,2022-04-23,15,15,15,0,795,795,778,17,2,1,1,0,140,140,139,139
Lassen,18,2022-04-23,0,0,0,0,1523,1525,1502,23,0,0,0,0,62,62,62,62
Los Angeles,18,2022-04-23,10822,10846,10788,58,858130,860000,855380,4620,191,22,22,27,31870,31870,31848,31848
Madera,18,2022-04-23,30,30,29,1,2829,2834,2773,61,2,0,0,0,368,368,368,368
Marin,18,2022-04-23,345,345,338,7,6084,6097,5970,127,8,0,0,1,295,295,295,295
Mariposa,18,2022-04-23,15,15,15,0,213,213,208,5,0,0,0,0,28,28,28,28
Mendocino,18,2022-04-23,64,64,62,2,1192,1193,1159,34,0,1,1,1,126,126,125,125
Merced,18,2022-04-23,89,89,88,1,2911,2916,2868,48,6,2,2,0,822,822,820,820
Modoc,18,2022-04-23,1,1,1,0,35,35,34,1,0,0,0,0,7,7,7,7
Mono,18,2022-04-23,3,3,3,0,88,88,85,3,0,0,0,0,6,6,6,6
Monterey,18,2022-04-23,248,248,240,8,7374,7391,7144,247,4,2,2,0,732,732,730,730
Napa,18,2022-04-23,209,209,206,3,3327,3332,3284,48,0,0,0,0,142,142,142,142
Nevada,18,2022-04-23,49,49,48,1,1363,1366,1337,29,2,0,0,1,128,128,128,128
Orange,18,2022-04-23,1811,1816,1793,23,83993,84176,83125,1051,52,7,7,14,7081,7081,7074,7074
Placer,18,2022-04-23,208,208,203,5,5690,5703,5570,133,23,0,0,2,627,627,627,627
Plumas,18,2022-04-23,2,2,2,0,233,233,228,5,0,0,0,0,13,13,13,13
Riverside,18,2022-04-23,1187,1187,1167,20,39103,39187,38530,657,38,4,4,6,6380,6380,6376,6376
Sacramento,18,2022-04-23,919,919,903,16,30678,30746,30191,555,48,5,5,4,3058,3058,3053,3053
San Benito,18,2022-04-23,33,33,33,0,1134,1136,1119,17,0,0,0,0,94,94,94,94
San Bernardino,18,2022-04-23,1276,1277,1260,17,42161,42251,41678,573,25,10,10,6,7847,7847,7837,7837
San Diego,18,2022-04-23,2763,2769,2753,16,72444,72603,72190,413,84,4,4,13,5321,5321,5317,5317
San Francisco,18,2022-04-23,1820,1824,1757,67,31038,31106,29973,1133,28,1,1,4,870,870,869,869
San Joaquin,18,2022-04-23,356,356,349,7,15221,15254,14949,305,10,1,1,3,2245,2245,2244,2244
San Luis Obispo,18,2022-04-23,193,193,190,3,4982,4994,4917,77,5,0,0,0,481,481,481,481
San Mateo,18,2022-04-23,1375,1378,1361,17,31642,31710,31311,399,16,1,1,3,703,703,702,702
Santa Barbara,18,2022-04-23,355,355,349,6,14691,14721,14467,254,7,0,0,0,691,691,691,691
Santa Clara,18,2022-04-23,2809,2816,2799,17,68961,69112,68696,416,73,2,2,10,2300,2300,2298,2298
Santa Cruz,18,2022-04-23,460,460,453,7,19439,19482,19196,286,2,1,1,0,261,261,260,260
Shasta,18,2022-04-23,49,49,48,1,3053,3059,3003,56,0,1,1,0,564,564,563,563
Siskiyou,18,2022-04-23,8,8,8,0,329,329,324,5,0,0,0,0,83,83,83,83
Solano,18,2022-04-23,422,422,415,7,10153,10176,10005,171,9,0,0,2,448,448,448,448
Sonoma,18,2022-04-23,629,629,619,10,11571,11597,11407,190,14,0,0,4,492,492,492,492
Stanislaus,18,2022-04-23,203,203,198,5,7441,7456,7261,195,18,2,2,3,1692,1692,1690,1690
Sutter,18,2022-04-23,33,33,32,1,1307,1310,1287,23,0,1,1,0,225,225,224,224
Tehama,18,2022-04-23,14,14,14,0,657,657,641,16,1,0,0,0,204,204,204,204
Trinity,18,2022-04-23,2,2,2,0,77,77,75,2,0,0,0,0,20,20,20,20
Tulare,18,2022-04-23,80,80,78,2,6947,6961,6776,185,12,0,0,0,1491,1491,1491,1491
Tuolumne,18,2022-04-23,32,32,31,1,1105,1106,1082,24,1,1,1,0,187,187,186,186
Ventura,18,2022-04-23,554,554,548,6,18645,18685,18469,216,13,3,3,3,1495,1495,1492,1492
Yolo,18,2022-04-23,261,261,257,4,18559,18599,18318,281,0,0,0,0,322,322,322,322
Yuba,18,2022-04-23,35,35,34,1,1085,1085,1067,18,0,0,0,1,118,118,118,118
Alameda,19,2022-04-30,3085,3092,3059,33,69279,69436,68702,734,40,3,3,3,1875,1875,1872,1872
Amador,19,2022-04-30,32,32,31,1,1344,1347,1324,23,0,0,0,0,86,86,86,86
Butte,19,2022-04-30,88,88,87,1,2286,2291,2271,20,4,2,2,0,433,433,431,431
Calaveras,19,2022-04-30,33,33,32,1,737,737,726,11,0,0,0,0,120,120,120,120
Colusa,19,2022-04-30,3,3,3,0,219,219,216,3,0,0,0,0,21,21,21,21
Contra Costa,19,2022-04-30,1708,1713,1683,30,28793,28859,28350,509,38,3,3,4,1295,1295,1292,1292
Del Norte,19,2022-04-30,38,38,37,1,1206,1207,1190,17,0,0,0,0,49,49,49,49
El Dorado,19,2022-04-30,115,115,113,2,2751,2756,2715,41,3,1,1,0,214,214,213,213
Fresno,19,2022-04-30,459,459,451,8,16957,16996,16713,283,35,3,3,4,2766,2766,2763,2763
Glenn,19,2022-04-30,4,4,4,0,244,244,240,4,0,0,0,0,42,42,42,42
Humboldt,19,2022-04-30,203,203,200,3,2909,2914,2874,40,5,0,0,2,146,146,146,146
Imperial,19,2022-04-30,108,108,106,2,3679,3687,3631,56,1,0,0,1,945,945,945,945
Inyo,19,2022-04-30,5,5,5,0,207,207,204,3,0,0,0,0,56,56,56,56
Kern,19,2022-04-30,273,273,270,3,17993,18034,17811,223,9,1,1,6,2341,2341,2340,2340
Kings,19,2022-04-30,45,45,44,1,4737,4748,4677,71,3,0,0,0,447,447,447,447
Lake,19,2022-04-30,28,28,28,0,1023,1024,1006,18,1,0,0,0,140,140,140,140
Lassen,19,2022-04-30,9,9,9,0,1606,1611,1592,19,0,0,0,0,62,62,62,62
Los Angeles,19,2022-04-30,13763,13793,13735,58,926012,928126,924228,3898,198,29,29,28,31899,31899,31870,31870
Madera,19,2022-04-30,68,68,67,1,3227,3233,3179,54,1,0,0,2,368,368,368,368
Marin,19,2022-04-30,383,383,377,6,6395,6409,6304,105,9,0,0,0,295,295,295,295
Mariposa,19,2022-04-30,7,7,7,0,239,239,235,4,0,0,0,0,28,28,28,28
Mendocino,19,2022-04-30,49,49,48,1,1260,1263,1235,28,0,0,0,0,126,126,126,126
Merced,19,2022-04-30,113,113,112,1,3253,3259,3217,42,6,3,3,0,825,825,822,822
Modoc,19,2022-04-30,0,0,0,0,44,44,43,1,0,0,0,0,7,7,7,7
Mono,19,2022-04-30,4,4,4,0,81,81,79,2,0,0,0,0,6,6,6,6
Monterey,19,2022-04-30,329,329,320,9,8328,8347,8126,221,8,1,1,0,733,733,732,732
Napa,19,2022-04-30,217,217,215,2,3498,3506,3467,39,5,0,0,0,142,142,142,142
Nevada,19,2022-04-30,68,68,67,1,1506,1510,1485,25,2,0,0,0,128,128,128,128
Orange,19,2022-04-30,2450,2456,2432,24,87956,88158,87295,863,71,7,7,12,7088,7088,7081,7081
Placer,19,2022-04-30,270,270,265,5,6284,6298,6183,115,22,0,0,5,627,627,627,627
Plumas,19,2022-04-30,7,7,7,0,253,253,249,4,0,0,0,0,13,13,13,13
Riverside,19,2022-04-30,1752,1758,1735,23,42004,42100,41547,553,35,4,4,6,6384,6384,6380,6380
Sacramento,19,2022-04-30,1238,1239,1222,17,32587,32662,32200,462,40,7,7,11,3065,3065,3058,3058
San Benito,19,2022-04-30,45,45,44,1,1204,1207,1193,14,0,0,0,0,94,94,94,94
San Bernardino,19,2022-04-30,1348,1350,1336,14,43024,43122,42665,457,28,7,7,9,7854,7854,7847,7847
San Diego,19,2022-04-30,3770,3779,3762,17,71489,71652,71333,319,85,4,4,12,5325,5325,5321,5321
San Francisco,19,2022-04-30,2284,2290,2224,66,35042,35122,34116,1006,38,1,1,6,871,871,870,870
San Joaquin,19,2022-04-30,474,474,467,7,15184,15219,14981,238,14,1,1,3,2246,2246,2245,2245
San Luis Obispo,19,2022-04-30,257,257,254,3,5140,5153,5091,62,9,2,2,0,483,483,481,481
San Mateo,19,2022-04-30,1679,1684,1667,17,36023,36105,35749,356,18,1,1,2,704,704,703,703
Santa Barbara,19,2022-04-30,384,384,379,5,15597,15633,15422,211,7,2,2,2,693,693,691,691
Santa Clara,19,2022-04-30,3879,3887,3869,18,95389,95607,95157,450,73,5,5,13,2305,2305,2300,2300
Santa Cruz,19,2022-04-30,644,644,637,7,22285,22336,22079,257,3,0,0,0,261,261,261,261
Shasta,19,2022-04-30,61,61,60,1,3425,3432,3383,49,6,0,0,1,564,564,564,564
Siskiyou,19,2022-04-30,10,10,10,0,322,322,318,4,0,0,0,0,83,83,83,83
Solano,19,2022-04-30,607,607,599,8,11594,11620,11467,153,11,0,0,3,448,448,448,448
Sonoma,19,2022-04-30,765,765,755,10,12402,12430,12270,160,14,0,0,5,492,492,492,492
Stanislaus,19,2022-04-30,270,270,264,6,8272,8292,8121,171,18,1,1,2,1693,1693,1692,1692
Sutter,19,2022-04-30,49,49,48,1,1278,1279,1262,17,0,1,1,0,226,226,225,225
Tehama,19,2022-04-30,17,17,17,0,676,676,663,13,0,0,0,0,204,204,204,204
Trinity,19,2022-04-30,1,1,1,0,84,84,82,2,0,0,0,0,20,20,20,20
Tulare,19,2022-04-30,146,146,143,3,7126,7143,6994,149,10,2,2,0,1493,1493,1491,1491
Tuolumne,19,2022-04-30,82,82,81,1,1239,1242,1221,21,5,0,0,0,187,187,187,187
Ventura,19,2022-04-30,662,662,656,6,19505,19548,19371,177,14,3,3,2,1498,1498,1495,1495
Yolo,19,2022-04-30,310,310,306,4,19270,19314,19085,229,1,1,1,1,323,323,322,322
Yuba,19,2022-04-30,36,36,36,0,1042,1042,1029,13,1,0,0,1,118,118,118,118
Alameda,20,2022-05-07,3982,3992,3959,33,70170,70339,69761,578,62,3,3,6,1878,1878,1875,1875
Amador,20,2022-05-07,14,14,14,0,1400,1404,1385,19,0,0,0,0,86,86,86,86
Butte,20,2022-05-07,117,117,116,1,2380,2385,2369,16,4,0,0,0,433,433,433,433
Calaveras,20,2022-05-07,26,26,26,0,695,695,687,8,1,0,0,0,120,120,120,120
Colusa,20,2022-05-07,3,3,3,0,216,216,214,2,0,0,0,0,21,21,21,21
Contra Costa,20,2022-05-07,2389,2396,2363,33,30668,30741,30317,424,38,2,2,12,1297,1297,1295,1295
Del Norte,20,2022-05-07,44,44,44,0,1229,1231,1218,13,0,0,0,0,49,49,49,49
El Dorado,20,2022-05-07,170,170,168,2,2820,2825,2792,33,4,0,0,0,214,214,214,214
Fresno,20,2022-05-07,666,666,657,9,17932,17975,17741,234,30,3,3,2,2769,2769,2766,2766
Glenn,20,2022-05-07,6,6,6,0,229,229,226,3,0,0,0,0,42,42,42,42
Humboldt,20,2022-05-07,298,298,295,3,3269,3277,3242,35,2,0,0,2,146,146,146,146
Imperial,20,2022-05-07,109,109,108,1,3776,3785,3740,45,0,0,0,1,945,945,945,945
Inyo,20,2022-05-07,17,17,17,0,199,199,197,2,0,0,0,0,56,56,56,56
Kern,20,2022-05-07,435,435,431,4,18603,18646,18466,180,21,1,1,2,2342,2342,2341,2341
Kings,20,2022-05-07,90,90,89,1,4934,4945,4887,58,2,0,0,0,447,447,447,447
Lake,20,2022-05-07,30,30,30,0,1009,1011,997,14,1,0,0,0,140,140,140,140
Lassen,20,2022-05-07,2,2,2,0,1681,1686,1670,16,0,0,0,0,62,62,62,62
Los Angeles,20,2022-05-07,17683,17724,17666,58,917234,919447,916439,3008,215,25,25,33,31924,31924,31899,31899
Madera,20,2022-05-07,131,131,129,2,3755,3765,3715,50,3,0,0,0,368,368,368,368
Marin,20,2022-05-07,644,644,636,8,7603,7621,7524,97,11,0,0,1,295,295,295,295
Mariposa,20,2022-05-07,25,25,25,0,271,271,267,4,0,0,0,0,28,28,28,28
Mendocino,20,2022-05-07,87,87,85,2,1237,1238,1216,22,0,1,1,1,127,127,126,126
Merced,20,2022-05-07,180,180,178,2,3427,3434,3400,34,5,1,1,0,826,826,825,825
Modoc,20,2022-05-07,2,2,2,0,38,39,38,1,0,0,0,0,7,7,7,7
Mono,20,2022-05-07,11,11,11,0,126,126,123,3,0,0,0,0,6,6,6,6
Monterey,20,2022-05-07,433,433,424,9,9208,9230,9039,191,8,0,0,0,733,733,733,733
Napa,20,2022-05-07,229,229,227,2,3254,3260,3231,29,2,0,0,0,142,142,142,142
Nevada,20,2022-05-07,101,101,100,1,1637,1642,1621,21,3,0,0,0,128,128,128,128
Orange,20,2022-05-07,3315,3322,3297,25,91025,91246,90550,696,94,5,5,14,7093,7093,7088,7088
Placer,20,2022-05-07,474,474,467,7,6715,6733,6637,96,24,0,0,3,627,627,627,627
Plumas,20,2022-05-07,13,13,13,0,276,276,272,4,0,0,0,0,13,13,13,13
Riverside,20,2022-05-07,2358,2365,2341,24,45010,45119,44656,463,35,4,4,8,6388,6388,6384,6384
Sacramento,20,2022-05-07,1992,1998,1976,22,36343,36431,36029,402,58,3,3,12,3068,3068,3065,3065
San Benito,20,2022-05-07,60,60,59,1,1432,1436,1423,13,0,0,0,0,94,94,94,94
San Bernardino,20,2022-05-07,1781,1786,1771,15,45734,45844,45465,379,31,5,5,7,7859,7859,7854,7854
San Diego,20,2022-05-07,4964,4976,4959,17,85837,86044,85746,298,82,3,3,12,5328,5328,5325,5325
San Francisco,20,2022-05-07,2838,2845,2781,64,37440,37530,36687,843,45,6,6,7,877,877,871,871
San Joaquin,20,2022-05-07,681,681,673,8,15800,15838,15645,193,12,0,0,2,2246,2246,2246,2246
San Luis Obispo,20,2022-05-07,289,289,286,3,5185,5198,5149,49,2,0,0,0,483,483,483,483
San Mateo,20,2022-05-07,2138,2145,2129,16,36746,36835,36552,283,26,2,2,1,706,706,704,704
Santa Barbara,20,2022-05-07,584,584,578,6,15295,15332,15170,162,12,0,0,2,693,693,693,693
Santa Clara,20,2022-05-07,5426,5438,5418,20,102658,102905,102527,378,87,2,2,23,2307,2307,2305,2305
Santa Cruz,20,2022-05-07,695,695,689,6,23036,23092,22885,207,3,1,1,2,262,262,261,261
Shasta,20,2022-05-07,92,92,91,1,3458,3465,3426,39,6,0,0,1,564,564,564,564
Siskiyou,20,2022-05-07,15,15,15,0,292,292,289,3,0,0,0,0,83,83,83,83
Solano,20,2022-05-07,836,836,827,9,12324,12353,12226,127,19,0,0,0,448,448,448,448
Sonoma,20,2022-05-07,1171,1172,1160,12,13916,13948,13808,140,19,1,1,4,493,493,492,492
Stanislaus,20,2022-05-07,390,390,384,6,8635,8656,8517,139,25,0,0,2,1693,1693,1693,1693
Sutter,20,2022-05-07,44,44,44,0,1524,1529,1513,16,0,0,0,0,226,226,226,226
Tehama,20,2022-05-07,25,25,25,0,692,692,681,11,1,0,0,0,204,204,204,204
Trinity,20,2022-05-07,3,3,3,0,69,69,68,1,0,0,0,0,20,20,20,20
Tulare,20,2022-05-07,170,170,167,3,7595,7614,7490,124,12,3,3,0,1496,1496,1493,1493
Tuolumne,20,2022-05-07,80,80,79,1,1331,1336,1318,18,1,1,1,0,188,188,187,187
Ventura,20,2022-05-07,1059,1059,1052,7,21012,21062,20913,149,13,0,0,3,1498,1498,1498,1498
Yolo,20,2022-05-07,453,453,449,4,19570,19617,19436,181,0,0,0,1,323,323,323,323
Yuba,20,2022-05-07,63,63,62,1,1213,1215,1203,12,1,0,0,1,118,118,118,118
Alameda,21,2022-05-14,4760,4772,4741,31,74138,74327,73850,477,64,9,9,5,1887,1887,1878,1878
Amador,21,2022-05-14,46,46,46,0,1680,1685,1667,18,1,0,0,0,86,86,86,86
Butte,21,2022-05-14,159,159,158,1,2558,2563,2550,13,6,2,2,0,435,435,433,433
Calaveras,21,2022-05-14,36,36,36,0,746,746,739,7,0,1,1,2,121,121,120,120
Colusa,21,2022-05-14,5,5,5,0,202,202,200,2,0,0,0,0,21,21,21,21
Contra Costa,21,2022-05-14,3082,3089,3056,33,32409,32493,32143,350,46,6,6,9,1303,1303,1297,1297
Del Norte,21,2022-05-14,110,110,109,1,1750,1755,1740,15,0,0,0,0,49,49,49,49
El Dorado,21,2022-05-14,233,233,231,2,3015,3021,2994,27,5,0,0,1,214,214,214,214
Fresno,21,2022-05-14,966,966,956,10,18894,18942,18750,192,38,2,2,6,2771,2771,2769,2769
Glenn,21,2022-05-14,14,14,14,0,244,244,242,2,0,0,0,0,42,42,42,42
Humboldt,21,2022-05-14,279,279,277,2,3199,3207,3180,27,8,0,0,2,146,146,146,146
Imperial,21,2022-05-14,197,197,195,2,4194,4206,4167,39,3,0,0,1,945,945,945,945
Inyo,21,2022-05-14,20,20,20,0,226,226,224,2,1,0,0,0,56,56,56,56
Kern,21,2022-05-14,563,563,559,4,19540,19589,19442,147,17,4,4,3,2346,2346,2342,2342
Kings,21,2022-05-14,163,163,162,1,5252,5266,5218,48,0,0,0,0,447,447,447,447
Lake,21,2022-05-14,58,58,57,1,1122,1126,1114,12,0,0,0,0,140,140,140,140
Lassen,21,2022-05-14,14,14,14,0,1683,1688,1676,12,0,0,0,0,62,62,62,62
Los Angeles,21,2022-05-14,20126,20176,20125,51,936485,938869,936473,2396,281,37,37,37,31961,31961,31924,31924
Madera,21,2022-05-14,170,170,168,2,3593,3603,3566,37,3,0,0,0,368,368,368,368
Marin,21,2022-05-14,731,731,724,7,8111,8133,8052,81,11,0,0,0,295,295,295,295
Mariposa,21,2022-05-14,27,27,27,0,349,349,345,4,0,0,0,0,28,28,28,28
Mendocino,21,2022-05-14,97,97,96,1,1322,1327,1309,18,1,0,0,1,127,127,127,127
Merced,21,2022-05-14,260,260,258,2,3806,3817,3787,30,7,1,1,1,827,827,826,826
Modoc,21,2022-05-14,2,2,2,0,39,40,39,1,0,0,0,0,7,7,7,7
Mono,21,2022-05-14,10,10,10,0,116,116,114,2,0,0,0,0,6,6,6,6
Monterey,21,2022-05-14,489,489,481,8,9405,9429,9276,153,10,1,1,0,734,734,733,733
Napa,21,2022-05-14,291,291,289,2,3495,3506,3482,24,1,0,0,2,142,142,142,142
Nevada,21,2022-05-14,135,135,134,1,1837,1842,1823,19,3,0,0,0,128,128,128,128
Orange,21,2022-05-14,4160,4172,4147,25,93506,93744,93186,558,75,6,6,13,7099,7099,7093,7093
Placer,21,2022-05-14,630,630,623,7,7362,7380,7298,82,34,1,1,3,628,628,627,627
Plumas,21,2022-05-14,42,42,42,0,256,256,253,3,1,0,0,0,13,13,13,13
Riverside,21,2022-05-14,2946,2953,2929,24,46471,46589,46216,373,50,2,2,9,6390,6390,6388,6388
Sacramento,21,2022-05-14,2834,2840,2816,24,38425,38523,38191,332,62,6,6,9,3074,3074,3068,3068
San Benito,21,2022-05-14,99,99,98,1,1523,1528,1517,11,3,0,0,0,94,94,94,94
San Bernardino,21,2022-05-14,2292,2299,2284,15,48103,48224,47913,311,42,7,7,5,7866,7866,7859,7859
San Diego,21,2022-05-14,6087,6103,6087,16,91961,92196,91947,249,91,2,2,20,5330,5330,5328,5328
San Francisco,21,2022-05-14,3318,3326,3267,59,38734,38833,38148,685,57,5,5,6,882,882,877,877
San Joaquin,21,2022-05-14,1110,1110,1099,11,17922,17969,17798,171,12,1,1,0,2247,2247,2246,2246
San Luis Obispo,21,2022-05-14,354,354,351,3,5753,5769,5726,43,2,0,0,0,483,483,483,483
San Mateo,21,2022-05-14,2641,2648,2632,16,39426,39526,39289,237,36,3,3,1,709,709,706,706
Santa Barbara,21,2022-05-14,788,788,782,6,16418,16461,16325,136,8,0,0,2,693,693,693,693
Santa Clara,21,2022-05-14,6620,6639,6620,19,109814,110094,109779,315,103,8,8,21,2315,2315,2307,2307
Santa Cruz,21,2022-05-14,889,889,883,6,24853,24916,24741,175,3,0,0,1,262,262,262,262
Shasta,21,2022-05-14,118,118,117,1,3726,3735,3703,32,5,0,0,1,564,564,564,564
Siskiyou,21,2022-05-14,19,19,19,0,383,383,380,3,1,0,0,0,83,83,83,83
Solano,21,2022-05-14,1116,1118,1109,9,13410,13444,13336,108,21,0,0,3,448,448,448,448
Sonoma,21,2022-05-14,1442,1447,1436,11,15256,15296,15176,120,21,1,1,2,494,494,493,493
Stanislaus,21,2022-05-14,642,642,634,8,9650,9675,9554,121,31,1,1,4,1694,1694,1693,1693
Sutter,21,2022-05-14,105,105,104,1,1754,1759,1744,15,0,0,0,0,226,226,226,226
Tehama,21,2022-05-14,22,22,22,0,799,799,789,10,2,0,0,0,204,204,204,204
Trinity,21,2022-05-14,5,5,5,0,68,68,67,1,0,0,0,0,20,20,20,20
Tulare,21,2022-05-14,309,309,305,4,7850,7871,7771,100,10,1,1,1,1497,1497,1496,1496
Tuolumne,21,2022-05-14,96,96,95,1,1444,1448,1433,15,2,1,1,0,189,189,188,188
Ventura,21,2022-05-14,1392,1397,1389,8,22986,23045,22918,127,23,1,1,2,1499,1499,1498,1498
Yolo,21,2022-05-14,655,655,650,5,21607,21662,21506,156,1,0,0,1,323,323,323,323
Yuba,21,2022-05-14,109,109,108,1,1256,1260,1250,10,2,0,0,0,118,118,118,118
Alameda,22,2022-05-21,5567,5582,5554,28,76220,76427,76044,383,89,5,5,3,1892,1892,1887,1887
Amador,22,2022-05-21,74,74,73,1,1576,1581,1568,13,0,0,0,0,86,86,86,86
Butte,22,2022-05-21,290,290,289,1,2727,2734,2723,11,7,1,1,0,436,436,435,435
Calaveras,22,2022-05-21,56,56,56,0,765,765,759,6,0,1,1,0,122,122,121,121
Colusa,22,2022-05-21,6,6,6,0,224,224,223,1,0,0,0,0,21,21,21,21
Contra Costa,22,2022-05-21,3870,3882,3849,33,35010,35104,34808,296,65,8,8,11,1311,1311,1303,1303
Del Norte,22,2022-05-21,125,125,124,1,1579,1583,1573,10,0,1,1,0,50,50,49,49
El Dorado,22,2022-05-21,338,338,336,2,3308,3317,3294,23,3,2,2,1,216,216,214,214
Fresno,22,2022-05-21,1544,1549,1537,12,21085,21144,20976,168,57,1,1,9,2772,2772,2771,2771
Glenn,22,2022-05-21,16,16,16,0,275,275,273,2,0,0,0,0,42,42,42,42
Humboldt,22,2022-05-21,242,242,240,2,2865,2871,2852,19,8,1,1,5,147,147,146,146
Imperial,22,2022-05-21,306,306,304,2,4656,4670,4636,34,2,0,0,2,945,945,945,945
Inyo,22,2022-05-21,26,26,26,0,236,236,235,1,0,0,0,0,56,56,56,56
Kern,22,2022-05-21,915,915,910,5,20429,20484,20364,120,33,0,0,6,2346,2346,2346,2346
Kings,22,2022-05-21,250,250,248,2,5609,5624,5584,40,0,0,0,0,447,447,447,447
Lake,22,2022-05-21,83,83,82,1,1237,1240,1230,10,0,0,0,0,140,140,140,140
Lassen,22,2022-05-21,32,32,32,0,1704,1709,1699,10,0,0,0,0,62,62,62,62
Los Angeles,22,2022-05-21,26174,26245,26193,52,941078,943634,941756,1878,336,32,32,49,31993,31993,31961,31961
Madera,22,2022-05-21,208,208,206,2,3740,3751,3721,30,1,0,0,1,368,368,368,368
Marin,22,2022-05-21,834,834,827,7,8833,8857,8788,69,14,0,0,2,295,295,295,295
Mariposa,22,2022-05-21,32,32,32,0,335,335,332,3,0,0,0,0,28,28,28,28
Mendocino,22,2022-05-21,140,140,139,1,1617,1622,1605,17,4,1,1,1,128,128,127,127
Merced,22,2022-05-21,416,416,413,3,4137,4149,4124,25,3,1,1,0,828,828,827,827
Modoc,22,2022-05-21,2,2,2,0,42,43,42,1,0,0,0,0,7,7,7,7
Mono,22,2022-05-21,16,16,16,0,148,148,146,2,0,0,0,0,6,6,6,6
Monterey,22,2022-05-21,649,649,641,8,9642,9668,9545,123,10,1,1,1,735,735,734,734
Napa,22,2022-05-21,306,306,304,2,3992,4003,3982,21,5,0,0,0,142,142,142,142
Nevada,22,2022-05-21,155,155,154,1,1832,1837,1823,14,1,0,0,0,128,128,128,128
Orange,22,2022-05-21,5348,5362,5337,25,95513,95773,95328,445,97,12,12,15,7111,7111,7099,7099
Placer,22,2022-05-21,899,899,891,8,7934,7955,7885,70,35,4,4,4,632,632,628,628
Plumas,22,2022-05-21,42,42,42,0,257,257,255,2,0,0,0,0,13,13,13,13
Riverside,22,2022-05-21,4238,4250,4223,27,50987,51126,50806,320,70,4,4,9,6394,6394,6390,6390
Sacramento,22,2022-05-21,3735,3746,3721,25,40768,40878,40602,276,101,10,10,15,3084,3084,3074,3074
San Benito,22,2022-05-21,159,159,158,1,1562,1567,1558,9,0,0,0,0,94,94,94,94
San Bernardino,22,2022-05-21,3100,3107,3091,16,49562,49698,49447,251,43,5,5,8,7871,7871,7866,7866
San Diego,22,2022-05-21,8630,8653,8635,18,102139,102417,102201,216,121,5,5,21,5335,5335,5330,5330
San Francisco,22,2022-05-21,3686,3696,3645,51,41382,41495,40924,571,81,6,6,13,888,888,882,882
San Joaquin,22,2022-05-21,1497,1502,1491,11,20383,20439,20287,152,17,3,3,9,2250,2250,2247,2247
San Luis Obispo,22,2022-05-21,588,588,585,3,6906,6926,6886,40,11,3,3,0,486,486,483,483
San Mateo,22,2022-05-21,3096,3103,3088,15,40458,40568,40378,190,45,0,0,2,709,709,709,709
Santa Barbara,22,2022-05-21,1078,1080,1073,7,17947,17996,17880,116,16,0,0,4,693,693,693,693
Santa Clara,22,2022-05-21,7775,7796,7779,17,111606,111910,111660,250,112,7,7,17,2322,2322,2315,2315
Santa Cruz,22,2022-05-21,522,522,519,3,7990,8011,7967,44,11,0,0,2,262,262,262,262
Shasta,22,2022-05-21,183,183,182,1,3562,3570,3546,24,4,1,1,3,565,565,564,564
Siskiyou,22,2022-05-21,21,21,21,0,339,339,337,2,1,0,0,0,83,83,83,83
Solano,22,2022-05-21,1517,1522,1512,10,14845,14886,14792,94,25,0,0,2,448,448,448,448
Sonoma,22,2022-05-21,1538,1543,1533,10,16214,16258,16159,99,35,2,2,1,496,496,494,494
Stanislaus,22,2022-05-21,867,867,859,8,10455,10483,10380,103,36,3,3,6,1697,1697,1694,1694
Sutter,22,2022-05-21,136,136,135,1,1798,1803,1791,12,0,1,1,0,227,227,226,226
Tehama,22,2022-05-21,62,62,61,1,800,801,793,8,0,1,1,1,205,205,204,204
Trinity,22,2022-05-21,4,4,4,0,88,88,87,1,0,0,0,0,20,20,20,20
Tulare,22,2022-05-21,531,531,526,5,9006,9032,8942,90,22,0,0,0,1497,1497,1497,1497
Tuolumne,22,2022-05-21,174,174,173,1,1593,1598,1585,13,1,1,1,0,190,190,189,189
Ventura,22,2022-05-21,1906,1912,1904,8,24122,24187,24083,104,34,2,2,2,1501,1501,1499,1499
Yolo,22,2022-05-21,728,728,724,4,22661,22724,22596,128,1,0,0,1,323,323,323,323
Yuba,22,2022-05-21,151,151,150,1,1434,1439,1430,9,4,0,0,2,118,118,118,118
Alameda,23,2022-05-28,5598,5615,5593,22,73772,73988,73697,291,88,4,4,9,1896,1896,1892,1892
Amador,23,2022-05-28,102,102,101,1,1296,1299,1291,8,1,1,1,0,87,87,86,86
Butte,23,2022-05-28,310,310,309,1,3142,3153,3143,10,14,0,0,0,436,436,436,436
Calaveras,23,2022-05-28,56,56,56,0,727,727,723,4,0,0,0,0,122,122,122,122
Colusa,23,2022-05-28,11,11,11,0,207,207,206,1,0,0,0,0,21,21,21,21
Contra Costa,23,2022-05-28,3782,3793,3768,25,34463,34565,34337,228,69,8,8,8,1319,1319,1311,1311
Del Norte,23,2022-05-28,50,50,50,0,1129,1131,1125,6,0,1,1,2,51,51,50,50
El Dorado,23,2022-05-28,389,389,387,2,3455,3466,3447,19,6,2,2,0,218,218,216,216
Fresno,23,2022-05-28,1846,1852,1841,11,22288,22354,22215,139,57,4,4,7,2776,2776,2772,2772
Glenn,23,2022-05-28,32,32,32,0,316,316,314,2,2,0,0,0,42,42,42,42
Humboldt,23,2022-05-28,216,216,215,1,2806,2814,2800,14,10,1,1,3,148,148,147,147
Imperial,23,2022-05-28,372,372,370,2,4999,5014,4986,28,2,0,0,2,945,945,945,945
Inyo,23,2022-05-28,27,27,27,0,197,197,196,1,0,0,0,0,56,56,56,56
Kern,23,2022-05-28,1210,1214,1208,6,21293,21354,21256,98,26,0,0,5,2346,2346,2346,2346
Kings,23,2022-05-28,328,328,326,2,5366,5382,5352,30,2,0,0,1,447,447,447,447
Lake,23,2022-05-28,110,110,109,1,1156,1160,1153,7,0,0,0,0,140,140,140,140
Lassen,23,2022-05-28,60,60,60,0,1849,1854,1846,8,1,0,0,0,62,62,62,62
Los Angeles,23,2022-05-28,30047,30137,30090,47,929071,931797,930348,1449,395,40,40,43,32033,32033,31993,31993
Madera,23,2022-05-28,260,260,258,2,3728,3739,3716,23,6,0,0,0,368,368,368,368
Marin,23,2022-05-28,748,748,743,5,8385,8411,8360,51,16,2,2,0,297,297,295,295
Mariposa,23,2022-05-28,36,36,36,0,345,345,343,2,0,0,0,0,28,28,28,28
Mendocino,23,2022-05-28,143,143,142,1,1439,1444,1432,12,4,1,1,0,129,129,128,128
Merced,23,2022-05-28,429,429,427,2,4083,4096,4076,20,5,0,0,1,828,828,828,828
Modoc,23,2022-05-28,6,6,6,0,46,47,46,1,0,0,0,0,7,7,7,7
Mono,23,2022-05-28,6,6,6,0,126,126,125,1,0,0,0,0,6,6,6,6
Monterey,23,2022-05-28,616,616,610,6,8851,8878,8790,88,10,1,1,1,736,736,735,735
Napa,23,2022-05-28,344,344,343,1,3785,3796,3780,16,3,0,0,2,142,142,142,142
Nevada,23,2022-05-28,194,194,193,1,1959,1964,1952,12,2,2,2,0,130,130,128,128
Orange,23,2022-05-28,6103,6121,6099,22,95291,95572,95225,347,110,10,10,19,7121,7121,7111,7111
Placer,23,2022-05-28,869,869,863,6,7371,7393,7342,51,48,0,0,6,632,632,632,632
Plumas,23,2022-05-28,36,36,36,0,259,259,257,2,1,0,0,0,13,13,13,13
Riverside,23,2022-05-28,4418,4430,4408,22,51970,52123,51868,255,88,4,4,11,6398,6398,6394,6394
Sacramento,23,2022-05-28,4231,4243,4221,22,39177,39292,39085,207,125,4,4,17,3088,3088,3084,3084
San Benito,23,2022-05-28,176,176,175,1,1554,1559,1552,7,0,0,0,0,94,94,94,94
San Bernardino,23,2022-05-28,3757,3769,3754,15,49721,49866,49669,197,49,3,3,14,7874,7874,7871,7871
San Diego,23,2022-05-28,9340,9368,9353,15,100493,100788,100622,166,163,8,8,26,5343,5343,5335,5335
San Francisco,23,2022-05-28,3386,3396,3359,37,38594,38706,38288,418,80,9,9,8,897,897,888,888
San Joaquin,23,2022-05-28,1540,1545,1536,9,20039,20098,19981,117,31,0,0,6,2250,2250,2250,2250
San Luis Obispo,23,2022-05-28,793,793,789,4,6862,6881,6850,31,14,0,0,0,486,486,486,486
San Mateo,23,2022-05-28,3078,3088,3077,11,37889,37999,37860,139,38,2,2,2,711,711,709,709
Santa Barbara,23,2022-05-28,1124,1126,1120,6,17294,17344,17257,87,25,1,1,7,694,694,693,693
Santa Clara,23,2022-05-28,7734,7756,7742,14,100448,100743,100567,176,142,11,11,19,2333,2333,2322,2322
Santa Cruz,23,2022-05-28,549,549,547,2,7465,7487,7455,32,8,1,1,0,263,263,262,262
Shasta,23,2022-05-28,168,168,167,1,3509,3518,3499,19,7,1,1,4,566,566,565,565
Siskiyou,23,2022-05-28,55,55,55,0,380,380,378,2,3,0,0,0,83,83,83,83
Solano,23,2022-05-28,1410,1415,1408,7,14122,14164,14094,70,39,1,1,6,449,449,448,448
Sonoma,23,2022-05-28,1376,1381,1374,7,15704,15751,15676,75,42,1,1,4,497,497,496,496
Stanislaus,23,2022-05-28,852,852,845,7,10397,10426,10346,80,53,2,2,5,1699,1699,1697,1697
Sutter,23,2022-05-28,161,161,160,1,1953,1958,1948,10,0,0,0,0,227,227,227,227
Tehama,23,2022-05-28,50,50,50,0,882,883,877,6,4,0,0,0,205,205,205,205
Trinity,23,2022-05-28,6,6,6,0,97,97,96,1,0,0,0,0,20,20,20,20
Tulare,23,2022-05-28,625,625,620,5,9056,9083,9012,71,18,0,0,2,1497,1497,1497,1497
Tuolumne,23,2022-05-28,118,118,117,1,1536,1541,1531,10,1,0,0,1,190,190,190,190
Ventura,23,2022-05-28,1895,1901,1895,6,22952,23020,22943,77,34,1,1,4,1502,1502,1501,1501
Yolo,23,2022-05-28,697,697,694,3,21110,21172,21079,93,2,0,0,1,323,323,323,323
Yuba,23,2022-05-28,154,154,153,1,1433,1438,1431,7,10,0,0,1,118,118,118,118
Alameda,24,2022-06-04,5767,5784,5766,18,63789,63991,63798,193,105,4,4,13,1900,1900,1896,1896
Amador,24,2022-06-04,82,82,82,0,1579,1583,1575,8,3,0,0,0,87,87,87,87
Butte,24,2022-06-04,373,373,372,1,3083,3092,3084,8,24,1,1,2,437,437,436,436
Calaveras,24,2022-06-04,58,58,58,0,604,605,602,3,0,2,2,0,124,124,122,122
Colusa,24,2022-06-04,19,19,19,0,234,234,233,1,3,0,0,0,21,21,21,21
Contra Costa,24,2022-06-04,3740,3752,3733,19,31058,31155,30996,159,88,8,8,9,1327,1327,1319,1319
Del Norte,24,2022-06-04,58,58,58,0,1115,1119,1115,4,1,0,0,0,51,51,51,51
El Dorado,24,2022-06-04,353,353,351,2,3127,3138,3125,13,5,0,0,4,218,218,218,218
Fresno,24,2022-06-04,2082,2087,2077,10,20390,20453,20355,98,94,4,4,6,2780,2780,2776,2776
Glenn,24,2022-06-04,38,38,38,0,294,294,293,1,3,0,0,0,42,42,42,42
Humboldt,24,2022-06-04,234,234,233,1,2571,2578,2568,10,12,1,1,3,149,149,148,148
Imperial,24,2022-06-04,380,380,378,2,4164,4177,4159,18,5,1,1,0,946,946,945,945
Inyo,24,2022-06-04,17,17,17,0,161,161,160,1,0,0,0,0,56,56,56,56
Kern,24,2022-06-04,1370,1374,1369,5,20068,20132,20061,71,39,0,0,6,2346,2346,2346,2346
Kings,24,2022-06-04,330,330,329,1,4888,4904,4883,21,7,0,0,1,447,447,447,447
Lake,24,2022-06-04,121,121,120,1,1021,1025,1020,5,3,0,0,2,140,140,140,140
Lassen,24,2022-06-04,65,65,65,0,2112,2118,2111,7,1,0,0,0,62,62,62,62
Los Angeles,24,2022-06-04,30792,30889,30852,37,883681,886480,885422,1058,477,41,41,63,32074,32074,32033,32033
Madera,24,2022-06-04,295,295,294,1,3465,3476,3459,17,4,0,0,1,368,368,368,368
Marin,24,2022-06-04,680,680,677,3,7050,7072,7039,33,9,1,1,2,298,298,297,297
Mariposa,24,2022-06-04,62,62,62,0,363,363,361,2,0,0,0,0,28,28,28,28
Mendocino,24,2022-06-04,193,193,192,1,1500,1504,1494,10,7,0,0,2,129,129,129,129
Merced,24,2022-06-04,447,447,445,2,3780,3792,3778,14,11,0,0,0,828,828,828,828
Modoc,24,2022-06-04,9,9,9,0,34,35,34,1,0,0,0,0,7,7,7,7
Mono,24,2022-06-04,13,13,13,0,107,107,106,1,0,0,0,0,6,6,6,6
Monterey,24,2022-06-04,887,889,882,7,8981,9009,8940,69,21,1,1,1,737,737,736,736
Napa,24,2022-06-04,446,446,445,1,3418,3428,3417,11,10,1,1,0,143,143,142,142
Nevada,24,2022-06-04,218,218,217,1,1808,1812,1803,9,4,0,0,1,130,130,130,130
Orange,24,2022-06-04,6735,6757,6738,19,64898,65104,64922,182,121,9,9,17,7130,7130,7121,7121
Placer,24,2022-06-04,790,791,787,4,6652,6674,6639,35,65,0,0,14,632,632,632,632
Plumas,24,2022-06-04,41,41,41,0,264,264,263,1,0,0,0,0,13,13,13,13
Riverside,24,2022-06-04,4584,4598,4581,17,47959,48111,47930,181,97,6,6,10,6404,6404,6398,6398
Sacramento,24,2022-06-04,4403,4417,4399,18,36922,37038,36887,151,126,14,14,20,3102,3102,3088,3088
San Benito,24,2022-06-04,222,222,221,1,1714,1719,1713,6,0,0,0,0,94,94,94,94
San Bernardino,24,2022-06-04,4399,4413,4400,13,47759,47909,47763,146,75,7,7,13,7881,7881,7874,7874
San Diego,24,2022-06-04,9564,9593,9581,12,90489,90775,90660,115,179,5,5,28,5348,5348,5343,5343
San Francisco,24,2022-06-04,3335,3345,3317,28,34810,34919,34628,291,78,4,4,11,901,901,897,897
San Joaquin,24,2022-06-04,1810,1816,1808,8,18918,18978,18893,85,37,4,4,9,2254,2254,2250,2250
San Luis Obispo,24,2022-06-04,783,785,782,3,6523,6544,6521,23,13,2,2,0,488,488,486,486
San Mateo,24,2022-06-04,2904,2914,2906,8,32778,32880,32787,93,28,3,3,4,714,714,711,711
Santa Barbara,24,2022-06-04,1185,1189,1184,5,13588,13631,13578,53,17,2,2,6,696,696,694,694
Santa Clara,24,2022-06-04,7810,7835,7824,11,89793,90076,89955,121,163,7,7,17,2340,2340,2333,2333
Santa Cruz,24,2022-06-04,737,737,735,2,7423,7447,7422,25,15,0,0,2,263,263,263,263
Shasta,24,2022-06-04,169,169,168,1,3723,3736,3721,15,10,3,3,1,569,569,566,566
Siskiyou,24,2022-06-04,44,44,44,0,385,385,384,1,2,0,0,0,83,83,83,83
Solano,24,2022-06-04,1427,1431,1426,5,12903,12943,12894,49,30,2,2,3,451,451,449,449
Sonoma,24,2022-06-04,1433,1437,1432,5,12118,12156,12111,45,40,2,2,2,499,499,497,497
Stanislaus,24,2022-06-04,1048,1052,1046,6,9518,9547,9490,57,52,1,1,3,1700,1700,1699,1699
Sutter,24,2022-06-04,183,183,182,1,1822,1828,1821,7,0,0,0,0,227,227,227,227
Tehama,24,2022-06-04,71,71,71,0,887,890,885,5,1,0,0,0,205,205,205,205
Trinity,24,2022-06-04,9,9,9,0,108,108,107,1,0,0,0,0,20,20,20,20
Tulare,24,2022-06-04,751,751,746,5,8880,8907,8853,54,26,0,0,1,1497,1497,1497,1497
Tuolumne,24,2022-06-04,114,114,113,1,1451,1455,1448,7,2,0,0,0,190,190,190,190
Ventura,24,2022-06-04,1747,1753,1748,5,21942,22012,21955,57,45,1,1,3,1503,1503,1502,1502
Yolo,24,2022-06-04,727,729,727,2,18665,18724,18661,63,2,1,1,0,324,324,323,323
Yuba,24,2022-06-04,160,160,159,1,1409,1413,1408,5,0,0,0,6,118,118,118,118
Alameda,25,2022-06-11,5392,5412,5399,13,57798,58001,57863,138,109,5,5,16,1905,1905,1900,1900
Amador,25,2022-06-11,141,141,140,1,1423,1428,1422,6,1,0,0,0,87,87,87,87
Butte,25,2022-06-11,420,420,419,1,3452,3465,3458,7,24,3,3,0,440,440,437,437
Calaveras,25,2022-06-11,78,78,78,0,704,705,703,2,0,0,0,1,124,124,124,124
Colusa,25,2022-06-11,18,18,18,0,269,269,268,1,17,0,0,0,21,21,21,21
Contra Costa,25,2022-06-11,3599,3611,3596,15,29620,29723,29604,119,82,5,5,10,1332,1332,1327,1327
Del Norte,25,2022-06-11,69,69,69,0,680,680,678,2,2,0,0,0,51,51,51,51
El Dorado,25,2022-06-11,367,367,366,1,3471,3483,3471,12,5,3,3,2,221,221,218,218
Fresno,25,2022-06-11,2350,2358,2349,9,20969,21043,20964,79,107,4,4,10,2784,2784,2780,2780
Glenn,25,2022-06-11,37,37,37,0,321,321,320,1,6,0,0,0,42,42,42,42
Humboldt,25,2022-06-11,249,249,248,1,2502,2511,2503,8,13,0,0,2,149,149,149,149
Imperial,25,2022-06-11,458,458,456,2,4559,4575,4559,16,5,0,0,1,946,946,946,946
Inyo,25,2022-06-11,15,15,15,0,211,211,210,1,0,0,0,0,56,56,56,56
Kern,25,2022-06-11,1586,1592,1588,4,21260,21334,21275,59,28,2,2,8,2348,2348,2346,2346
Kings,25,2022-06-11,365,365,364,1,5105,5123,5106,17,6,1,1,0,448,448,447,447
Lake,25,2022-06-11,140,140,139,1,1213,1218,1213,5,2,0,0,0,140,140,140,140
Lassen,25,2022-06-11,67,67,67,0,2015,2023,2018,5,3,0,0,0,62,62,62,62
Los Angeles,25,2022-06-11,31223,31332,31302,30,760335,762991,762267,724,504,49,49,70,32123,32123,32074,32074
Madera,25,2022-06-11,362,362,361,1,4131,4146,4130,16,9,0,0,1,368,368,368,368
Marin,25,2022-06-11,688,688,685,3,6979,7004,6978,26,18,2,2,0,300,300,298,298
Mariposa,25,2022-06-11,40,40,40,0,381,381,379,2,0,0,0,0,28,28,28,28
Mendocino,25,2022-06-11,176,176,175,1,1640,1645,1637,8,6,1,1,1,130,130,129,129
Merced,25,2022-06-11,540,540,538,2,4085,4098,4086,12,12,0,0,1,828,828,828,828
Modoc,25,2022-06-11,9,9,9,0,37,38,37,1,1,1,1,0,8,8,7,7
Mono,25,2022-06-11,18,18,18,0,82,82,81,1,0,0,0,0,6,6,6,6
Monterey,25,2022-06-11,841,842,837,5,8793,8824,8771,53,25,4,4,2,741,741,737,737
Napa,25,2022-06-11,504,504,503,1,4083,4099,4089,10,4,1,1,1,144,144,143,143
Nevada,25,2022-06-11,185,185,184,1,1903,1910,1903,7,6,0,0,0,130,130,130,130
Orange,25,2022-06-11,6964,6988,6973,15,66067,66300,66154,146,171,14,14,18,7144,7144,7130,7130
Placer,25,2022-06-11,812,813,810,3,7018,7043,7014,29,72,2,2,8,634,634,632,632
Plumas,25,2022-06-11,37,37,37,0,290,290,289,1,0,0,0,0,13,13,13,13
Riverside,25,2022-06-11,5046,5064,5049,15,49286,49459,49312,147,85,2,2,11,6406,6406,6404,6404
Sacramento,25,2022-06-11,4386,4401,4387,14,37855,37987,37865,122,151,16,16,24,3118,3118,3102,3102
San Benito,25,2022-06-11,227,227,226,1,1797,1802,1797,5,3,0,0,0,94,94,94,94
San Bernardino,25,2022-06-11,4747,4764,4753,11,49786,49961,49841,120,70,6,6,15,7887,7887,7881,7881
San Diego,25,2022-06-11,9825,9858,9848,10,85763,86065,85979,86,189,14,14,27,5362,5362,5348,5348
San Francisco,25,2022-06-11,3086,3097,3077,20,32048,32160,31949,211,67,8,8,12,909,909,901,901
San Joaquin,25,2022-06-11,1975,1980,1973,7,19533,19602,19532,70,41,6,6,2,2260,2260,2254,2254
San Luis Obispo,25,2022-06-11,690,692,690,2,6219,6241,6224,17,19,0,0,1,488,488,488,488
San Mateo,25,2022-06-11,2757,2766,2760,6,29959,30063,29996,67,44,2,2,3,716,716,714,714
Santa Barbara,25,2022-06-11,982,986,983,3,10082,10118,10087,31,18,1,1,5,697,697,696,696
Santa Clara,25,2022-06-11,7360,7386,7378,8,80452,80732,80646,86,174,8,8,24,2348,2348,2340,2340
Santa Cruz,25,2022-06-11,904,907,905,2,10655,10691,10663,28,12,1,1,1,264,264,263,263
Shasta,25,2022-06-11,220,220,219,1,3600,3613,3601,12,9,2,2,1,571,571,569,569
Siskiyou,25,2022-06-11,45,45,45,0,389,389,388,1,1,0,0,0,83,83,83,83
Solano,25,2022-06-11,1713,1719,1714,5,13308,13354,13314,40,40,0,0,3,451,451,451,451
Sonoma,25,2022-06-11,1405,1411,1407,4,12065,12108,12073,35,40,1,1,6,500,500,499,499
Stanislaus,25,2022-06-11,1166,1171,1166,5,9623,9657,9612,45,53,1,1,6,1701,1701,1700,1700
Sutter,25,2022-06-11,194,194,193,1,1822,1827,1821,6,0,0,0,0,227,227,227,227
Tehama,25,2022-06-11,94,94,94,0,1030,1033,1028,5,3,0,0,0,205,205,205,205
Trinity,25,2022-06-11,7,7,7,0,82,83,82,1,0,0,0,0,20,20,20,20
Tulare,25,2022-06-11,792,793,789,4,9614,9648,9602,46,22,1,1,1,1498,1498,1497,1497
Tuolumne,25,2022-06-11,132,132,132,0,1506,1511,1505,6,3,0,0,0,190,190,190,190
Ventura,25,2022-06-11,1940,1947,1943,4,21230,21303,21259,44,32,5,5,4,1508,1508,1503,1503
Yolo,25,2022-06-11,794,795,793,2,15637,15692,15650,42,2,0,0,0,324,324,324,324
Yuba,25,2022-06-11,197,197,196,1,1476,1481,1477,4,8,0,0,1,118,118,118,118
Alameda,26,2022-06-18,4782,4801,4792,9,51201,51405,51309,96,96,8,8,11,1913,1913,1905,1905
Amador,26,2022-06-18,84,84,84,0,1244,1249,1245,4,1,0,0,0,87,87,87,87
Butte,26,2022-06-18,394,394,393,1,3583,3598,3593,5,23,4,4,1,444,444,440,440
Calaveras,26,2022-06-18,73,73,73,0,603,603,601,2,0,0,0,0,124,124,124,124
Colusa,26,2022-06-18,12,12,12,0,265,265,264,1,15,0,0,0,21,21,21,21
Contra Costa,26,2022-06-18,3238,3250,3240,10,26474,26579,26496,83,71,9,9,8,1341,1341,1332,1332
Del Norte,26,2022-06-18,81,81,81,0,613,614,613,1,2,1,1,1,52,52,51,51
El Dorado,26,2022-06-18,319,319,318,1,2968,2980,2972,8,7,0,0,1,221,221,221,221
Fresno,26,2022-06-18,2441,2452,2445,7,20558,20640,20579,61,94,3,3,12,2787,2787,2784,2784
Glenn,26,2022-06-18,33,33,33,0,308,308,307,1,3,0,0,0,42,42,42,42
Humboldt,26,2022-06-18,283,283,282,1,2232,2241,2236,5,13,0,0,4,149,149,149,149
Imperial,26,2022-06-18,542,542,541,1,4144,4161,4150,11,7,1,1,0,947,947,946,946
Inyo,26,2022-06-18,18,18,18,0,181,182,181,1,0,0,0,0,56,56,56,56
Kern,26,2022-06-18,1561,1567,1564,3,20657,20739,20694,45,37,4,4,8,2352,2352,2348,2348
Kings,26,2022-06-18,393,393,392,1,5081,5101,5088,13,4,1,1,0,449,449,448,448
Lake,26,2022-06-18,127,127,127,0,1195,1200,1196,4,3,0,0,2,140,140,140,140
Lassen,26,2022-06-18,49,49,49,0,1295,1300,1297,3,1,0,0,0,62,62,62,62
Los Angeles,26,2022-06-18,27498,27607,27587,20,369807,371275,371001,274,587,60,60,66,32183,32183,32123,32123
Madera,26,2022-06-18,334,334,333,1,4165,4182,4169,13,5,0,0,0,368,368,368,368
Marin,26,2022-06-18,684,684,682,2,6571,6597,6578,19,18,1,1,4,301,301,300,300
Mariposa,26,2022-06-18,51,51,51,0,342,342,341,1,0,0,0,0,28,28,28,28
Mendocino,26,2022-06-18,163,163,162,1,1560,1565,1559,6,4,0,0,2,130,130,130,130
Merced,26,2022-06-18,540,540,539,1,4108,4125,4116,9,10,3,3,1,831,831,828,828
Modoc,26,2022-06-18,2,2,2,0,33,34,33,1,1,0,0,0,8,8,8,8
Mono,26,2022-06-18,7,7,7,0,92,93,92,1,0,1,1,0,7,7,6,6
Monterey,26,2022-06-18,897,902,898,4,8935,8970,8928,42,30,1,1,1,742,742,741,741
Napa,26,2022-06-18,377,377,376,1,3356,3369,3362,7,3,0,0,1,144,144,144,144
Nevada,26,2022-06-18,186,186,185,1,1731,1738,1733,5,9,0,0,0,130,130,130,130
Orange,26,2022-06-18,7006,7033,7021,12,61749,61996,61889,107,143,9,9,27,7153,7153,7144,7144
Placer,26,2022-06-18,689,689,687,2,6140,6164,6144,20,71,1,1,7,635,635,634,634
Plumas,26,2022-06-18,32,32,32,0,229,229,228,1,0,0,0,0,13,13,13,13
Riverside,26,2022-06-18,5020,5040,5028,12,44618,44795,44691,104,98,6,6,9,6412,6412,6406,6406
Sacramento,26,2022-06-18,3912,3927,3917,10,35508,35649,35560,89,159,9,9,21,3127,3127,3118,3118
San Benito,26,2022-06-18,182,182,182,0,1675,1680,1677,3,0,1,1,1,95,95,94,94
San Bernardino,26,2022-06-18,4585,4605,4596,9,46500,46684,46597,87,106,9,9,14,7896,7896,7887,7887
San Diego,26,2022-06-18,9903,9943,9935,8,80497,80816,80753,63,202,6,6,16,5368,5368,5362,5362
San Francisco,26,2022-06-18,3086,3098,3082,16,29861,29980,29826,154,77,13,13,14,922,922,909,909
San Joaquin,26,2022-06-18,1688,1695,1690,5,18161,18234,18184,50,43,1,1,5,2261,2261,2260,2260
San Luis Obispo,26,2022-06-18,582,583,582,1,5763,5785,5773,12,31,8,8,0,496,496,488,488
San Mateo,26,2022-06-18,2575,2586,2582,4,27203,27311,27264,47,48,2,2,1,718,718,716,716
Santa Barbara,26,2022-06-18,891,896,894,2,8531,8565,8545,20,24,1,1,5,698,698,697,697
Santa Clara,26,2022-06-18,6790,6817,6811,6,65244,65504,65450,54,147,9,9,18,2357,2357,2348,2348
Santa Cruz,26,2022-06-18,794,798,796,2,9220,9257,9238,19,18,1,1,2,265,265,264,264
Shasta,26,2022-06-18,223,223,222,1,3268,3281,3273,8,8,1,1,1,572,572,571,571
Siskiyou,26,2022-06-18,55,55,55,0,401,401,400,1,2,1,1,0,84,84,83,83
Solano,26,2022-06-18,1445,1451,1448,3,11823,11870,11842,28,37,0,0,5,451,451,451,451
Sonoma,26,2022-06-18,1381,1387,1384,3,11060,11104,11079,25,31,2,2,3,502,502,500,500
Stanislaus,26,2022-06-18,1049,1054,1050,4,8932,8967,8934,33,66,5,5,8,1706,1706,1701,1701
Sutter,26,2022-06-18,199,199,199,0,1851,1857,1853,4,0,0,0,0,227,227,227,227
Tehama,26,2022-06-18,105,105,105,0,929,933,930,3,3,0,0,0,205,205,205,205
Trinity,26,2022-06-18,10,10,10,0,109,110,109,1,0,0,0,0,20,20,20,20
Tulare,26,2022-06-18,890,894,891,3,9370,9405,9370,35,28,5,5,0,1503,1503,1498,1498
Tuolumne,26,2022-06-18,146,146,146,0,1556,1562,1557,5,3,0,0,0,190,190,190,190
Ventura,26,2022-06-18,1844,1851,1848,3,19135,19211,19180,31,52,1,1,5,1509,1509,1508,1508
Yolo,26,2022-06-18,710,711,710,1,11773,11820,11795,25,3,1,1,3,325,325,324,324
Yuba,26,2022-06-18,151,151,151,0,1403,1408,1405,3,8,0,0,6,118,118,118,118
Alameda,27,2022-06-25,5302,5326,5318,8,46655,46858,46790,68,126,10,10,17,1923,1923,1913,1913
Amador,27,2022-06-25,96,96,96,0,1164,1169,1166,3,1,0,0,2,87,87,87,87
Butte,27,2022-06-25,410,410,410,0,3364,3380,3376,4,29,2,2,0,446,446,444,444
Calaveras,27,2022-06-25,74,74,74,0,591,592,591,1,0,2,2,0,126,126,124,124
Colusa,27,2022-06-25,23,23,23,0,184,185,184,1,8,1,1,0,22,22,21,21
Contra Costa,27,2022-06-25,3533,3548,3539,9,25205,25315,25253,62,92,10,10,7,1351,1351,1341,1341
Del Norte,27,2022-06-25,127,127,127,0,671,674,673,1,6,1,1,0,53,53,52,52
El Dorado,27,2022-06-25,420,420,419,1,3185,3198,3191,7,7,1,1,2,222,222,221,221
Fresno,27,2022-06-25,2681,2693,2687,6,19866,19954,19908,46,124,3,3,16,2790,2790,2787,2787
Glenn,27,2022-06-25,31,31,31,0,298,299,298,1,2,0,0,0,42,42,42,42
Humboldt,27,2022-06-25,279,279,278,1,2236,2247,2243,4,4,0,0,2,149,149,149,149
Imperial,27,2022-06-25,669,671,670,1,3830,3847,3839,8,6,0,0,2,947,947,947,947
Inyo,27,2022-06-25,21,21,21,0,235,236,235,1,0,0,0,0,56,56,56,56
Kern,27,2022-06-25,1830,1838,1835,3,18416,18496,18465,31,46,7,7,8,2359,2359,2352,2352
Kings,27,2022-06-25,453,453,452,1,4126,4144,4135,9,8,0,0,0,449,449,449,449
Lake,27,2022-06-25,118,118,118,0,1126,1131,1128,3,3,0,0,0,140,140,140,140
Lassen,27,2022-06-25,53,53,53,0,1119,1124,1122,2,1,0,0,0,62,62,62,62
Los Angeles,27,2022-06-25,30443,30577,30560,17,351317,352851,352649,202,674,63,63,74,32246,32246,32183,32183
Madera,27,2022-06-25,425,425,424,1,4280,4299,4289,10,8,0,0,0,368,368,368,368
Marin,27,2022-06-25,677,679,677,2,6243,6271,6257,14,20,1,1,2,302,302,301,301
Mariposa,27,2022-06-25,57,57,57,0,304,304,303,1,0,0,0,0,28,28,28,28
Mendocino,27,2022-06-25,161,161,160,1,1390,1395,1391,4,5,0,0,0,130,130,130,130
Merced,27,2022-06-25,567,567,566,1,4045,4063,4056,7,5,2,2,0,833,833,831,831
Modoc,27,2022-06-25,9,9,9,0,33,34,33,1,0,0,0,0,8,8,8,8
Mono,27,2022-06-25,12,12,12,0,80,81,80,1,0,0,0,0,7,7,7,7
Monterey,27,2022-06-25,901,906,903,3,8471,8507,8476,31,34,1,1,5,743,743,742,742
Napa,27,2022-06-25,367,367,366,1,3187,3201,3196,5,4,2,2,0,146,146,144,144
Nevada,27,2022-06-25,163,163,163,0,1571,1577,1573,4,4,1,1,1,131,131,130,130
Orange,27,2022-06-25,7213,7244,7234,10,58076,58329,58251,78,174,12,12,31,7165,7165,7153,7153
Placer,27,2022-06-25,757,760,758,2,6082,6109,6094,15,92,5,5,7,640,640,635,635
Plumas,27,2022-06-25,50,50,50,0,262,262,261,1,0,0,0,0,13,13,13,13
Riverside,27,2022-06-25,5723,5748,5738,10,43626,43818,43739,79,119,8,8,15,6420,6420,6412,6412
Sacramento,27,2022-06-25,4070,4088,4080,8,34243,34393,34326,67,155,12,12,17,3139,3139,3127,3127
San Benito,27,2022-06-25,185,185,185,0,1528,1534,1532,2,0,0,0,2,95,95,95,95
San Bernardino,27,2022-06-25,5167,5191,5183,8,46465,46668,46600,68,111,14,14,19,7910,7910,7896,7896
San Diego,27,2022-06-25,10062,10107,10101,6,77599,77938,77891,47,254,8,8,18,5376,5376,5368,5368
San Francisco,27,2022-06-25,3206,3219,3206,13,27838,27960,27849,111,96,5,5,22,927,927,922,922
San Joaquin,27,2022-06-25,1846,1853,1849,4,17927,18006,17967,39,51,6,6,8,2267,2267,2261,2261
San Luis Obispo,27,2022-06-25,622,623,622,1,5744,5770,5760,10,25,4,4,0,500,500,496,496
San Mateo,27,2022-06-25,2806,2819,2815,4,25545,25656,25621,35,38,1,1,1,719,719,718,718
Santa Barbara,27,2022-06-25,1075,1081,1079,2,9236,9277,9260,17,29,3,3,3,701,701,698,698
Santa Clara,27,2022-06-25,7196,7228,7223,5,58481,58738,58700,38,180,10,10,13,2367,2367,2357,2357
Santa Cruz,27,2022-06-25,873,878,877,1,9124,9164,9150,14,20,2,2,1,267,267,265,265
Shasta,27,2022-06-25,300,300,299,1,3306,3322,3315,7,19,0,0,2,572,572,572,572
Siskiyou,27,2022-06-25,62,62,62,0,341,341,340,1,1,1,1,0,85,85,84,84
Solano,27,2022-06-25,1574,1580,1577,3,12646,12701,12678,23,35,0,0,4,451,451,451,451
Sonoma,27,2022-06-25,1404,1411,1409,2,10000,10043,10025,18,29,2,2,4,504,504,502,502
Stanislaus,27,2022-06-25,1174,1180,1177,3,8792,8831,8806,25,94,1,1,6,1707,1707,1706,1706
Sutter,27,2022-06-25,192,192,192,0,1842,1850,1847,3,0,0,0,0,227,227,227,227
Tehama,27,2022-06-25,81,81,81,0,826,831,829,2,2,0,0,0,205,205,205,205
Trinity,27,2022-06-25,22,22,22,0,142,143,142,1,1,0,0,0,20,20,20,20
Tulare,27,2022-06-25,903,908,905,3,7856,7891,7868,23,42,4,4,1,1507,1507,1503,1503
Tuolumne,27,2022-06-25,176,176,176,0,1420,1426,1423,3,2,3,3,0,193,193,190,190
Ventura,27,2022-06-25,2019,2026,2023,3,18634,18716,18693,23,56,2,2,4,1511,1511,1509,1509
Yolo,27,2022-06-25,771,774,773,1,10392,10437,10420,17,5,1,1,2,326,326,325,325
Yuba,27,2022-06-25,157,157,157,0,1395,1400,1398,2,10,2,2,2,120,120,118,118
Alameda,28,2022-07-02,5420,5446,5440,6,45248,45469,45418,51,111,10,10,12,1933,1933,1923,1923
Amador,28,2022-07-02,91,91,91,0,1661,1669,1666,3,4,1,1,3,88,88,87,87
Butte,28,2022-07-02,356,356,356,0,3090,3107,3104,3,24,2,2,1,448,448,446,446
Calaveras,28,2022-07-02,84,84,84,0,549,550,549,1,0,2,2,0,128,128,126,126
Colusa,28,2022-07-02,29,29,29,0,261,263,262,1,5,0,0,0,22,22,22,22
Contra Costa,28,2022-07-02,3611,3629,3622,7,24579,24699,24652,47,89,7,7,10,1358,1358,1351,1351
Del Norte,28,2022-07-02,155,155,155,0,671,674,673,1,5,0,0,0,53,53,53,53
El Dorado,28,2022-07-02,365,365,364,1,3047,3063,3058,5,8,1,1,2,223,223,222,222
Fresno,28,2022-07-02,2736,2749,2744,5,18362,18451,18418,33,151,2,2,16,2792,2792,2790,2790
Glenn,28,2022-07-02,28,28,28,0,257,259,258,1,1,0,0,0,42,42,42,42
Humboldt,28,2022-07-02,196,196,196,0,1911,1922,1919,3,9,2,2,4,151,151,149,149
Imperial,28,2022-07-02,771,775,774,1,3853,3871,3865,6,8,1,1,3,948,948,947,947
Inyo,28,2022-07-02,46,46,46,0,367,369,368,1,1,0,0,0,56,56,56,56
Kern,28,2022-07-02,1916,1925,1922,3,16210,16288,16267,21,55,3,3,8,2362,2362,2359,2359
Kings,28,2022-07-02,515,516,515,1,3966,3984,3978,6,5,0,0,0,449,449,449,449
Lake,28,2022-07-02,116,116,116,0,1027,1032,1030,2,2,2,2,1,142,142,140,140
Lassen,28,2022-07-02,42,42,42,0,838,841,840,1,2,0,0,0,62,62,62,62
Los Angeles,28,2022-07-02,36116,36293,36277,16,345069,346753,346598,155,726,78,78,95,32324,32324,32246,32246
Madera,28,2022-07-02,386,386,385,1,4064,4085,4078,7,11,0,0,1,368,368,368,368
Marin,28,2022-07-02,649,653,652,1,5762,5791,5781,10,26,0,0,2,302,302,302,302
Mariposa,28,2022-07-02,38,38,38,0,251,252,251,1,0,0,0,0,28,28,28,28
Mendocino,28,2022-07-02,164,164,164,0,1345,1352,1349,3,4,1,1,1,131,131,130,130
Merced,28,2022-07-02,699,701,700,1,3698,3717,3712,5,10,1,1,1,834,834,833,833
Modoc,28,2022-07-02,11,11,11,0,36,37,36,1,1,0,0,0,8,8,8,8
Mono,28,2022-07-02,33,33,33,0,118,119,118,1,0,0,0,0,7,7,7,7
Monterey,28,2022-07-02,912,917,914,3,7392,7428,7407,21,46,2,2,2,745,745,743,743
Napa,28,2022-07-02,402,402,402,0,3169,3185,3181,4,8,1,1,1,147,147,146,146
Nevada,28,2022-07-02,210,210,210,0,1536,1543,1540,3,7,0,0,0,131,131,131,131
Orange,28,2022-07-02,7917,7957,7949,8,57948,58232,58171,61,196,23,23,38,7188,7188,7165,7165
Placer,28,2022-07-02,856,861,859,2,5870,5898,5886,12,71,3,3,6,643,643,640,640
Plumas,28,2022-07-02,31,31,31,0,214,215,214,1,2,0,0,0,13,13,13,13
Riverside,28,2022-07-02,7090,7125,7115,10,44746,44966,44903,63,134,7,7,11,6427,6427,6420,6420
Sacramento,28,2022-07-02,4089,4109,4103,6,31739,31894,31845,49,159,11,11,21,3150,3150,3139,3139
San Benito,28,2022-07-02,254,254,254,0,1594,1602,1600,2,0,0,0,1,95,95,95,95
San Bernardino,28,2022-07-02,6729,6761,6753,8,47941,48174,48119,55,123,12,12,21,7922,7922,7910,7910
San Diego,28,2022-07-02,11179,11234,11229,5,76982,77358,77321,37,295,9,9,35,5385,5385,5376,5376
San Francisco,28,2022-07-02,3163,3178,3168,10,26997,27129,27044,85,95,8,8,19,935,935,927,927
San Joaquin,28,2022-07-02,1891,1901,1898,3,16961,17043,17014,29,40,4,4,5,2271,2271,2267,2267
San Luis Obispo,28,2022-07-02,702,706,705,1,5172,5197,5190,7,25,1,1,0,501,501,500,500
San Mateo,28,2022-07-02,2770,2782,2779,3,24655,24776,24750,26,39,2,2,5,721,721,719,719
Santa Barbara,28,2022-07-02,1173,1180,1178,2,9209,9254,9241,13,25,4,4,1,705,705,701,701
Santa Clara,28,2022-07-02,7562,7599,7595,4,57319,57599,57570,29,212,13,13,35,2380,2380,2367,2367
Santa Cruz,28,2022-07-02,839,844,843,1,8838,8882,8871,11,24,0,0,1,267,267,267,267
Shasta,28,2022-07-02,335,335,334,1,3126,3142,3137,5,16,4,4,4,576,576,572,572
Siskiyou,28,2022-07-02,58,58,58,0,381,382,381,1,2,0,0,1,85,85,85,85
Solano,28,2022-07-02,1526,1533,1531,2,11754,11811,11794,17,50,0,0,5,451,451,451,451
Sonoma,28,2022-07-02,1213,1220,1218,2,9520,9567,9554,13,37,1,1,1,505,505,504,504
Stanislaus,28,2022-07-02,1261,1268,1265,3,8182,8223,8205,18,90,6,6,12,1713,1713,1707,1707
Sutter,28,2022-07-02,254,254,254,0,1864,1873,1870,3,0,0,0,0,227,227,227,227
Tehama,28,2022-07-02,119,119,119,0,976,981,979,2,6,0,0,0,205,205,205,205
Trinity,28,2022-07-02,20,20,20,0,150,151,150,1,3,0,0,0,20,20,20,20
Tulare,28,2022-07-02,1006,1011,1009,2,7598,7635,7618,17,30,2,2,1,1509,1509,1507,1507
Tuolumne,28,2022-07-02,175,175,175,0,1181,1187,1185,2,7,0,0,2,193,193,193,193
Ventura,28,2022-07-02,2170,2182,2180,2,17974,18062,18045,17,68,3,3,3,1514,1514,1511,1511
Yolo,28,2022-07-02,626,630,629,1,8689,8732,8721,11,6,1,1,2,327,327,326,326
Yuba,28,2022-07-02,199,199,199,0,1236,1241,1239,2,6,0,0,2,120,120,120,120
Alameda,29,2022-07-09,5218,5245,5240,5,41425,41644,41608,36,110,9,9,19,1942,1942,1933,1933
Amador,29,2022-07-09,97,97,97,0,1453,1460,1458,2,1,0,0,2,88,88,88,88
Butte,29,2022-07-09,391,392,392,0,2694,2708,2706,2,28,1,1,4,449,449,448,448
Calaveras,29,2022-07-09,76,76,76,0,504,506,505,1,0,1,1,0,129,129,128,128
Colusa,29,2022-07-09,27,27,27,0,357,360,359,1,0,0,0,0,22,22,22,22
Contra Costa,29,2022-07-09,3465,3484,3479,5,23051,23173,23139,34,95,14,14,14,1372,1372,1358,1358
Del Norte,29,2022-07-09,145,145,145,0,590,594,593,1,6,0,0,2,53,53,53,53
El Dorado,29,2022-07-09,321,321,321,0,2659,2674,2671,3,11,0,0,3,223,223,223,223
Fresno,29,2022-07-09,3176,3192,3188,4,18663,18762,18736,26,145,8,8,11,2800,2800,2792,2792
Glenn,29,2022-07-09,39,39,39,0,275,277,276,1,0,0,0,0,42,42,42,42
Humboldt,29,2022-07-09,262,262,262,0,1840,1851,1849,2,9,1,1,2,152,152,151,151
Imperial,29,2022-07-09,965,969,968,1,3870,3889,3884,5,9,0,0,1,948,948,948,948
Inyo,29,2022-07-09,35,35,35,0,328,330,329,1,0,0,0,0,56,56,56,56
Kern,29,2022-07-09,2040,2051,2049,2,14551,14627,14612,15,75,4,4,11,2366,2366,2362,2362
Kings,29,2022-07-09,585,588,587,1,3752,3772,3767,5,11,3,3,1,452,452,449,449
Lake,29,2022-07-09,113,113,113,0,961,965,964,1,2,0,0,0,142,142,142,142
Lassen,29,2022-07-09,47,47,47,0,691,695,694,1,5,1,1,0,63,63,62,62
Los Angeles,29,2022-07-09,37594,37793,37780,13,320161,321858,321747,111,959,92,92,109,32416,32416,32324,32324
Madera,29,2022-07-09,439,439,438,1,3416,3434,3429,5,10,0,0,5,368,368,368,368
Marin,29,2022-07-09,582,584,583,1,5280,5307,5300,7,17,2,2,3,304,304,302,302
Mariposa,29,2022-07-09,48,48,48,0,261,262,261,1,0,0,0,0,28,28,28,28
Mendocino,29,2022-07-09,185,185,185,0,1253,1259,1257,2,10,2,2,0,133,133,131,131
Merced,29,2022-07-09,658,662,661,1,3599,3618,3614,4,22,3,3,3,837,837,834,834
Modoc,29,2022-07-09,27,27,27,0,48,49,48,1,0,0,0,0,8,8,8,8
Mono,29,2022-07-09,13,13,13,0,89,90,89,1,0,0,0,0,7,7,7,7
Monterey,29,2022-07-09,991,997,995,2,6843,6879,6864,15,48,3,3,2,748,748,745,745
Napa,29,2022-07-09,320,320,320,0,3025,3042,3039,3,12,1,1,2,148,148,147,147
Nevada,29,2022-07-09,182,182,182,0,1523,1530,1528,2,6,0,0,2,131,131,131,131
Orange,29,2022-07-09,8332,8375,8368,7,56083,56380,56334,46,246,23,23,33,7211,7211,7188,7188
Placer,29,2022-07-09,759,763,762,1,5184,5211,5203,8,87,3,3,8,646,646,643,643
Plumas,29,2022-07-09,67,67,67,0,257,258,257,1,3,0,0,0,13,13,13,13
Riverside,29,2022-07-09,7867,7909,7900,9,43764,43997,43949,48,192,10,10,14,6437,6437,6427,6427
Sacramento,29,2022-07-09,3783,3802,3798,4,30320,30480,30444,36,189,24,24,23,3174,3174,3150,3150
San Benito,29,2022-07-09,205,205,205,0,1440,1447,1446,1,0,0,0,0,95,95,95,95
San Bernardino,29,2022-07-09,7384,7423,7417,6,47870,48124,48082,42,164,12,12,26,7934,7934,7922,7922
San Diego,29,2022-07-09,11814,11876,11872,4,74231,74623,74596,27,307,9,9,53,5394,5394,5385,5385
San Francisco,29,2022-07-09,2801,2815,2808,7,23892,24018,23960,58,104,12,12,27,947,947,935,935
San Joaquin,29,2022-07-09,1880,1891,1889,2,16513,16601,16580,21,54,5,5,6,2276,2276,2271,2271
San Luis Obispo,29,2022-07-09,692,695,694,1,4678,4702,4697,5,27,2,2,1,503,503,501,501
San Mateo,29,2022-07-09,2577,2592,2590,2,21654,21769,21751,18,32,3,3,11,724,724,721,721
Santa Barbara,29,2022-07-09,1192,1199,1198,1,8286,8329,8320,9,39,3,3,9,708,708,705,705
Santa Clara,29,2022-07-09,6967,7004,7001,3,52341,52618,52598,20,200,11,11,46,2391,2391,2380,2380
Santa Cruz,29,2022-07-09,879,883,882,1,7890,7931,7923,8,20,0,0,0,267,267,267,267
Shasta,29,2022-07-09,302,302,302,0,2820,2836,2833,3,24,3,3,5,579,579,576,576
Siskiyou,29,2022-07-09,44,44,44,0,332,333,332,1,1,1,1,1,86,86,85,85
Solano,29,2022-07-09,1393,1399,1397,2,9826,9878,9867,11,48,1,1,6,452,452,451,451
Sonoma,29,2022-07-09,1220,1228,1227,1,8856,8904,8895,9,34,1,1,5,506,506,505,505
Stanislaus,29,2022-07-09,1328,1336,1334,2,7853,7895,7882,13,102,6,6,14,1719,1719,1713,1713
Sutter,29,2022-07-09,250,250,250,0,1594,1601,1599,2,0,0,0,0,227,227,227,227
Tehama,29,2022-07-09,132,132,132,0,766,770,769,1,7,1,1,0,206,206,205,205
Trinity,29,2022-07-09,32,32,32,0,108,109,108,1,0,0,0,0,20,20,20,20
Tulare,29,2022-07-09,1220,1227,1225,2,7576,7615,7602,13,41,5,5,3,1514,1514,1509,1509
Tuolumne,29,2022-07-09,213,213,213,0,1101,1106,1104,2,4,0,0,0,193,193,193,193
Ventura,29,2022-07-09,2187,2198,2196,2,17141,17232,17219,13,76,4,4,1,1518,1518,1514,1514
Yolo,29,2022-07-09,459,459,459,0,4625,4649,4644,5,5,2,2,2,329,329,327,327
Yuba,29,2022-07-09,182,182,182,0,1261,1267,1266,1,6,0,0,2,120,120,120,120
Alameda,30,2022-07-16,5083,5114,5110,4,43357,43620,43590,30,134,7,7,26,1949,1949,1942,1942
Amador,30,2022-07-16,86,86,86,0,1254,1262,1261,1,3,0,0,1,88,88,88,88
Butte,30,2022-07-16,396,397,397,0,2901,2918,2916,2,26,1,1,3,450,450,449,449
Calaveras,30,2022-07-16,81,81,81,0,550,554,553,1,0,0,0,0,129,129,129,129
Colusa,30,2022-07-16,17,17,17,0,355,358,357,1,2,0,0,0,22,22,22,22
Contra Costa,30,2022-07-16,3104,3124,3120,4,22933,23071,23044,27,82,4,4,17,1376,1376,1372,1372
Del Norte,30,2022-07-16,177,177,177,0,683,688,687,1,6,0,0,0,53,53,53,53
El Dorado,30,2022-07-16,336,336,336,0,2686,2701,2698,3,6,2,2,1,225,225,223,223
Fresno,30,2022-07-16,3616,3637,3633,4,20998,21126,21103,23,178,11,11,16,2811,2811,2800,2800
Glenn,30,2022-07-16,35,35,35,0,260,262,261,1,0,0,0,0,42,42,42,42
Humboldt,30,2022-07-16,283,283,283,0,2008,2021,2019,2,8,0,0,4,152,152,152,152
Imperial,30,2022-07-16,1050,1055,1054,1,4653,4682,4677,5,17,3,3,0,951,951,948,948
Inyo,30,2022-07-16,29,29,29,0,329,332,331,1,0,1,1,0,57,57,56,56
Kern,30,2022-07-16,2318,2332,2330,2,15928,16024,16011,13,73,7,7,17,2373,2373,2366,2366
Kings,30,2022-07-16,744,749,748,1,4188,4215,4211,4,12,0,0,0,452,452,452,452
Lake,30,2022-07-16,117,117,117,0,936,941,940,1,0,0,0,0,142,142,142,142
Lassen,30,2022-07-16,65,65,65,0,969,974,973,1,1,0,0,0,63,63,63,63
Los Angeles,30,2022-07-16,41491,41744,41733,11,348949,351075,350980,95,1157,92,94,125,32508,32510,32416,32416
Madera,30,2022-07-16,525,528,527,1,3836,3860,3856,4,16,0,0,2,368,368,368,368
Marin,30,2022-07-16,532,535,534,1,5476,5510,5504,6,16,1,1,5,305,305,304,304
Mariposa,30,2022-07-16,45,45,45,0,256,257,256,1,0,1,1,0,29,29,28,28
Mendocino,30,2022-07-16,181,181,181,0,1455,1463,1461,2,3,0,0,3,133,133,133,133
Merced,30,2022-07-16,732,737,736,1,3868,3891,3888,3,19,4,4,2,841,841,837,837
Modoc,30,2022-07-16,11,11,11,0,36,37,36,1,1,0,0,0,8,8,8,8
Mono,30,2022-07-16,9,9,9,0,78,79,78,1,0,0,0,0,7,7,7,7
Monterey,30,2022-07-16,986,993,991,2,7145,7189,7177,12,45,6,6,6,754,754,748,748
Napa,30,2022-07-16,323,323,323,0,3125,3144,3142,2,9,0,0,0,148,148,148,148
Nevada,30,2022-07-16,168,168,168,0,1359,1365,1364,1,9,0,0,1,131,131,131,131
Orange,30,2022-07-16,9011,9067,9061,6,59697,60061,60023,38,242,22,22,42,7233,7233,7211,7211
Placer,30,2022-07-16,713,718,717,1,5399,5431,5424,7,85,1,1,7,647,647,646,646
Plumas,30,2022-07-16,61,61,61,0,252,253,252,1,1,0,0,0,13,13,13,13
Riverside,30,2022-07-16,8492,8544,8537,7,47831,48122,48081,41,214,13,13,13,6450,6450,6437,6437
Sacramento,30,2022-07-16,3586,3608,3605,3,30110,30294,30266,28,171,13,13,27,3187,3187,3174,3174
San Benito,30,2022-07-16,210,210,210,0,1612,1623,1622,1,0,0,0,0,95,95,95,95
San Bernardino,30,2022-07-16,7938,7985,7979,6,53276,53600,53563,37,203,14,14,27,7948,7948,7934,7934
San Diego,30,2022-07-16,13168,13247,13243,4,80491,80982,80959,23,366,10,10,47,5404,5404,5394,5394
San Francisco,30,2022-07-16,2577,2592,2587,5,24859,25010,24963,47,108,10,10,23,957,957,947,947
San Joaquin,30,2022-07-16,2046,2058,2056,2,17818,17927,17909,18,64,5,5,14,2281,2281,2276,2276
San Luis Obispo,30,2022-07-16,588,592,592,0,4637,4665,4661,4,13,4,4,2,507,507,503,503
San Mateo,30,2022-07-16,2366,2380,2378,2,22801,22940,22925,15,44,1,1,2,725,725,724,724
Santa Barbara,30,2022-07-16,1277,1284,1283,1,9244,9300,9292,8,46,3,3,4,711,711,708,708
Santa Clara,30,2022-07-16,6318,6357,6355,2,53506,53831,53815,16,214,11,11,27,2402,2402,2391,2391
Santa Cruz,30,2022-07-16,872,878,877,1,7688,7734,7728,6,18,1,1,3,268,268,267,267
Shasta,30,2022-07-16,338,338,338,0,3180,3199,3196,3,35,2,2,5,581,581,579,579
Siskiyou,30,2022-07-16,43,43,43,0,314,315,314,1,2,1,1,0,87,87,86,86
Solano,30,2022-07-16,1291,1297,1296,1,9616,9674,9666,8,47,1,1,6,453,453,452,452
Sonoma,30,2022-07-16,1061,1067,1066,1,8826,8881,8874,7,39,0,0,3,506,506,506,506
Stanislaus,30,2022-07-16,1404,1412,1410,2,8093,8143,8132,11,108,5,5,7,1724,1724,1719,1719
Sutter,30,2022-07-16,255,255,255,0,1677,1687,1686,1,0,0,0,0,227,227,227,227
Tehama,30,2022-07-16,121,121,121,0,902,907,906,1,6,1,1,1,207,207,206,206
Trinity,30,2022-07-16,21,21,21,0,108,109,108,1,1,0,0,0,20,20,20,20
Tulare,30,2022-07-16,1218,1225,1223,2,8411,8463,8451,12,42,1,1,1,1515,1515,1514,1514
Tuolumne,30,2022-07-16,256,256,256,0,1167,1173,1172,1,6,0,0,0,193,193,193,193
Ventura,30,2022-07-16,2374,2387,2386,1,18808,18924,18913,11,80,3,3,8,1521,1521,1518,1518
Yolo,30,2022-07-16,437,437,437,0,4619,4647,4643,4,0,2,2,0,331,331,329,329
Yuba,30,2022-07-16,211,211,211,0,1266,1272,1271,1,13,0,0,1,120,120,120,120
Alameda,31,2022-07-23,4483,4515,4513,2,41375,41671,41649,22,126,11,11,21,1960,1960,1949,1949
Amador,31,2022-07-23,75,75,75,0,1320,1330,1329,1,2,0,0,1,88,88,88,88
Butte,31,2022-07-23,330,330,330,0,2945,2965,2964,1,28,0,0,1,450,450,450,450
Calaveras,31,2022-07-23,76,76,76,0,554,560,559,1,0,2,2,1,131,131,129,129
Colusa,31,2022-07-23,26,26,26,0,363,367,366,1,2,0,0,0,22,22,22,22
Contra Costa,31,2022-07-23,2867,2887,2884,3,22524,22684,22664,20,83,4,4,16,1380,1380,1376,1376
Del Norte,31,2022-07-23,83,83,83,0,584,589,588,1,6,0,0,1,53,53,53,53
El Dorado,31,2022-07-23,276,276,276,0,2486,2504,2502,2,9,1,1,0,226,226,225,225
Fresno,31,2022-07-23,3437,3462,3459,3,20606,20753,20735,18,195,4,4,30,2815,2815,2811,2811
Glenn,31,2022-07-23,35,35,35,0,271,273,272,1,1,0,0,0,42,42,42,42
Humboldt,31,2022-07-23,256,256,256,0,2016,2030,2029,1,12,2,2,4,154,154,152,152
Imperial,31,2022-07-23,928,935,934,1,4404,4435,4432,3,20,1,1,1,952,952,951,951
Inyo,31,2022-07-23,24,24,24,0,313,316,315,1,0,0,0,0,57,57,57,57
Kern,31,2022-07-23,2020,2034,2033,1,15712,15824,15814,10,86,4,4,16,2377,2377,2373,2373
Kings,31,2022-07-23,583,588,588,0,3940,3967,3964,3,14,2,2,0,454,454,452,452
Lake,31,2022-07-23,139,139,139,0,985,992,991,1,5,0,0,1,142,142,142,142
Lassen,31,2022-07-23,52,52,52,0,1109,1117,1116,1,0,0,0,0,63,63,63,63
Los Angeles,31,2022-07-23,38163,38437,38429,8,337897,340311,340239,72,1093,126,133,114,32634,32643,32508,32510
Madera,31,2022-07-23,528,533,533,0,3798,3825,3822,3,8,0,0,4,368,368,368,368
Marin,31,2022-07-23,474,477,477,0,5571,5611,5606,5,19,2,2,3,307,307,305,305
Mariposa,31,2022-07-23,43,43,43,0,232,233,232,1,0,0,0,0,29,29,29,29
Mendocino,31,2022-07-23,173,173,173,0,1365,1376,1374,2,4,0,0,3,133,133,133,133
Merced,31,2022-07-23,722,729,729,0,3872,3900,3897,3,17,1,1,1,842,842,841,841
Modoc,31,2022-07-23,8,8,8,0,28,29,28,1,0,1,1,0,9,9,8,8
Mono,31,2022-07-23,16,16,16,0,94,95,94,1,0,0,0,0,7,7,7,7
Monterey,31,2022-07-23,954,961,960,1,7132,7183,7173,10,36,2,2,3,756,756,754,754
Napa,31,2022-07-23,297,297,297,0,2859,2880,2878,2,7,5,5,1,153,153,148,148
Nevada,31,2022-07-23,126,126,126,0,1333,1343,1342,1,4,1,1,0,132,132,131,131
Orange,31,2022-07-23,8226,8284,8280,4,58510,58930,58901,29,273,34,34,39,7267,7267,7233,7233
Placer,31,2022-07-23,581,587,586,1,5013,5048,5043,5,83,3,3,11,650,650,647,647
Plumas,31,2022-07-23,42,42,42,0,214,216,215,1,6,0,0,0,13,13,13,13
Riverside,31,2022-07-23,7754,7809,7804,5,46758,47093,47062,31,242,13,13,21,6463,6463,6450,6450
Sacramento,31,2022-07-23,3610,3637,3634,3,29811,30024,30002,22,182,12,12,29,3199,3199,3187,3187
San Benito,31,2022-07-23,209,209,209,0,1448,1459,1458,1,1,1,1,1,96,96,95,95
San Bernardino,31,2022-07-23,7250,7303,7299,4,51089,51455,51427,28,200,23,23,29,7971,7971,7948,7948
San Diego,31,2022-07-23,12274,12361,12358,3,76798,77348,77331,17,414,14,14,49,5418,5418,5404,5404
San Francisco,31,2022-07-23,2314,2330,2327,3,24677,24854,24817,37,105,10,10,22,967,967,957,957
San Joaquin,31,2022-07-23,1841,1854,1853,1,16945,17066,17052,14,74,4,4,11,2285,2285,2281,2281
San Luis Obispo,31,2022-07-23,508,512,512,0,4424,4456,4453,3,15,4,4,0,511,511,507,507
San Mateo,31,2022-07-23,2087,2103,2102,1,21919,22075,22064,11,54,1,1,9,726,726,725,725
Santa Barbara,31,2022-07-23,1236,1245,1244,1,9057,9122,9116,6,39,1,1,2,712,712,711,711
Santa Clara,31,2022-07-23,5926,5969,5968,1,51156,51522,51510,12,238,14,14,26,2416,2416,2402,2402
Santa Cruz,31,2022-07-23,878,884,883,1,7777,7833,7828,5,24,0,0,2,268,268,268,268
Shasta,31,2022-07-23,276,276,276,0,3080,3102,3100,2,38,1,1,6,582,582,581,581
Siskiyou,31,2022-07-23,56,56,56,0,357,360,359,1,1,0,0,0,87,87,87,87
Solano,31,2022-07-23,1173,1181,1180,1,9624,9693,9687,6,58,0,0,7,453,453,453,453
Sonoma,31,2022-07-23,1056,1063,1062,1,8619,8681,8675,6,42,0,0,2,506,506,506,506
Stanislaus,31,2022-07-23,1355,1365,1364,1,8089,8147,8138,9,109,8,8,12,1732,1732,1724,1724
Sutter,31,2022-07-23,229,229,229,0,1709,1722,1721,1,0,0,0,0,227,227,227,227
Tehama,31,2022-07-23,110,110,110,0,906,912,911,1,8,0,0,0,207,207,207,207
Trinity,31,2022-07-23,16,16,16,0,104,105,104,1,0,0,0,0,20,20,20,20
Tulare,31,2022-07-23,1148,1156,1155,1,8032,8090,8081,9,37,1,1,1,1516,1516,1515,1515
Tuolumne,31,2022-07-23,199,199,199,0,1166,1174,1173,1,6,0,0,0,193,193,193,193
Ventura,31,2022-07-23,2244,2259,2258,1,18561,18694,18685,9,77,5,5,9,1526,1526,1521,1521
Yolo,31,2022-07-23,425,426,426,0,4561,4594,4591,3,6,2,2,2,333,333,331,331
Yuba,31,2022-07-23,198,198,198,0,1332,1343,1342,1,13,0,0,1,120,120,120,120
Alameda,32,2022-07-30,3976,4007,4005,2,37585,37898,37882,16,148,11,11,21,1971,1971,1960,1960
Amador,32,2022-07-30,70,70,70,0,1123,1131,1130,1,4,1,1,1,89,89,88,88
Butte,32,2022-07-30,374,377,377,0,2782,2805,2804,1,36,2,2,2,452,452,450,450
Calaveras,32,2022-07-30,74,74,74,0,558,564,563,1,1,1,1,2,132,132,131,131
Colusa,32,2022-07-30,28,28,28,0,377,381,380,1,5,0,0,0,22,22,22,22
Contra Costa,32,2022-07-30,2694,2716,2714,2,21202,21379,21364,15,96,11,11,15,1391,1391,1380,1380
Del Norte,32,2022-07-30,56,56,56,0,487,493,492,1,5,0,0,1,53,53,53,53
El Dorado,32,2022-07-30,254,254,254,0,2500,2520,2519,1,5,2,2,0,228,228,226,226
Fresno,32,2022-07-30,3086,3111,3109,2,18979,19137,19124,13,218,8,8,14,2823,2823,2815,2815
Glenn,32,2022-07-30,27,27,27,0,244,246,245,1,0,0,0,0,42,42,42,42
Humboldt,32,2022-07-30,224,224,224,0,1863,1878,1877,1,10,0,0,4,154,154,154,154
Imperial,32,2022-07-30,708,714,714,0,3766,3799,3797,2,21,3,3,4,955,955,952,952
Inyo,32,2022-07-30,21,21,21,0,278,281,280,1,1,1,1,0,58,58,57,57
Kern,32,2022-07-30,1782,1796,1795,1,14616,14738,14731,7,80,5,5,12,2382,2382,2377,2377
Kings,32,2022-07-30,632,637,637,0,4006,4040,4038,2,7,0,0,1,454,454,454,454
Lake,32,2022-07-30,136,136,136,0,1041,1049,1048,1,4,1,1,1,143,143,142,142
Lassen,32,2022-07-30,50,50,50,0,911,920,919,1,1,0,0,0,63,63,63,63
Los Angeles,32,2022-07-30,31826,32090,32085,5,311140,313728,313676,52,1025,136,143,132,32770,32786,32634,32643
Madera,32,2022-07-30,496,500,500,0,3558,3588,3586,2,8,0,0,6,368,368,368,368
Marin,32,2022-07-30,451,456,456,0,5184,5228,5225,3,33,0,0,4,307,307,307,307
Mariposa,32,2022-07-30,20,20,20,0,206,207,206,1,0,0,0,0,29,29,29,29
Mendocino,32,2022-07-30,197,197,197,0,1353,1365,1364,1,4,1,1,1,134,134,133,133
Merced,32,2022-07-30,682,689,689,0,3694,3725,3723,2,22,5,5,3,847,847,842,842
Modoc,32,2022-07-30,12,12,12,0,31,32,31,1,0,0,0,0,9,9,9,9
Mono,32,2022-07-30,9,9,9,0,81,82,81,1,1,0,0,0,7,7,7,7
Monterey,32,2022-07-30,934,941,940,1,6659,6715,6708,7,39,1,1,3,757,757,756,756
Napa,32,2022-07-30,275,275,275,0,2871,2895,2894,1,9,0,0,0,153,153,153,153
Nevada,32,2022-07-30,108,108,108,0,1384,1397,1396,1,9,0,0,0,132,132,132,132
Orange,32,2022-07-30,6930,6986,6983,3,53776,54224,54203,21,277,33,33,39,7300,7300,7267,7267
Placer,32,2022-07-30,639,646,646,0,4892,4932,4928,4,84,3,3,9,653,653,650,650
Plumas,32,2022-07-30,19,19,19,0,175,176,175,1,0,0,0,0,13,13,13,13
Riverside,32,2022-07-30,6482,6537,6534,3,42651,43007,42985,22,205,9,9,24,6472,6472,6463,6463
Sacramento,32,2022-07-30,3217,3243,3241,2,28343,28579,28563,16,156,19,19,28,3218,3218,3199,3199
San Benito,32,2022-07-30,156,156,156,0,725,731,730,1,0,2,2,0,98,98,96,96
San Bernardino,32,2022-07-30,6444,6498,6495,3,48721,49128,49107,21,208,26,26,23,7997,7997,7971,7971
San Diego,32,2022-07-30,10014,10098,10096,2,70608,71194,71182,12,385,20,20,52,5438,5438,5418,5418
San Francisco,32,2022-07-30,1894,1911,1909,2,22134,22318,22292,26,107,12,12,23,979,979,967,967
San Joaquin,32,2022-07-30,1755,1768,1767,1,15706,15836,15826,10,78,5,5,13,2290,2290,2285,2285
San Luis Obispo,32,2022-07-30,563,568,568,0,4092,4126,4124,2,12,3,3,0,514,514,511,511
San Mateo,32,2022-07-30,1845,1860,1859,1,20574,20745,20737,8,64,0,0,4,726,726,726,726
Santa Barbara,32,2022-07-30,1112,1121,1120,1,7876,7942,7938,4,29,3,3,2,715,715,712,712
Santa Clara,32,2022-07-30,5124,5167,5166,1,45933,46315,46306,9,222,13,13,37,2429,2429,2416,2416
Santa Cruz,32,2022-07-30,737,743,743,0,7109,7168,7165,3,18,1,1,0,269,269,268,268
Shasta,32,2022-07-30,273,274,274,0,3013,3037,3035,2,41,1,1,8,583,583,582,582
Siskiyou,32,2022-07-30,41,41,41,0,299,301,300,1,1,0,0,0,87,87,87,87
Solano,32,2022-07-30,1163,1173,1172,1,9164,9240,9235,5,47,0,0,5,453,453,453,453
Sonoma,32,2022-07-30,966,974,974,0,8401,8471,8467,4,40,4,4,5,510,510,506,506
Stanislaus,32,2022-07-30,1286,1297,1296,1,7813,7877,7871,6,109,8,8,11,1740,1740,1732,1732
Sutter,32,2022-07-30,234,234,234,0,1643,1657,1656,1,0,2,2,0,229,229,227,227
Tehama,32,2022-07-30,99,99,99,0,795,801,800,1,2,2,2,0,209,209,207,207
Trinity,32,2022-07-30,10,10,10,0,80,81,80,1,0,0,0,0,20,20,20,20
Tulare,32,2022-07-30,1054,1062,1061,1,7550,7613,7607,6,42,1,1,2,1517,1517,1516,1516
Tuolumne,32,2022-07-30,157,157,157,0,1082,1093,1092,1,6,0,0,0,193,193,193,193
Ventura,32,2022-07-30,1906,1921,1920,1,17024,17165,17159,6,71,7,7,7,1533,1533,1526,1526
Yolo,32,2022-07-30,351,353,353,0,4130,4164,4162,2,4,2,2,1,335,335,333,333
Yuba,32,2022-07-30,155,155,155,0,1209,1220,1219,1,3,0,0,2,120,120,120,120
Alameda,33,2022-08-06,3541,3575,3574,1,35554,35903,35891,12,119,7,7,23,1978,1978,1971,1971
Amador,33,2022-08-06,50,50,50,0,873,883,882,1,4,0,0,0,89,89,89,89
Butte,33,2022-08-06,328,330,330,0,2604,2630,2629,1,29,1,1,1,453,453,452,452
Calaveras,33,2022-08-06,59,59,59,0,566,572,571,1,1,1,1,0,133,133,132,132
Colusa,33,2022-08-06,18,18,18,0,351,355,354,1,2,0,0,0,22,22,22,22
Contra Costa,33,2022-08-06,2287,2309,2308,1,20112,20308,20297,11,93,6,6,15,1397,1397,1391,1391
Del Norte,33,2022-08-06,48,48,48,0,484,490,489,1,4,0,0,0,53,53,53,53
El Dorado,33,2022-08-06,184,184,184,0,2319,2342,2341,1,8,1,1,0,229,229,228,228
Fresno,33,2022-08-06,2535,2559,2558,1,17377,17547,17538,9,205,4,4,24,2827,2827,2823,2823
Glenn,33,2022-08-06,27,27,27,0,249,251,250,1,2,0,0,0,42,42,42,42
Humboldt,33,2022-08-06,200,200,200,0,1981,2001,2000,1,10,1,1,2,155,155,154,154
Imperial,33,2022-08-06,571,577,577,0,3326,3357,3355,2,19,2,2,3,957,957,955,955
Inyo,33,2022-08-06,14,14,14,0,263,266,265,1,0,0,0,1,58,58,58,58
Kern,33,2022-08-06,1415,1428,1427,1,14283,14421,14416,5,55,7,7,14,2389,2389,2382,2382
Kings,33,2022-08-06,488,493,493,0,3500,3534,3532,2,9,0,0,3,454,454,454,454
Lake,33,2022-08-06,108,108,108,0,928,937,936,1,2,0,0,1,143,143,143,143
Lassen,33,2022-08-06,123,124,124,0,1053,1063,1062,1,0,0,0,0,63,63,63,63
Los Angeles,33,2022-08-06,26461,26720,26717,3,289220,292046,292008,38,986,130,139,117,32900,32925,32770,32786
Madera,33,2022-08-06,400,403,403,0,3131,3161,3159,2,17,0,0,5,368,368,368,368
Marin,33,2022-08-06,374,379,379,0,4632,4678,4676,2,25,2,2,1,309,309,307,307
Mariposa,33,2022-08-06,29,29,29,0,224,225,224,1,0,0,0,0,29,29,29,29
Mendocino,33,2022-08-06,145,145,145,0,1163,1175,1174,1,2,1,1,2,135,135,134,134
Merced,33,2022-08-06,550,556,556,0,3448,3481,3480,1,15,2,2,5,849,849,847,847
Modoc,33,2022-08-06,5,5,5,0,28,29,28,1,0,0,0,0,9,9,9,9
Mono,33,2022-08-06,4,4,4,0,66,67,66,1,0,0,0,0,7,7,7,7
Monterey,33,2022-08-06,804,811,810,1,5898,5956,5951,5,44,2,2,0,759,759,757,757
Napa,33,2022-08-06,281,282,282,0,2672,2699,2698,1,6,2,2,1,155,155,153,153
Nevada,33,2022-08-06,105,105,105,0,1335,1349,1348,1,10,0,0,0,132,132,132,132
Orange,33,2022-08-06,5477,5530,5528,2,48654,49129,49114,15,236,29,29,39,7329,7329,7300,7300
Placer,33,2022-08-06,496,502,502,0,4489,4534,4531,3,63,2,2,9,655,655,653,653
Plumas,33,2022-08-06,27,27,27,0,182,183,182,1,1,0,0,0,13,13,13,13
Riverside,33,2022-08-06,5694,5750,5748,2,40298,40691,40675,16,182,9,9,16,6481,6481,6472,6472
Sacramento,33,2022-08-06,2789,2816,2815,1,26666,26927,26915,12,197,17,17,25,3235,3235,3218,3218
San Benito,33,2022-08-06,171,171,171,0,686,694,693,1,1,0,0,0,98,98,98,98
San Bernardino,33,2022-08-06,5287,5338,5336,2,44687,45123,45108,15,189,21,21,22,8018,8018,7997,7997
San Diego,33,2022-08-06,7693,7768,7767,1,64400,65029,65020,9,328,7,7,36,5445,5445,5438,5438
San Francisco,33,2022-08-06,1593,1608,1607,1,20490,20692,20673,19,90,13,13,24,992,992,979,979
San Joaquin,33,2022-08-06,1560,1574,1573,1,15786,15940,15932,8,73,7,7,8,2297,2297,2290,2290
San Luis Obispo,33,2022-08-06,557,562,562,0,3727,3764,3763,1,15,0,0,0,514,514,514,514
San Mateo,33,2022-08-06,1548,1563,1563,0,18493,18674,18668,6,60,0,0,2,726,726,726,726
Santa Barbara,33,2022-08-06,1013,1023,1023,0,7557,7632,7629,3,54,2,2,3,717,717,715,715
Santa Clara,33,2022-08-06,4219,4259,4258,1,40553,40949,40943,6,216,17,17,33,2446,2446,2429,2429
Santa Cruz,33,2022-08-06,671,679,679,0,5969,6028,6026,2,24,1,1,0,270,270,269,269
Shasta,33,2022-08-06,181,181,181,0,2898,2925,2924,1,36,1,1,4,584,584,583,583
Siskiyou,33,2022-08-06,51,51,51,0,283,286,285,1,2,1,1,0,88,88,87,87
Solano,33,2022-08-06,920,930,930,0,8051,8128,8125,3,49,0,0,9,453,453,453,453
Sonoma,33,2022-08-06,885,894,894,0,7797,7873,7870,3,41,3,3,1,513,513,510,510
Stanislaus,33,2022-08-06,1101,1112,1111,1,7242,7313,7308,5,99,7,7,10,1747,1747,1740,1740
Sutter,33,2022-08-06,234,235,235,0,1613,1629,1628,1,0,1,1,0,230,230,229,229
Tehama,33,2022-08-06,74,74,74,0,680,687,686,1,5,0,0,0,209,209,209,209
Trinity,33,2022-08-06,5,5,5,0,68,69,68,1,0,0,0,0,20,20,20,20
Tulare,33,2022-08-06,924,933,932,1,7411,7482,7477,5,37,3,3,3,1520,1520,1517,1517
Tuolumne,33,2022-08-06,135,135,135,0,1127,1139,1138,1,3,0,0,0,193,193,193,193
Ventura,33,2022-08-06,1605,1620,1620,0,15898,16054,16050,4,69,7,7,6,1540,1540,1533,1533
Yolo,33,2022-08-06,287,288,288,0,3852,3889,3888,1,3,0,0,3,335,335,335,335
Yuba,33,2022-08-06,146,146,146,0,1118,1131,1130,1,6,0,0,1,120,120,120,120
Alameda,34,2022-08-13,2650,2680,2679,1,33745,34122,34113,9,124,9,9,19,1987,1987,1978,1978
Amador,34,2022-08-13,48,48,48,0,814,824,823,1,2,0,0,0,89,89,89,89
Butte,34,2022-08-13,290,292,292,0,2364,2392,2391,1,20,0,0,1,453,453,453,453
Calaveras,34,2022-08-13,52,52,52,0,563,570,569,1,0,0,0,0,133,133,133,133
Colusa,34,2022-08-13,19,19,19,0,371,374,373,1,0,0,0,0,22,22,22,22
Contra Costa,34,2022-08-13,1956,1978,1977,1,19209,19424,19416,8,64,7,7,11,1404,1404,1397,1397
Del Norte,34,2022-08-13,58,58,58,0,500,507,506,1,4,1,1,1,54,54,53,53
El Dorado,34,2022-08-13,190,190,190,0,2266,2292,2291,1,4,0,0,3,229,229,229,229
Fresno,34,2022-08-13,2005,2028,2027,1,16777,16965,16958,7,162,8,8,16,2835,2835,2827,2827
Glenn,34,2022-08-13,14,14,14,0,241,243,242,1,2,0,0,0,42,42,42,42
Humboldt,34,2022-08-13,187,187,187,0,1635,1653,1652,1,17,0,0,2,155,155,155,155
Imperial,34,2022-08-13,384,390,390,0,3121,3157,3156,1,15,1,1,2,958,958,957,957
Inyo,34,2022-08-13,4,4,4,0,248,251,250,1,0,1,1,0,59,59,58,58
Kern,34,2022-08-13,1233,1247,1247,0,13352,13502,13498,4,65,5,5,13,2394,2394,2389,2389
Kings,34,2022-08-13,389,394,394,0,3258,3295,3294,1,10,0,0,1,454,454,454,454
Lake,34,2022-08-13,92,92,92,0,960,972,971,1,4,0,0,2,143,143,143,143
Lassen,34,2022-08-13,122,123,123,0,1008,1020,1019,1,1,0,0,0,63,63,63,63
Los Angeles,34,2022-08-13,21842,22086,22084,2,286013,289213,289184,29,911,100,107,115,33000,33032,32900,32925
Madera,34,2022-08-13,325,329,329,0,3033,3066,3065,1,10,0,0,4,368,368,368,368
Marin,34,2022-08-13,311,315,315,0,4071,4117,4115,2,18,0,0,0,309,309,309,309
Mariposa,34,2022-08-13,13,13,13,0,196,197,196,1,0,0,0,0,29,29,29,29
Mendocino,34,2022-08-13,96,96,96,0,1032,1044,1043,1,7,0,0,1,135,135,135,135
Merced,34,2022-08-13,443,448,448,0,3380,3419,3418,1,10,2,2,4,851,851,849,849
Modoc,34,2022-08-13,3,3,3,0,17,18,17,1,0,0,0,0,9,9,9,9
Mono,34,2022-08-13,8,8,8,0,80,81,80,1,0,0,0,0,7,7,7,7
Monterey,34,2022-08-13,657,664,664,0,5729,5793,5789,4,35,0,0,0,759,759,759,759
Napa,34,2022-08-13,223,223,223,0,2376,2404,2403,1,12,0,0,0,155,155,155,155
Nevada,34,2022-08-13,95,95,95,0,1218,1233,1232,1,5,0,0,0,132,132,132,132
Orange,34,2022-08-13,4758,4811,4810,1,44144,44639,44628,11,261,29,31,38,7358,7360,7329,7329
Placer,34,2022-08-13,440,447,447,0,4462,4512,4510,2,61,2,2,12,657,657,655,655
Plumas,34,2022-08-13,16,16,16,0,177,178,177,1,0,0,0,0,13,13,13,13
Riverside,34,2022-08-13,4754,4806,4804,2,37444,37863,37851,12,141,11,11,16,6492,6492,6481,6481
Sacramento,34,2022-08-13,2339,2366,2365,1,25583,25869,25860,9,160,11,11,17,3246,3246,3235,3235
San Benito,34,2022-08-13,147,147,147,0,686,694,693,1,1,1,1,1,99,99,98,98
San Bernardino,34,2022-08-13,4632,4684,4683,1,43221,43703,43692,11,133,17,17,23,8035,8035,8018,8018
San Diego,34,2022-08-13,5971,6038,6037,1,60139,60812,60806,6,284,12,12,32,5457,5457,5445,5445
San Francisco,34,2022-08-13,1324,1339,1338,1,19342,19559,19545,14,103,15,15,14,1007,1007,992,992
San Joaquin,34,2022-08-13,1435,1450,1449,1,15004,15171,15165,6,54,6,6,7,2303,2303,2297,2297
San Luis Obispo,34,2022-08-13,365,370,370,0,3395,3432,3431,1,12,4,4,2,518,518,514,514
San Mateo,34,2022-08-13,1266,1279,1279,0,16968,17158,17154,4,52,0,0,5,726,726,726,726
Santa Barbara,34,2022-08-13,865,874,874,0,7266,7347,7345,2,40,0,0,6,717,717,717,717
Santa Clara,34,2022-08-13,3608,3649,3649,0,38602,39033,39029,4,203,7,7,24,2453,2453,2446,2446
Santa Cruz,34,2022-08-13,527,534,534,0,5968,6034,6032,2,22,0,0,1,270,270,270,270
Shasta,34,2022-08-13,185,186,186,0,2789,2821,2820,1,20,1,1,0,585,585,584,584
Siskiyou,34,2022-08-13,31,31,31,0,297,302,301,1,1,0,0,3,88,88,88,88
Solano,34,2022-08-13,682,691,691,0,7396,7478,7476,2,46,0,0,6,453,453,453,453
Sonoma,34,2022-08-13,644,651,651,0,7342,7424,7422,2,39,2,2,2,515,515,513,513
Stanislaus,34,2022-08-13,943,954,954,0,7458,7542,7538,4,94,6,6,12,1753,1753,1747,1747
Sutter,34,2022-08-13,202,202,202,0,1563,1581,1580,1,0,1,1,0,231,231,230,230
Tehama,34,2022-08-13,61,61,61,0,625,632,631,1,2,0,0,0,209,209,209,209
Trinity,34,2022-08-13,8,8,8,0,62,63,62,1,0,0,0,0,20,20,20,20
Tulare,34,2022-08-13,724,733,733,0,7016,7094,7090,4,26,4,4,4,1524,1524,1520,1520
Tuolumne,34,2022-08-13,99,99,99,0,1000,1013,1012,1,1,0,0,0,193,193,193,193
Ventura,34,2022-08-13,1416,1433,1433,0,15022,15190,15187,3,67,4,4,7,1544,1544,1540,1540
Yolo,34,2022-08-13,268,270,270,0,3739,3780,3779,1,3,0,0,1,335,335,335,335
Yuba,34,2022-08-13,131,131,131,0,1090,1104,1103,1,6,0,0,0,120,120,120,120
Alameda,35,2022-08-20,2303,2333,2333,0,32350,32759,32753,6,104,10,10,21,1997,1997,1987,1987
Amador,35,2022-08-20,52,52,52,0,851,863,862,1,1,1,1,0,90,90,89,89
Butte,35,2022-08-20,217,219,219,0,2115,2142,2141,1,17,0,0,3,453,453,453,453
Calaveras,35,2022-08-20,40,40,40,0,538,546,545,1,2,0,0,0,133,133,133,133
Colusa,35,2022-08-20,9,9,9,0,381,386,385,1,0,0,0,0,22,22,22,22
Contra Costa,35,2022-08-20,1532,1552,1551,1,18620,18855,18849,6,44,5,5,14,1409,1409,1404,1404
Del Norte,35,2022-08-20,33,33,33,0,489,496,495,1,3,1,1,0,55,55,54,54
El Dorado,35,2022-08-20,141,141,141,0,2251,2279,2278,1,6,0,0,2,229,229,229,229
Fresno,35,2022-08-20,1590,1611,1610,1,15879,16080,16075,5,151,4,4,26,2839,2839,2835,2835
Glenn,35,2022-08-20,20,20,20,0,213,215,214,1,1,0,0,0,42,42,42,42
Humboldt,35,2022-08-20,152,152,152,0,1701,1723,1722,1,6,1,1,3,156,156,155,155
Imperial,35,2022-08-20,297,301,301,0,2918,2954,2953,1,10,0,0,0,958,958,958,958
Inyo,35,2022-08-20,17,17,17,0,243,246,245,1,0,0,0,0,59,59,59,59
Kern,35,2022-08-20,963,975,975,0,13430,13599,13596,3,68,6,6,12,2400,2400,2394,2394
Kings,35,2022-08-20,353,359,359,0,3429,3472,3471,1,6,1,1,1,455,455,454,454
Lake,35,2022-08-20,95,95,95,0,961,975,974,1,2,1,1,0,144,144,143,143
Lassen,35,2022-08-20,53,53,53,0,845,857,856,1,0,0,0,0,63,63,63,63
Los Angeles,35,2022-08-20,18757,18994,18993,1,269933,273339,273318,21,801,110,121,102,33110,33153,33000,33032
Madera,35,2022-08-20,298,303,303,0,2705,2740,2739,1,13,2,2,4,370,370,368,368
Marin,35,2022-08-20,247,249,249,0,3950,4001,4000,1,11,0,0,4,309,309,309,309
Mariposa,35,2022-08-20,13,13,13,0,179,180,179,1,0,0,0,0,29,29,29,29
Mendocino,35,2022-08-20,103,103,103,0,1122,1136,1135,1,2,0,0,3,135,135,135,135
Merced,35,2022-08-20,459,465,465,0,3588,3633,3632,1,11,4,4,1,855,855,851,851
Modoc,35,2022-08-20,6,6,6,0,28,29,28,1,0,0,0,0,9,9,9,9
Mono,35,2022-08-20,6,6,6,0,59,60,59,1,0,0,0,0,7,7,7,7
Monterey,35,2022-08-20,581,589,589,0,5688,5759,5756,3,26,0,0,2,759,759,759,759
Napa,35,2022-08-20,149,149,149,0,2022,2048,2047,1,3,1,1,0,156,156,155,155
Nevada,35,2022-08-20,97,97,97,0,1216,1232,1231,1,4,0,0,2,132,132,132,132
Orange,35,2022-08-20,3918,3968,3967,1,40492,41003,40995,8,200,20,20,36,7378,7380,7358,7360
Placer,35,2022-08-20,372,378,378,0,4352,4407,4405,2,58,1,1,15,658,658,657,657
Plumas,35,2022-08-20,17,17,17,0,175,177,176,1,0,0,0,0,13,13,13,13
Riverside,35,2022-08-20,4369,4425,4424,1,37019,37486,37477,9,153,6,6,18,6498,6498,6492,6492
Sacramento,35,2022-08-20,2223,2251,2250,1,24552,24862,24855,7,140,14,14,22,3260,3260,3246,3246
San Benito,35,2022-08-20,88,88,88,0,568,575,574,1,1,1,1,0,100,100,99,99
San Bernardino,35,2022-08-20,4631,4690,4689,1,42728,43268,43259,9,137,12,12,18,8047,8047,8035,8035
San Diego,35,2022-08-20,4892,4955,4955,0,57064,57784,57779,5,269,7,7,32,5464,5464,5457,5457
San Francisco,35,2022-08-20,1075,1089,1088,1,18541,18774,18764,10,100,12,13,12,1019,1020,1007,1007
San Joaquin,35,2022-08-20,1253,1269,1269,0,15317,15509,15504,5,52,1,1,8,2304,2304,2303,2303
San Luis Obispo,35,2022-08-20,264,267,267,0,3148,3188,3187,1,18,1,1,0,519,519,518,518
San Mateo,35,2022-08-20,1066,1079,1079,0,16812,17024,17021,3,38,0,0,4,726,726,726,726
Santa Barbara,35,2022-08-20,735,744,744,0,7276,7367,7365,2,45,2,2,4,719,719,717,717
Santa Clara,35,2022-08-20,3075,3114,3114,0,38697,39184,39181,3,171,8,8,27,2461,2461,2453,2453
Santa Cruz,35,2022-08-20,498,504,504,0,11587,11734,11731,3,11,3,3,2,273,273,270,270
Shasta,35,2022-08-20,187,188,188,0,2783,2819,2818,1,3,2,2,0,587,587,585,585
Siskiyou,35,2022-08-20,27,27,27,0,250,254,253,1,1,0,0,0,88,88,88,88
Solano,35,2022-08-20,566,573,573,0,7193,7284,7282,2,33,0,0,10,453,453,453,453
Sonoma,35,2022-08-20,595,602,602,0,7266,7359,7357,2,39,2,2,2,517,517,515,515
Stanislaus,35,2022-08-20,911,923,923,0,7566,7661,7658,3,90,9,9,11,1762,1762,1753,1753
Sutter,35,2022-08-20,184,185,185,0,1632,1653,1652,1,0,0,0,0,231,231,231,231
Tehama,35,2022-08-20,47,47,47,0,642,650,649,1,1,0,0,0,209,209,209,209
Trinity,35,2022-08-20,10,10,10,0,59,60,59,1,0,0,0,0,20,20,20,20
Tulare,35,2022-08-20,726,735,735,0,7196,7287,7284,3,32,2,2,1,1526,1526,1524,1524
Tuolumne,35,2022-08-20,112,113,113,0,1028,1042,1041,1,1,0,0,0,193,193,193,193
Ventura,35,2022-08-20,1387,1404,1404,0,14577,14761,14759,2,60,5,5,8,1549,1549,1544,1544
Yolo,35,2022-08-20,206,207,207,0,3437,3481,3480,1,6,1,1,0,336,336,335,335
Yuba,35,2022-08-20,128,128,128,0,1082,1096,1095,1,11,0,0,3,120,120,120,120
Alameda,36,2022-08-27,2081,2112,2112,0,33620,34103,34098,5,83,10,10,39,2007,2007,1997,1997
Amador,36,2022-08-27,43,43,43,0,778,790,789,1,4,1,1,0,91,91,90,90
Butte,36,2022-08-27,229,232,232,0,2113,2145,2144,1,20,0,0,2,453,453,453,453
Calaveras,36,2022-08-27,62,62,62,0,600,609,608,1,1,0,0,0,133,133,133,133
Colusa,36,2022-08-27,16,16,16,0,378,385,384,1,1,0,0,0,22,22,22,22
Contra Costa,36,2022-08-27,1400,1420,1420,0,18794,19065,19060,5,49,4,4,7,1413,1413,1409,1409
Del Norte,36,2022-08-27,28,28,28,0,460,468,467,1,1,0,0,2,55,55,55,55
El Dorado,36,2022-08-27,152,152,152,0,2061,2092,2091,1,6,1,1,1,230,230,229,229
Fresno,36,2022-08-27,1444,1465,1465,0,15970,16199,16195,4,164,5,5,12,2844,2844,2839,2839
Glenn,36,2022-08-27,25,25,25,0,226,228,227,1,2,0,0,0,42,42,42,42
Humboldt,36,2022-08-27,122,122,122,0,1694,1718,1717,1,6,0,0,0,156,156,156,156
Imperial,36,2022-08-27,310,315,315,0,2877,2920,2919,1,0,0,0,0,958,958,958,958
Inyo,36,2022-08-27,4,4,4,0,200,203,202,1,0,0,0,0,59,59,59,59
Kern,36,2022-08-27,930,943,943,0,13463,13656,13654,2,53,3,3,7,2403,2403,2400,2400
Kings,36,2022-08-27,325,330,330,0,3597,3649,3648,1,5,0,0,0,455,455,455,455
Lake,36,2022-08-27,102,102,102,0,897,912,911,1,0,1,1,0,145,145,144,144
Lassen,36,2022-08-27,21,21,21,0,824,837,836,1,0,0,0,0,63,63,63,63
Los Angeles,36,2022-08-27,16128,16360,16359,1,269902,273777,273760,17,742,89,100,84,33199,33253,33110,33153
Madera,36,2022-08-27,286,291,291,0,2816,2857,2856,1,15,0,0,6,370,370,370,370
Marin,36,2022-08-27,223,224,224,0,3930,3987,3986,1,18,1,1,1,310,310,309,309
Mariposa,36,2022-08-27,18,18,18,0,186,188,187,1,0,0,0,0,29,29,29,29
Mendocino,36,2022-08-27,110,110,110,0,994,1010,1009,1,2,0,0,1,135,135,135,135
Merced,36,2022-08-27,379,385,385,0,3528,3578,3577,1,9,3,3,0,858,858,855,855
Modoc,36,2022-08-27,2,2,2,0,29,30,29,1,0,0,0,0,9,9,9,9
Mono,36,2022-08-27,0,0,0,0,58,59,58,1,0,0,0,0,7,7,7,7
Monterey,36,2022-08-27,442,449,449,0,5627,5707,5705,2,28,3,3,3,762,762,759,759
Napa,36,2022-08-27,114,114,114,0,2078,2109,2108,1,7,0,0,2,156,156,156,156
Nevada,36,2022-08-27,97,97,97,0,1160,1177,1176,1,8,0,0,0,132,132,132,132
Orange,36,2022-08-27,3158,3203,3203,0,39754,40325,40319,6,186,19,19,30,7397,7399,7378,7380
Placer,36,2022-08-27,388,395,395,0,4225,4286,4285,1,69,1,1,8,659,659,658,658
Plumas,36,2022-08-27,21,21,21,0,175,178,177,1,0,0,0,0,13,13,13,13
Riverside,36,2022-08-27,3929,3986,3985,1,36885,37413,37406,7,93,9,9,18,6507,6507,6498,6498
Sacramento,36,2022-08-27,1927,1955,1955,0,24532,24884,24879,5,139,11,11,23,3271,3271,3260,3260
San Benito,36,2022-08-27,131,131,131,0,677,689,688,1,1,0,0,1,100,100,100,100
San Bernardino,36,2022-08-27,3944,4001,4000,1,41398,41993,41986,7,143,14,14,14,8061,8061,8047,8047
San Diego,36,2022-08-27,4047,4105,4105,0,56651,57465,57461,4,233,7,7,26,5471,5471,5464,5464
San Francisco,36,2022-08-27,953,967,967,0,18441,18707,18699,8,60,8,8,10,1027,1028,1019,1020
San Joaquin,36,2022-08-27,1040,1053,1053,0,14300,14505,14502,3,38,2,2,11,2306,2306,2304,2304
San Luis Obispo,36,2022-08-27,321,326,326,0,3239,3285,3284,1,19,0,0,0,519,519,519,519
San Mateo,36,2022-08-27,846,858,858,0,16433,16669,16667,2,25,0,0,1,726,726,726,726
Santa Barbara,36,2022-08-27,633,642,642,0,7569,7677,7675,2,23,0,0,3,719,719,719,719
Santa Clara,36,2022-08-27,2456,2491,2491,0,38437,38988,38985,3,116,5,5,21,2466,2466,2461,2461
Santa Cruz,36,2022-08-27,412,418,418,0,12019,12192,12190,2,15,0,0,0,273,273,273,273
Shasta,36,2022-08-27,145,146,146,0,2706,2745,2744,1,19,0,0,1,587,587,587,587
Siskiyou,36,2022-08-27,22,22,22,0,253,258,257,1,0,2,2,0,90,90,88,88
Solano,36,2022-08-27,537,544,544,0,7322,7428,7427,1,40,0,0,9,453,453,453,453
Sonoma,36,2022-08-27,514,521,521,0,7135,7238,7237,1,35,0,0,3,517,517,517,517
Stanislaus,36,2022-08-27,867,879,879,0,8095,8211,8209,2,69,5,5,6,1767,1767,1762,1762
Sutter,36,2022-08-27,188,188,188,0,1648,1673,1672,1,0,0,0,0,231,231,231,231
Tehama,36,2022-08-27,55,55,55,0,724,736,735,1,3,0,0,0,209,209,209,209
Trinity,36,2022-08-27,7,7,7,0,61,62,61,1,0,0,0,0,20,20,20,20
Tulare,36,2022-08-27,698,709,709,0,7316,7420,7418,2,37,1,1,2,1527,1527,1526,1526
Tuolumne,36,2022-08-27,103,103,103,0,880,894,893,1,2,0,0,0,193,193,193,193
Ventura,36,2022-08-27,1063,1076,1076,0,14416,14624,14622,2,44,3,3,4,1552,1552,1549,1549
Yolo,36,2022-08-27,202,204,204,0,3679,3732,3731,1,3,0,0,2,336,336,336,336
Yuba,36,2022-08-27,134,134,134,0,1152,1169,1168,1,12,0,0,2,120,120,120,120
Alameda,37,2022-09-03,1665,1692,1692,0,32713,33255,33251,4,75,6,6,36,2013,2013,2007,2007
Amador,37,2022-09-03,48,48,48,0,830,844,843,1,4,0,0,1,91,91,91,91
Butte,37,2022-09-03,232,236,236,0,2399,2441,2440,1,16,1,1,1,454,454,453,453
Calaveras,37,2022-09-03,31,31,31,0,529,537,536,1,1,0,0,0,133,133,133,133
Colusa,37,2022-09-03,10,10,10,0,271,275,274,1,2,0,0,0,22,22,22,22
Contra Costa,37,2022-09-03,1091,1110,1110,0,17811,18106,18102,4,54,4,4,12,1417,1417,1413,1413
Del Norte,37,2022-09-03,13,13,13,0,368,374,373,1,3,0,0,1,55,55,55,55
El Dorado,37,2022-09-03,103,103,103,0,1844,1874,1873,1,4,0,0,0,230,230,230,230
Fresno,37,2022-09-03,1264,1285,1285,0,14971,15220,15217,3,174,7,7,9,2851,2851,2844,2844
Glenn,37,2022-09-03,14,14,14,0,206,208,207,1,2,0,0,0,42,42,42,42
Humboldt,37,2022-09-03,128,128,128,0,1515,1542,1541,1,9,0,0,1,156,156,156,156
Imperial,37,2022-09-03,261,266,266,0,2909,2958,2957,1,12,0,0,0,958,958,958,958
Inyo,37,2022-09-03,11,11,11,0,162,165,164,1,0,0,0,0,59,59,59,59
Kern,37,2022-09-03,784,796,796,0,12883,13095,13093,2,47,3,3,6,2406,2406,2403,2403
Kings,37,2022-09-03,289,294,294,0,3263,3316,3315,1,5,0,0,0,455,455,455,455
Lake,37,2022-09-03,66,66,66,0,782,796,795,1,2,2,2,0,147,147,145,145
Lassen,37,2022-09-03,31,31,31,0,749,763,762,1,0,0,0,0,63,63,63,63
Los Angeles,37,2022-09-03,12529,12736,12735,1,256992,261243,261231,12,649,81,96,101,33280,33349,33199,33253
Madera,37,2022-09-03,259,265,265,0,3100,3152,3151,1,12,0,0,5,370,370,370,370
Marin,37,2022-09-03,200,205,205,0,3781,3845,3844,1,12,0,0,2,310,310,310,310
Mariposa,37,2022-09-03,16,16,16,0,196,201,200,1,0,0,0,0,29,29,29,29
Mendocino,37,2022-09-03,57,57,57,0,965,982,981,1,2,1,1,1,136,136,135,135
Merced,37,2022-09-03,309,314,314,0,3214,3269,3268,1,8,2,2,1,860,860,858,858
Modoc,37,2022-09-03,3,3,3,0,22,23,22,1,0,0,0,0,9,9,9,9
Mono,37,2022-09-03,4,4,4,0,51,52,51,1,0,0,0,0,7,7,7,7
Monterey,37,2022-09-03,290,295,295,0,5098,5183,5181,2,18,1,1,1,763,763,762,762
Napa,37,2022-09-03,127,127,127,0,2120,2156,2155,1,5,1,1,2,157,157,156,156
Nevada,37,2022-09-03,98,98,98,0,1169,1190,1189,1,4,0,0,0,132,132,132,132
Orange,37,2022-09-03,2492,2532,2532,0,36799,37408,37404,4,167,16,19,36,7413,7418,7397,7399
Placer,37,2022-09-03,250,256,256,0,3949,4015,4014,1,42,0,0,9,659,659,659,659
Plumas,37,2022-09-03,9,9,9,0,157,161,160,1,0,0,0,0,13,13,13,13
Riverside,37,2022-09-03,2943,2991,2991,0,33571,34125,34120,5,100,9,9,8,6516,6516,6507,6507
Sacramento,37,2022-09-03,1475,1499,1499,0,22545,22918,22914,4,128,10,11,25,3281,3282,3271,3271
San Benito,37,2022-09-03,81,81,81,0,626,637,636,1,0,0,0,1,100,100,100,100
San Bernardino,37,2022-09-03,2859,2906,2906,0,38440,39076,39071,5,119,2,2,20,8063,8063,8061,8061
San Diego,37,2022-09-03,3390,3446,3446,0,55333,56250,56247,3,217,12,13,25,5483,5484,5471,5471
San Francisco,37,2022-09-03,763,775,775,0,17628,17922,17916,6,58,10,11,10,1037,1039,1027,1028
San Joaquin,37,2022-09-03,929,946,946,0,13427,13649,13647,2,45,6,6,10,2312,2312,2306,2306
San Luis Obispo,37,2022-09-03,200,203,203,0,2992,3043,3042,1,10,4,4,0,523,523,519,519
San Mateo,37,2022-09-03,735,747,747,0,15595,15854,15852,2,20,0,0,2,726,726,726,726
Santa Barbara,37,2022-09-03,550,558,558,0,7391,7513,7512,1,37,2,2,2,721,721,719,719
Santa Clara,37,2022-09-03,2124,2159,2159,0,37145,37760,37758,2,127,10,10,20,2476,2476,2466,2466
Santa Cruz,37,2022-09-03,353,359,359,0,13793,14021,14019,2,13,0,0,1,273,273,273,273
Shasta,37,2022-09-03,122,122,122,0,2456,2496,2495,1,16,1,1,0,588,588,587,587
Siskiyou,37,2022-09-03,32,32,32,0,245,251,250,1,0,0,0,0,90,90,90,90
Solano,37,2022-09-03,464,471,471,0,7219,7338,7337,1,42,1,1,8,454,454,453,453
Sonoma,37,2022-09-03,443,450,450,0,7185,7305,7304,1,33,0,0,3,517,517,517,517
Stanislaus,37,2022-09-03,665,676,676,0,7573,7697,7695,2,70,7,7,5,1774,1774,1767,1767
Sutter,37,2022-09-03,132,132,132,0,1604,1631,1630,1,0,0,0,0,231,231,231,231
Tehama,37,2022-09-03,64,64,64,0,742,756,755,1,4,0,0,0,209,209,209,209
Trinity,37,2022-09-03,5,5,5,0,56,57,56,1,0,0,0,0,20,20,20,20
Tulare,37,2022-09-03,516,524,524,0,6556,6663,6661,2,32,1,1,1,1528,1528,1527,1527
Tuolumne,37,2022-09-03,61,61,61,0,840,854,853,1,2,0,0,0,193,193,193,193
Ventura,37,2022-09-03,937,951,951,0,13452,13676,13675,1,63,7,7,3,1559,1559,1552,1552
Yolo,37,2022-09-03,186,188,188,0,3250,3305,3304,1,7,2,2,1,338,338,336,336
Yuba,37,2022-09-03,104,104,104,0,1141,1160,1159,1,12,0,0,2,120,120,120,120
Alameda,38,2022-09-10,1453,1483,1483,0,27790,28345,28342,3,88,1,1,21,2014,2014,2013,2013
Amador,38,2022-09-10,31,31,31,0,760,776,775,1,4,0,0,1,91,91,91,91
Butte,38,2022-09-10,174,177,177,0,2241,2286,2285,1,19,0,0,0,454,454,454,454
Calaveras,38,2022-09-10,12,12,12,0,446,455,454,1,0,0,0,0,133,133,133,133
Colusa,38,2022-09-10,15,15,15,0,290,296,295,1,2,0,0,0,22,22,22,22
Contra Costa,38,2022-09-10,905,924,924,0,15540,15850,15848,2,45,6,7,7,1423,1424,1417,1417
Del Norte,38,2022-09-10,27,27,27,0,510,522,521,1,3,0,0,1,55,55,55,55
El Dorado,38,2022-09-10,99,99,99,0,1701,1735,1734,1,2,0,0,0,230,230,230,230
Fresno,38,2022-09-10,888,904,904,0,13307,13572,13570,2,150,6,7,12,2857,2858,2851,2851
Glenn,38,2022-09-10,11,11,11,0,186,189,188,1,2,0,0,0,42,42,42,42
Humboldt,38,2022-09-10,98,98,98,0,1415,1445,1444,1,9,1,1,5,157,157,156,156
Imperial,38,2022-09-10,239,245,245,0,2935,2994,2993,1,12,0,0,0,958,958,958,958
Inyo,38,2022-09-10,15,15,15,0,191,195,194,1,0,0,0,0,59,59,59,59
Kern,38,2022-09-10,623,635,635,0,11230,11453,11452,1,44,3,3,11,2409,2409,2406,2406
Kings,38,2022-09-10,203,207,207,0,2751,2806,2805,1,5,1,1,0,456,456,455,455
Lake,38,2022-09-10,42,42,42,0,759,774,773,1,4,0,0,0,147,147,147,147
Lassen,38,2022-09-10,16,16,16,0,781,798,797,1,0,0,0,0,63,63,63,63
Los Angeles,38,2022-09-10,9959,10157,10157,0,241163,245964,245955,9,616,88,110,91,33368,33459,33280,33349
Madera,38,2022-09-10,225,229,229,0,2684,2738,2737,1,10,0,0,3,370,370,370,370
Marin,38,2022-09-10,158,161,161,0,3582,3654,3653,1,11,2,3,1,312,313,310,310
Mariposa,38,2022-09-10,13,13,13,0,191,196,195,1,0,0,0,0,29,29,29,29
Mendocino,38,2022-09-10,55,55,55,0,879,897,896,1,4,0,0,1,136,136,136,136
Merced,38,2022-09-10,229,233,233,0,2800,2858,2857,1,10,3,3,0,863,863,860,860
Modoc,38,2022-09-10,2,2,2,0,19,20,19,1,0,0,0,0,9,9,9,9
Mono,38,2022-09-10,5,5,5,0,62,63,62,1,0,0,0,0,7,7,7,7
Monterey,38,2022-09-10,215,220,220,0,4402,4489,4488,1,24,2,2,0,765,765,763,763
Napa,38,2022-09-10,103,104,104,0,1835,1874,1873,1,7,0,0,0,157,157,157,157
Nevada,38,2022-09-10,58,58,58,0,1004,1025,1024,1,3,0,0,0,132,132,132,132
Orange,38,2022-09-10,1952,1991,1991,0,32479,33126,33123,3,152,18,22,24,7431,7440,7413,7418
Placer,38,2022-09-10,235,241,241,0,3653,3724,3723,1,43,0,0,6,659,659,659,659
Plumas,38,2022-09-10,15,15,15,0,148,152,151,1,0,0,0,0,13,13,13,13
Riverside,38,2022-09-10,2101,2145,2145,0,28116,28678,28675,3,111,5,6,8,6521,6522,6516,6516
Sacramento,38,2022-09-10,1189,1213,1213,0,20319,20724,20721,3,124,11,14,23,3292,3296,3281,3282
San Benito,38,2022-09-10,85,85,85,0,513,524,523,1,2,0,0,1,100,100,100,100
San Bernardino,38,2022-09-10,1754,1788,1788,0,32541,33189,33186,3,103,2,2,22,8065,8065,8063,8063
San Diego,38,2022-09-10,2740,2795,2795,0,48985,49961,49959,2,188,2,2,24,5485,5486,5483,5484
San Francisco,38,2022-09-10,712,727,727,0,15009,15309,15305,4,64,5,6,11,1042,1045,1037,1039
San Joaquin,38,2022-09-10,654,667,667,0,12334,12578,12576,2,33,3,3,11,2315,2315,2312,2312
San Luis Obispo,38,2022-09-10,155,157,157,0,2810,2867,2866,1,8,1,1,0,524,524,523,523
San Mateo,38,2022-09-10,575,586,586,0,12160,12404,12403,1,23,0,0,1,726,726,726,726
Santa Barbara,38,2022-09-10,353,361,361,0,6715,6848,6847,1,26,1,1,2,722,722,721,721
Santa Clara,38,2022-09-10,1729,1764,1764,0,32822,33474,33473,1,136,4,4,28,2480,2480,2476,2476
Santa Cruz,38,2022-09-10,261,266,266,0,10386,10595,10594,1,12,0,0,1,273,273,273,273
Shasta,38,2022-09-10,153,155,155,0,2236,2281,2280,1,22,0,0,2,588,588,588,588
Siskiyou,38,2022-09-10,32,32,32,0,269,275,274,1,1,0,0,0,90,90,90,90
Solano,38,2022-09-10,338,344,344,0,5678,5793,5792,1,27,1,1,6,455,455,454,454
Sonoma,38,2022-09-10,346,352,352,0,5993,6112,6111,1,36,2,2,2,519,519,517,517
Stanislaus,38,2022-09-10,435,444,444,0,6799,6934,6933,1,70,1,1,2,1775,1775,1774,1774
Sutter,38,2022-09-10,110,111,111,0,1431,1461,1460,1,0,0,0,0,231,231,231,231
Tehama,38,2022-09-10,45,45,45,0,589,602,601,1,4,0,0,0,209,209,209,209
Trinity,38,2022-09-10,2,2,2,0,56,57,56,1,0,0,0,0,20,20,20,20
Tulare,38,2022-09-10,353,361,361,0,5958,6077,6076,1,41,0,0,0,1528,1528,1528,1528
Tuolumne,38,2022-09-10,63,63,63,0,747,763,762,1,2,0,0,1,193,193,193,193
Ventura,38,2022-09-10,776,791,791,0,12897,13155,13154,1,48,2,2,4,1561,1561,1559,1559
Yolo,38,2022-09-10,123,124,124,0,2504,2555,2554,1,5,1,1,0,339,339,338,338
Yuba,38,2022-09-10,89,89,89,0,1028,1050,1049,1,6,0,0,0,120,120,120,120
Alameda,39,2022-09-17,1289,1322,1322,0,28639,29362,29360,2,81,6,8,12,2020,2022,2014,2014
Amador,39,2022-09-17,35,35,35,0,813,834,833,1,2,1,1,0,92,92,91,91
Butte,39,2022-09-17,137,139,139,0,2196,2251,2250,1,19,0,0,1,454,454,454,454
Calaveras,39,2022-09-17,23,23,23,0,486,500,499,1,0,0,0,0,133,133,133,133
Colusa,39,2022-09-17,10,10,10,0,311,320,319,1,2,0,0,0,22,22,22,22
Contra Costa,39,2022-09-17,844,864,864,0,16568,16988,16986,2,58,2,2,8,1425,1426,1423,1424
Del Norte,39,2022-09-17,21,21,21,0,502,516,515,1,1,0,0,1,55,55,55,55
El Dorado,39,2022-09-17,79,79,79,0,1660,1702,1701,1,2,0,0,0,230,230,230,230
Fresno,39,2022-09-17,640,656,656,0,13590,13933,13931,2,116,6,8,15,2863,2866,2857,2858
Glenn,39,2022-09-17,11,11,11,0,200,206,205,1,2,0,0,0,42,42,42,42
Humboldt,39,2022-09-17,107,108,108,0,1563,1603,1602,1,10,0,0,2,157,157,157,157
Imperial,39,2022-09-17,171,176,176,0,2943,3017,3016,1,12,0,0,1,958,958,958,958
Inyo,39,2022-09-17,7,7,7,0,171,177,176,1,0,0,0,0,59,59,59,59
Kern,39,2022-09-17,482,494,494,0,11789,12085,12084,1,40,5,6,8,2414,2415,2409,2409
Kings,39,2022-09-17,156,159,159,0,2711,2781,2780,1,6,1,1,0,457,457,456,456
Lake,39,2022-09-17,45,45,45,0,883,907,906,1,0,0,0,0,147,147,147,147
Lassen,39,2022-09-17,9,9,9,0,736,755,754,1,0,0,0,0,63,63,63,63
Los Angeles,39,2022-09-17,8639,8858,8858,0,250263,256561,256554,7,514,42,59,87,33410,33518,33368,33459
Madera,39,2022-09-17,124,126,126,0,2772,2842,2841,1,14,0,0,2,370,370,370,370
Marin,39,2022-09-17,149,153,153,0,3711,3806,3805,1,8,0,0,0,312,313,312,313
Mariposa,39,2022-09-17,11,11,11,0,171,177,176,1,0,0,0,0,29,29,29,29
Mendocino,39,2022-09-17,41,41,41,0,938,963,962,1,1,0,0,2,136,136,136,136
Merced,39,2022-09-17,170,175,175,0,2828,2898,2897,1,7,0,0,1,863,863,863,863
Modoc,39,2022-09-17,1,1,1,0,17,18,17,1,0,0,0,0,9,9,9,9
Mono,39,2022-09-17,8,8,8,0,69,70,69,1,0,0,0,0,7,7,7,7
Monterey,39,2022-09-17,166,170,170,0,4359,4469,4468,1,12,0,0,2,765,765,765,765
Napa,39,2022-09-17,104,105,105,0,1842,1890,1889,1,6,0,0,1,157,157,157,157
Nevada,39,2022-09-17,55,55,55,0,1076,1103,1102,1,2,0,0,0,132,132,132,132
Orange,39,2022-09-17,1701,1744,1744,0,33550,34397,34395,2,128,14,19,22,7445,7459,7431,7440
Placer,39,2022-09-17,205,211,211,0,3940,4039,4038,1,56,1,1,4,660,660,659,659
Plumas,39,2022-09-17,22,22,22,0,194,200,199,1,0,0,0,0,13,13,13,13
Riverside,39,2022-09-17,1453,1489,1489,0,28555,29274,29271,3,85,4,5,10,6525,6527,6521,6522
Sacramento,39,2022-09-17,1047,1074,1074,0,21526,22071,22069,2,108,5,7,17,3297,3303,3292,3296
San Benito,39,2022-09-17,57,57,57,0,550,564,563,1,0,0,0,0,100,100,100,100
San Bernardino,39,2022-09-17,1562,1602,1602,0,31745,32543,32541,2,88,4,5,26,8069,8070,8065,8065
San Diego,39,2022-09-17,2642,2709,2709,0,54624,56006,56004,2,173,8,11,23,5493,5497,5485,5486
San Francisco,39,2022-09-17,669,685,685,0,16146,16557,16554,3,48,3,3,8,1045,1048,1042,1045
San Joaquin,39,2022-09-17,487,499,499,0,12799,13122,13121,1,37,3,4,3,2318,2319,2315,2315
San Luis Obispo,39,2022-09-17,157,162,162,0,2879,2953,2952,1,8,0,0,1,524,524,524,524
San Mateo,39,2022-09-17,590,605,605,0,13164,13496,13495,1,16,0,0,1,726,726,726,726
Santa Barbara,39,2022-09-17,242,248,248,0,6856,7030,7029,1,27,2,3,0,724,725,722,722
Santa Clara,39,2022-09-17,1539,1578,1578,0,35418,36313,36312,1,142,1,1,19,2481,2481,2480,2480
Santa Cruz,39,2022-09-17,153,158,158,0,11879,12178,12177,1,4,0,0,1,273,273,273,273
Shasta,39,2022-09-17,103,105,105,0,2135,2190,2189,1,18,1,1,4,589,589,588,588
Siskiyou,39,2022-09-17,19,19,19,0,235,242,241,1,1,1,1,0,91,91,90,90
Solano,39,2022-09-17,309,317,317,0,6187,6343,6342,1,17,0,0,3,455,455,455,455
Sonoma,39,2022-09-17,307,314,314,0,6359,6521,6520,1,25,1,1,2,520,520,519,519
Stanislaus,39,2022-09-17,359,368,368,0,6585,6750,6749,1,58,2,2,9,1777,1777,1775,1775
Sutter,39,2022-09-17,95,95,95,0,1436,1472,1471,1,0,0,0,0,231,231,231,231
Tehama,39,2022-09-17,39,39,39,0,558,574,573,1,2,0,0,0,209,209,209,209
Trinity,39,2022-09-17,3,3,3,0,62,63,62,1,0,0,0,0,20,20,20,20
Tulare,39,2022-09-17,229,236,236,0,5933,6080,6079,1,36,0,0,1,1528,1528,1528,1528
Tuolumne,39,2022-09-17,57,57,57,0,745,764,763,1,0,0,0,0,193,193,193,193
Ventura,39,2022-09-17,644,661,661,0,13142,13475,13474,1,47,2,2,5,1563,1563,1561,1561
Yolo,39,2022-09-17,94,95,95,0,3567,3656,3655,1,1,0,0,2,339,339,339,339
Yuba,39,2022-09-17,65,65,65,0,1067,1096,1095,1,4,0,0,0,120,120,120,120
Alameda,40,2022-09-24,1088,1126,1126,0,27549,28518,28516,2,77,2,4,8,2022,2026,2020,2022
Amador,40,2022-09-24,28,28,28,0,715,741,740,1,2,1,2,0,93,94,92,92
Butte,40,2022-09-24,81,82,82,0,1800,1862,1861,1,23,0,0,2,454,454,454,454
Calaveras,40,2022-09-24,23,23,23,0,379,394,393,1,3,0,0,1,133,133,133,133
Colusa,40,2022-09-24,10,10,10,0,291,302,301,1,2,0,0,0,22,22,22,22
Contra Costa,40,2022-09-24,743,770,770,0,16436,17016,17014,2,43,0,0,7,1425,1426,1425,1426
Del Norte,40,2022-09-24,20,20,20,0,477,495,494,1,1,0,0,1,55,55,55,55
El Dorado,40,2022-09-24,76,77,77,0,1490,1544,1543,1,4,0,0,0,230,230,230,230
Fresno,40,2022-09-24,504,522,522,0,11853,12267,12266,1,95,0,0,11,2863,2866,2863,2866
Glenn,40,2022-09-24,15,15,15,0,181,189,188,1,2,0,0,0,42,42,42,42
Humboldt,40,2022-09-24,91,94,94,0,1318,1366,1365,1,9,1,2,1,158,159,157,157
Imperial,40,2022-09-24,118,123,123,0,2659,2753,2752,1,5,0,0,0,958,958,958,958
Inyo,40,2022-09-24,4,4,4,0,171,178,177,1,0,0,0,0,59,59,59,59
Kern,40,2022-09-24,343,355,355,0,10926,11307,11306,1,32,0,0,7,2414,2415,2414,2415
Kings,40,2022-09-24,101,105,105,0,2525,2615,2614,1,4,1,2,0,458,459,457,457
Lake,40,2022-09-24,23,23,23,0,799,828,827,1,0,0,0,0,147,147,147,147
Lassen,40,2022-09-24,15,15,15,0,572,591,590,1,0,0,0,0,63,63,63,63
Los Angeles,40,2022-09-24,7336,7593,7593,0,239313,247666,247660,6,427,31,56,62,33441,33574,33410,33518
Madera,40,2022-09-24,91,94,94,0,2169,2245,2244,1,10,0,0,2,370,370,370,370
Marin,40,2022-09-24,148,154,154,0,3567,3695,3694,1,9,0,0,0,312,313,312,313
Mariposa,40,2022-09-24,3,3,3,0,157,163,162,1,0,0,0,0,29,29,29,29
Mendocino,40,2022-09-24,29,29,29,0,850,880,879,1,2,0,0,0,136,136,136,136
Merced,40,2022-09-24,121,126,126,0,2754,2852,2851,1,10,2,4,2,865,867,863,863
Modoc,40,2022-09-24,1,1,1,0,15,16,15,1,0,0,0,0,9,9,9,9
Mono,40,2022-09-24,1,1,1,0,67,68,67,1,0,0,0,0,7,7,7,7
Monterey,40,2022-09-24,137,142,142,0,4026,4166,4165,1,17,1,2,2,766,767,765,765
Napa,40,2022-09-24,74,75,75,0,1872,1939,1938,1,0,0,0,2,157,157,157,157
Nevada,40,2022-09-24,46,46,46,0,1100,1139,1138,1,3,0,0,0,132,132,132,132
Orange,40,2022-09-24,1635,1692,1692,0,31145,32236,32234,2,107,5,10,23,7450,7469,7445,7459
Placer,40,2022-09-24,198,205,205,0,3464,3587,3586,1,47,0,0,5,660,660,660,660
Plumas,40,2022-09-24,20,20,20,0,153,159,158,1,1,0,0,0,13,13,13,13
Riverside,40,2022-09-24,1248,1291,1291,0,25333,26219,26217,2,53,5,11,15,6530,6538,6525,6527
Sacramento,40,2022-09-24,932,965,965,0,19010,19677,19675,2,116,8,16,16,3305,3319,3297,3303
San Benito,40,2022-09-24,40,40,40,0,474,491,490,1,1,0,0,1,100,100,100,100
San Bernardino,40,2022-09-24,1196,1238,1238,0,26652,27580,27578,2,67,3,6,17,8072,8076,8069,8070
San Diego,40,2022-09-24,2394,2479,2479,0,51966,53782,53781,1,176,4,8,26,5497,5505,5493,5497
San Francisco,40,2022-09-24,631,653,653,0,15645,16199,16196,3,43,0,0,6,1045,1048,1045,1048
San Joaquin,40,2022-09-24,387,400,400,0,10852,11232,11231,1,30,0,0,4,2318,2319,2318,2319
San Luis Obispo,40,2022-09-24,105,110,110,0,2508,2598,2597,1,7,0,0,0,524,524,524,524
San Mateo,40,2022-09-24,548,568,568,0,12836,13286,13285,1,29,0,0,1,726,726,726,726
Santa Barbara,40,2022-09-24,246,254,254,0,6365,6590,6589,1,20,1,2,0,725,727,724,725
Santa Clara,40,2022-09-24,1327,1374,1374,0,35312,36544,36543,1,119,3,5,19,2484,2486,2481,2481
Santa Cruz,40,2022-09-24,191,199,199,0,12914,13365,13364,1,12,0,0,1,273,273,273,273
Shasta,40,2022-09-24,80,82,82,0,1830,1894,1893,1,19,0,0,4,589,589,589,589
Siskiyou,40,2022-09-24,16,16,16,0,191,199,198,1,2,1,2,0,92,93,91,91
Solano,40,2022-09-24,278,287,287,0,5579,5776,5775,1,23,1,2,1,456,457,455,455
Sonoma,40,2022-09-24,295,305,305,0,6266,6488,6487,1,24,0,0,2,520,520,520,520
Stanislaus,40,2022-09-24,251,259,259,0,5792,5994,5993,1,43,0,0,6,1777,1777,1777,1777
Sutter,40,2022-09-24,67,67,67,0,1133,1175,1174,1,0,0,0,0,231,231,231,231
Tehama,40,2022-09-24,29,29,29,0,545,566,565,1,0,0,0,0,209,209,209,209
Trinity,40,2022-09-24,3,3,3,0,40,41,40,1,0,0,0,0,20,20,20,20
Tulare,40,2022-09-24,170,177,177,0,5168,5347,5346,1,17,0,0,2,1528,1528,1528,1528
Tuolumne,40,2022-09-24,41,41,41,0,669,694,693,1,1,0,0,0,193,193,193,193
Ventura,40,2022-09-24,525,543,543,0,11568,11973,11972,1,29,2,4,1,1565,1567,1563,1563
Yolo,40,2022-09-24,106,110,110,0,3889,4024,4023,1,0,0,0,2,339,339,339,339
Yuba,40,2022-09-24,45,45,45,0,912,945,944,1,5,0,0,0,120,120,120,120
Alameda,41,2022-10-01,977,1040,1040,0,25975,27660,27659,1,46,0,0,7,2022,2026,2022,2026
Amador,41,2022-10-01,13,13,13,0,682,726,725,1,0,0,0,0,93,94,93,94
Butte,41,2022-10-01,62,65,65,0,1765,1881,1880,1,9,0,0,3,454,454,454,454
Calaveras,41,2022-10-01,19,19,19,0,355,379,378,1,1,0,0,0,133,133,133,133
Colusa,41,2022-10-01,6,6,6,0,274,291,290,1,0,0,0,0,22,22,22,22
Contra Costa,41,2022-10-01,664,707,707,0,15195,16184,16183,1,36,0,0,8,1425,1426,1425,1426
Del Norte,41,2022-10-01,14,14,14,0,388,413,412,1,1,0,0,0,55,55,55,55
El Dorado,41,2022-10-01,63,67,67,0,1443,1537,1536,1,4,0,0,1,230,230,230,230
Fresno,41,2022-10-01,468,499,499,0,11044,11752,11751,1,77,0,0,9,2863,2866,2863,2866
Glenn,41,2022-10-01,2,2,2,0,159,168,167,1,0,0,0,0,42,42,42,42
Humboldt,41,2022-10-01,61,66,66,0,1167,1242,1241,1,6,1,3,0,159,162,158,159
Imperial,41,2022-10-01,114,121,121,0,2468,2627,2626,1,6,0,0,0,958,958,958,958
Inyo,41,2022-10-01,7,7,7,0,140,149,148,1,0,0,0,1,59,59,59,59
Kern,41,2022-10-01,243,258,258,0,9447,10044,10043,1,29,0,0,7,2414,2415,2414,2415
Kings,41,2022-10-01,93,99,99,0,2362,2514,2513,1,4,0,0,0,458,459,458,459
Lake,41,2022-10-01,30,31,31,0,784,835,834,1,1,0,0,0,147,147,147,147
Lassen,41,2022-10-01,6,6,6,0,582,620,619,1,0,0,0,0,63,63,63,63
Los Angeles,41,2022-10-01,5955,6331,6331,0,195857,208022,208018,4,431,19,71,58,33460,33645,33441,33574
Madera,41,2022-10-01,63,66,66,0,1644,1751,1750,1,8,0,0,3,370,370,370,370
Marin,41,2022-10-01,150,160,160,0,3523,3753,3752,1,5,0,0,2,312,313,312,313
Mariposa,41,2022-10-01,7,7,7,0,137,146,145,1,0,0,0,0,29,29,29,29
Mendocino,41,2022-10-01,37,39,39,0,787,840,839,1,2,0,0,0,136,136,136,136
Merced,41,2022-10-01,90,97,97,0,2718,2892,2891,1,6,0,0,0,865,867,865,867
Modoc,41,2022-10-01,2,2,2,0,9,10,9,1,0,0,0,0,9,9,9,9
Mono,41,2022-10-01,2,2,2,0,57,61,60,1,0,0,0,0,7,7,7,7
Monterey,41,2022-10-01,91,97,97,0,3720,3957,3956,1,7,0,0,1,766,767,766,767
Napa,41,2022-10-01,95,101,101,0,1711,1822,1821,1,4,0,0,3,157,157,157,157
Nevada,41,2022-10-01,52,56,56,0,966,1029,1028,1,1,0,0,4,132,132,132,132
Orange,41,2022-10-01,1377,1465,1465,0,26057,27695,27694,1,124,2,7,21,7452,7476,7450,7469
Placer,41,2022-10-01,165,175,175,0,3126,3328,3327,1,38,0,0,4,660,660,660,660
Plumas,41,2022-10-01,14,14,14,0,119,127,126,1,2,0,0,0,13,13,13,13
Riverside,41,2022-10-01,876,930,930,0,19609,20835,20834,1,57,3,13,8,6533,6551,6530,6538
Sacramento,41,2022-10-01,775,825,825,0,17539,18671,18670,1,92,2,7,16,3307,3326,3305,3319
San Benito,41,2022-10-01,34,35,35,0,463,493,492,1,0,0,0,0,100,100,100,100
San Bernardino,41,2022-10-01,936,994,994,0,21184,22502,22501,1,65,1,5,12,8073,8081,8072,8076
San Diego,41,2022-10-01,2128,2265,2265,0,44664,47512,47511,1,148,1,3,16,5498,5508,5497,5505
San Francisco,41,2022-10-01,576,613,613,0,14648,15612,15610,2,40,0,0,8,1045,1048,1045,1048
San Joaquin,41,2022-10-01,308,326,326,0,9423,10021,10020,1,26,0,0,4,2318,2319,2318,2319
San Luis Obispo,41,2022-10-01,134,143,143,0,2350,2501,2500,1,2,0,0,2,524,524,524,524
San Mateo,41,2022-10-01,498,529,529,0,11877,12645,12644,1,24,0,0,0,726,726,726,726
Santa Barbara,41,2022-10-01,216,230,230,0,6189,6589,6588,1,12,0,0,1,725,727,725,727
Santa Clara,41,2022-10-01,1251,1332,1332,0,31738,33760,33759,1,103,1,3,17,2485,2489,2484,2486
Santa Cruz,41,2022-10-01,196,209,209,0,10960,11659,11658,1,11,0,0,1,273,273,273,273
Shasta,41,2022-10-01,44,46,46,0,1435,1525,1524,1,13,0,0,2,589,589,589,589
Siskiyou,41,2022-10-01,10,10,10,0,188,203,202,1,1,0,0,0,92,93,92,93
Solano,41,2022-10-01,255,272,272,0,5258,5598,5597,1,21,0,0,2,456,457,456,457
Sonoma,41,2022-10-01,292,311,311,0,6045,6440,6439,1,19,0,0,1,520,520,520,520
Stanislaus,41,2022-10-01,195,208,208,0,5282,5618,5617,1,37,0,0,3,1777,1777,1777,1777
Sutter,41,2022-10-01,65,68,68,0,1127,1200,1199,1,0,0,0,0,231,231,231,231
Tehama,41,2022-10-01,24,24,24,0,474,506,505,1,0,0,0,1,209,209,209,209
Trinity,41,2022-10-01,0,0,0,0,46,49,48,1,0,0,0,0,20,20,20,20
Tulare,41,2022-10-01,154,164,164,0,4734,5032,5031,1,14,0,0,2,1528,1528,1528,1528
Tuolumne,41,2022-10-01,20,20,20,0,664,707,706,1,1,0,0,0,193,193,193,193
Ventura,41,2022-10-01,412,439,439,0,9843,10475,10474,1,28,0,0,2,1565,1567,1565,1567
Yolo,41,2022-10-01,131,139,139,0,3186,3382,3381,1,5,0,0,1,339,339,339,339
Yuba,41,2022-10-01,29,29,29,0,824,877,876,1,5,0,0,0,120,120,120,120
Alameda,42,2022-10-03,136,155,155,0,2589,2952,2951,1,54,0,0,5,2022,2026,2022,2026
Amador,42,2022-10-03,3,3,3,0,77,89,88,1,0,0,0,1,93,94,93,94
Butte,42,2022-10-03,6,6,6,0,182,208,207,1,11,0,0,2,454,454,454,454
Calaveras,42,2022-10-03,1,1,1,0,53,62,61,1,1,0,0,0,133,133,133,133
Colusa,42,2022-10-03,0,0,0,0,10,12,11,1,0,0,0,0,22,22,22,22
Contra Costa,42,2022-10-03,78,88,88,0,1830,2087,2086,1,34,0,0,6,1425,1426,1425,1426
Del Norte,42,2022-10-03,3,3,3,0,33,39,38,1,1,0,0,1,55,55,55,55
El Dorado,42,2022-10-03,6,7,7,0,139,160,159,1,3,0,0,1,230,230,230,230
Fresno,42,2022-10-03,48,55,55,0,1135,1293,1292,1,77,0,0,11,2863,2866,2863,2866
Glenn,42,2022-10-03,0,0,0,0,9,11,10,1,0,0,0,0,42,42,42,42
Humboldt,42,2022-10-03,2,2,2,0,160,183,182,1,6,0,0,1,159,162,159,162
Imperial,42,2022-10-03,7,8,8,0,227,261,260,1,6,0,0,0,958,958,958,958
Inyo,42,2022-10-03,0,0,0,0,31,37,36,1,0,0,0,1,59,59,59,59
Kern,42,2022-10-03,18,20,20,0,489,560,559,1,24,0,0,5,2414,2415,2414,2415
Kings,42,2022-10-03,10,11,11,0,199,228,227,1,2,0,0,0,458,459,458,459
Lake,42,2022-10-03,5,5,5,0,122,141,140,1,3,0,0,0,147,147,147,147
Lassen,42,2022-10-03,2,2,2,0,23,27,26,1,2,0,0,0,63,63,63,63
Los Angeles,42,2022-10-03,251,283,283,0,1169,1324,1323,1,439,2,18,69,33462,33663,33460,33645
Madera,42,2022-10-03,3,3,3,0,125,144,143,1,6,0,0,2,370,370,370,370
Marin,42,2022-10-03,39,45,45,0,366,418,417,1,6,0,0,2,312,313,312,313
Mariposa,42,2022-10-03,0,0,0,0,15,18,17,1,0,0,0,0,29,29,29,29
Mendocino,42,2022-10-03,5,5,5,0,122,140,139,1,4,0,0,0,136,136,136,136
Merced,42,2022-10-03,4,4,4,0,182,208,207,1,5,0,0,1,865,867,865,867
Modoc,42,2022-10-03,0,0,0,0,2,3,2,1,0,0,0,0,9,9,9,9
Mono,42,2022-10-03,2,2,2,0,17,20,19,1,0,0,0,0,7,7,7,7
Monterey,42,2022-10-03,16,18,18,0,427,489,488,1,11,0,0,1,766,767,766,767
Napa,42,2022-10-03,5,6,6,0,212,244,243,1,4,0,0,2,157,157,157,157
Nevada,42,2022-10-03,0,0,0,0,48,55,54,1,1,0,0,4,132,132,132,132
Orange,42,2022-10-03,147,167,167,0,2305,2630,2629,1,131,0,0,16,7452,7476,7452,7476
Placer,42,2022-10-03,16,18,18,0,422,480,479,1,41,0,0,3,660,660,660,660
Plumas,42,2022-10-03,5,6,6,0,24,29,28,1,1,0,0,0,13,13,13,13
Riverside,42,2022-10-03,73,83,83,0,1334,1517,1516,1,59,1,9,12,6534,6560,6533,6551
Sacramento,42,2022-10-03,88,100,100,0,1579,1801,1800,1,88,0,0,19,3307,3326,3307,3326
San Benito,42,2022-10-03,3,3,3,0,49,57,56,1,0,0,0,0,100,100,100,100
San Bernardino,42,2022-10-03,72,82,82,0,1157,1315,1314,1,77,0,0,7,8073,8081,8073,8081
San Diego,42,2022-10-03,132,150,150,0,4066,4627,4626,1,162,0,0,18,5498,5508,5498,5508
San Francisco,42,2022-10-03,70,80,80,0,1532,1746,1745,1,44,0,0,9,1045,1048,1045,1048
San Joaquin,42,2022-10-03,57,65,65,0,945,1080,1079,1,25,0,0,3,2318,2319,2318,2319
San Luis Obispo,42,2022-10-03,10,11,11,0,163,186,185,1,2,0,0,1,524,524,524,524
San Mateo,42,2022-10-03,70,80,80,0,1384,1581,1580,1,22,0,0,2,726,726,726,726
Santa Barbara,42,2022-10-03,28,32,32,0,586,666,665,1,15,0,0,2,725,727,725,727
Santa Clara,42,2022-10-03,202,230,230,0,3171,3613,3612,1,109,0,0,20,2485,2489,2485,2489
Santa Cruz,42,2022-10-03,7,8,8,0,212,241,240,1,10,0,0,1,273,273,273,273
Shasta,42,2022-10-03,0,0,0,0,23,27,26,1,10,0,0,2,589,589,589,589
Siskiyou,42,2022-10-03,1,1,1,0,33,38,37,1,0,0,0,0,92,93,92,93
Solano,42,2022-10-03,43,50,50,0,679,779,778,1,17,0,0,2,456,457,456,457
Sonoma,42,2022-10-03,41,47,47,0,674,772,771,1,17,0,0,3,520,520,520,520
Stanislaus,42,2022-10-03,35,40,40,0,683,780,779,1,49,0,0,6,1777,1777,1777,1777
Sutter,42,2022-10-03,7,8,8,0,123,141,140,1,0,0,0,0,231,231,231,231
Tehama,42,2022-10-03,1,1,1,0,12,15,14,1,1,0,0,0,209,209,209,209
Trinity,42,2022-10-03,0,0,0,0,5,6,5,1,0,0,0,0,20,20,20,20
Tulare,42,2022-10-03,16,18,18,0,236,270,269,1,19,0,0,1,1528,1528,1528,1528
Tuolumne,42,2022-10-03,4,4,4,0,70,81,80,1,0,0,0,0,193,193,193,193
Ventura,42,2022-10-03,39,44,44,0,965,1103,1102,1,41,0,0,2,1565,1567,1565,1567
Yolo,42,2022-10-03,10,12,12,0,190,218,217,1,3,2,18,2,341,357,339,339
Yuba,42,2022-10-03,9,10,10,0,106,121,120,1,4,0,0,1,120,120,120,120
