county,time,date,cases,est_cases,est_omicron_cases,est_other_cases,tests,est_tests,est_omicron_tests,est_other_tests,hospitalizations
Alameda,1,2021-12-25,5404,5416,2688,2728,83120,83310,40976,42334,86
Amador,1,2021-12-25,75,75,27,48,1474,1477,527,950,4
Butte,1,2021-12-25,348,348,188,160,3809,3819,2032,1787,31
Calaveras,1,2021-12-25,72,72,29,43,965,966,380,586,2
Colusa,1,2021-12-25,15,15,6,9,239,239,97,142,2
Contra Costa,1,2021-12-25,3257,3263,1252,2011,43045,43143,16362,26781,49
Del Norte,1,2021-12-25,20,20,9,11,1225,1226,524,702,0
El Dorado,1,2021-12-25,386,386,151,235,4121,4131,1583,2548,11
Fresno,1,2021-12-25,1524,1528,559,969,22559,22611,8169,14442,152
Glenn,1,2021-12-25,37,37,15,22,412,412,170,242,0
Humboldt,1,2021-12-25,334,334,140,194,3141,3149,1279,1870,10
Imperial,1,2021-12-25,659,659,254,405,5418,5432,2088,3344,51
Inyo,1,2021-12-25,81,81,39,42,419,419,196,223,0
Kern,1,2021-12-25,1205,1206,498,708,19629,19674,8043,11631,98
Kings,1,2021-12-25,352,352,131,221,5355,5367,1958,3409,20
Lake,1,2021-12-25,43,43,15,28,1144,1147,399,748,0
Lassen,1,2021-12-25,19,19,9,10,2322,2329,1068,1261,0
Los Angeles,1,2021-12-25,66451,66602,48296,18306,660095,661601,477586,184015,904
Madera,1,2021-12-25,209,209,78,131,4152,4162,1508,2654,12
Marin,1,2021-12-25,1160,1161,459,702,14382,14413,5674,8739,4
Mariposa,1,2021-12-25,31,31,11,20,504,504,183,321,0
Mendocino,1,2021-12-25,86,86,25,61,2497,2501,714,1787,6
Merced,1,2021-12-25,428,428,172,256,4860,4871,1939,2932,2
Modoc,1,2021-12-25,5,5,2,3,57,57,24,33,2
Mono,1,2021-12-25,93,93,30,63,356,356,111,245,1
Monterey,1,2021-12-25,723,723,197,526,12220,12247,3273,8974,35
Napa,1,2021-12-25,559,559,237,322,5566,5579,2341,3238,5
Nevada,1,2021-12-25,205,205,72,133,2513,2518,871,1647,6
Orange,1,2021-12-25,10833,10857,4600,6257,106595,106838,44776,62062,256
Placer,1,2021-12-25,912,912,312,600,10314,10337,3471,6866,82
Plumas,1,2021-12-25,11,11,4,7,395,395,140,255,0
Riverside,1,2021-12-25,9348,9369,3379,5990,76506,76682,27285,49397,357
Sacramento,1,2021-12-25,3386,3394,1417,1977,47935,48045,19831,28214,158
San Benito,1,2021-12-25,204,204,96,108,2097,2101,978,1123,5
San Bernardino,1,2021-12-25,8906,8927,4392,4535,79722,79904,38888,41016,421
San Diego,1,2021-12-25,17481,17521,12218,5303,156996,157353,109223,48130,355
San Francisco,1,2021-12-25,5599,5611,1808,3803,62129,62271,19932,42339,34
San Joaquin,1,2021-12-25,1556,1561,616,945,20818,20866,8112,12754,74
San Luis Obispo,1,2021-12-25,718,718,326,392,10144,10168,4570,5598,22
San Mateo,1,2021-12-25,3548,3556,1866,1690,50458,50573,26283,24290,18
Santa Barbara,1,2021-12-25,1417,1420,594,826,13837,13868,5710,8158,37
Santa Clara,1,2021-12-25,6164,6178,4280,1898,97868,98092,67444,30648,114
Santa Cruz,1,2021-12-25,654,654,315,339,11583,11610,5508,6102,14
Shasta,1,2021-12-25,198,198,71,127,4589,4598,1617,2981,37
Siskiyou,1,2021-12-25,15,15,7,8,344,344,161,183,0
Solano,1,2021-12-25,837,838,355,483,15109,15144,6369,8775,29
Sonoma,1,2021-12-25,1327,1329,561,768,18925,18968,7899,11069,16
Stanislaus,1,2021-12-25,880,880,278,602,10380,10404,3227,7177,104
Sutter,1,2021-12-25,177,177,70,107,2013,2017,787,1230,0
Tehama,1,2021-12-25,64,64,19,45,1046,1049,302,747,11
Trinity,1,2021-12-25,3,3,1,2,96,96,32,64,0
Tulare,1,2021-12-25,561,561,172,389,10434,10458,3135,7323,47
Tuolumne,1,2021-12-25,133,133,49,84,1743,1747,631,1116,5
Ventura,1,2021-12-25,3580,3587,1911,1676,34020,34098,17970,16128,74
Yolo,1,2021-12-25,544,544,258,286,20050,20096,9399,10697,7
Yuba,1,2021-12-25,116,116,49,67,1501,1505,623,882,11
Alameda,2,2022-01-01,13858,13891,7887,6004,102081,102326,57915,44411,150
Amador,2,2022-01-01,148,148,64,84,1850,1854,797,1057,7
Butte,2,2022-01-01,900,900,548,352,5681,5693,3447,2246,30
Calaveras,2,2022-01-01,170,170,80,90,1148,1150,538,612,3
Colusa,2,2022-01-01,53,53,26,27,299,299,144,155,4
Contra Costa,2,2022-01-01,11118,11145,5052,6093,59685,59828,27022,32806,85
Del Norte,2,2022-01-01,61,61,31,30,1963,1968,982,986,0
El Dorado,2,2022-01-01,1002,1004,462,542,5333,5346,2445,2901,17
Fresno,2,2022-01-01,5028,5041,2192,2849,34827,34911,15129,19782,188
Glenn,2,2022-01-01,68,68,33,35,517,517,251,266,0
Humboldt,2,2022-01-01,721,721,349,372,4664,4674,2251,2423,10
Imperial,2,2022-01-01,1498,1502,687,815,8190,8210,3752,4458,57
Inyo,2,2022-01-01,207,207,113,94,598,598,324,274,3
Kern,2,2022-01-01,4273,4284,2084,2200,30062,30134,14530,15604,121
Kings,2,2022-01-01,872,872,383,489,7435,7454,3261,4193,17
Lake,2,2022-01-01,144,144,61,83,1470,1474,618,856,1
Lassen,2,2022-01-01,45,45,24,21,2511,2517,1332,1185,2
Los Angeles,2,2022-01-01,175228,175650,136703,38947,912080,914279,711142,203137,1792
Madera,2,2022-01-01,660,660,289,371,5686,5700,2475,3225,13
Marin,2,2022-01-01,2211,2216,1024,1192,17585,17627,8132,9495,19
Mariposa,2,2022-01-01,73,73,32,41,533,533,232,301,0
Mendocino,2,2022-01-01,325,325,114,211,2901,2907,1018,1889,6
Merced,2,2022-01-01,1223,1227,580,647,7403,7423,3509,3914,22
Modoc,2,2022-01-01,11,11,6,5,52,52,26,26,0
Mono,2,2022-01-01,170,170,64,106,386,386,146,240,2
Monterey,2,2022-01-01,1976,1981,658,1323,17498,17540,5799,11741,29
Napa,2,2022-01-01,1518,1522,750,772,10129,10154,4992,5162,10
Nevada,2,2022-01-01,472,472,201,271,2183,2189,925,1264,6
Orange,2,2022-01-01,39441,39536,19512,20024,199485,199966,98468,101498,522
Placer,2,2022-01-01,2381,2387,978,1409,14038,14073,5715,8358,124
Plumas,2,2022-01-01,36,36,16,20,352,352,150,202,2
Riverside,2,2022-01-01,26672,26736,11471,15265,125617,125920,53800,72120,545
Sacramento,2,2022-01-01,11306,11334,5547,5787,71512,71685,34933,36752,243
San Benito,2,2022-01-01,617,617,333,284,3032,3039,1639,1400,5
San Bernardino,2,2022-01-01,28052,28119,15811,12308,122891,123188,69159,54029,624
San Diego,2,2022-01-01,53222,53351,40243,13108,229967,230520,173701,56819,628
San Francisco,2,2022-01-01,9659,9682,3764,5918,74984,75164,29132,46032,84
San Joaquin,2,2022-01-01,5515,5529,2578,2951,32323,32400,14992,17408,94
San Luis Obispo,2,2022-01-01,2118,2122,1111,1011,14801,14837,7767,7070,19
San Mateo,2,2022-01-01,8997,9019,5352,3667,67506,67668,40074,27594,34
Santa Barbara,2,2022-01-01,4182,4193,2048,2145,22303,22357,10886,11471,57
Santa Clara,2,2022-01-01,17644,17687,13274,4413,134007,134330,100522,33808,198
Santa Cruz,2,2022-01-01,1857,1863,1031,832,15281,15318,8416,6902,21
Shasta,2,2022-01-01,439,439,189,250,5442,5455,2310,3145,13
Siskiyou,2,2022-01-01,57,57,31,26,456,456,247,209,0
Solano,2,2022-01-01,3488,3496,1731,1765,24086,24144,11912,12232,62
Sonoma,2,2022-01-01,3703,3712,1827,1885,27937,28004,13706,14298,29
Stanislaus,2,2022-01-01,2636,2643,1010,1633,15970,16010,6055,9955,120
Sutter,2,2022-01-01,402,402,188,214,2617,2623,1215,1408,0
Tehama,2,2022-01-01,169,169,61,108,1173,1176,414,762,4
Trinity,2,2022-01-01,9,9,4,5,101,101,40,61,0
Tulare,2,2022-01-01,1604,1608,597,1011,14668,14704,5393,9311,53
Tuolumne,2,2022-01-01,284,284,124,160,1902,1907,827,1080,6
Ventura,2,2022-01-01,11375,11402,6863,4539,55655,55790,33478,22312,124
Yolo,2,2022-01-01,1627,1632,892,740,25313,25374,13728,11646,10
Yuba,2,2022-01-01,358,358,177,181,2056,2061,1009,1052,22
Alameda,3,2022-01-08,31028,31106,19931,11175,191096,191584,122642,68942,307
Amador,3,2022-01-08,374,374,189,185,2778,2785,1397,1388,6
Butte,3,2022-01-08,1926,1932,1306,626,9996,10021,6767,3254,47
Calaveras,3,2022-01-08,454,454,249,205,2435,2440,1329,1111,2
Colusa,3,2022-01-08,77,77,43,34,659,659,365,294,5
Contra Costa,3,2022-01-08,18929,18977,10020,8957,102131,102392,54098,48294,172
Del Norte,3,2022-01-08,161,161,93,68,3855,3864,2244,1620,2
El Dorado,3,2022-01-08,2116,2121,1131,990,8873,8895,4739,4156,18
Fresno,3,2022-01-08,12030,12062,6166,5896,57975,58123,29641,28482,284
Glenn,3,2022-01-08,181,181,103,78,872,873,491,382,2
Humboldt,3,2022-01-08,1413,1418,793,625,8252,8273,4626,3647,16
Imperial,3,2022-01-08,3411,3421,1821,1600,13723,13757,7321,6436,74
Inyo,3,2022-01-08,392,392,240,152,1243,1246,766,480,4
Kern,3,2022-01-08,10964,10993,6148,4845,55468,55609,31032,24577,191
Kings,3,2022-01-08,1951,1956,1006,950,11902,11932,6125,5807,22
Lake,3,2022-01-08,456,456,225,231,2672,2677,1317,1360,2
Lassen,3,2022-01-08,118,118,72,46,3627,3636,2182,1454,2
Los Angeles,3,2022-01-08,333574,334426,276414,58012,1909160,1914031,1582264,331767,3364
Madera,3,2022-01-08,1701,1706,876,830,10067,10092,5149,4943,26
Marin,3,2022-01-08,3075,3082,1661,1421,21672,21727,11728,9999,23
Mariposa,3,2022-01-08,181,181,92,89,1104,1107,566,541,0
Mendocino,3,2022-01-08,808,808,342,466,5478,5491,2321,3170,7
Merced,3,2022-01-08,3166,3172,1744,1428,13340,13375,7342,6033,39
Modoc,3,2022-01-08,16,16,9,7,95,95,54,41,0
Mono,3,2022-01-08,261,261,118,143,841,842,382,460,1
Monterey,3,2022-01-08,4463,4475,1797,2678,32077,32159,12872,19287,56
Napa,3,2022-01-08,2692,2698,1526,1172,14849,14886,8415,6471,15
Nevada,3,2022-01-08,1102,1104,548,556,4899,4911,2427,2484,15
Orange,3,2022-01-08,61463,61619,34960,26659,313004,313800,178246,135554,907
Placer,3,2022-01-08,4817,4829,2335,2494,21304,21358,10298,11060,165
Plumas,3,2022-01-08,120,120,60,60,784,784,390,394,4
Riverside,3,2022-01-08,47592,47713,24002,23711,185246,185718,93406,92312,851
Sacramento,3,2022-01-08,26614,26682,15056,11626,119992,120298,67747,52551,399
San Benito,3,2022-01-08,963,963,589,374,4320,4330,2651,1679,6
San Bernardino,3,2022-01-08,47438,47558,30197,17361,188409,188890,119982,68908,923
San Diego,3,2022-01-08,85926,86146,69390,16756,343336,344211,277285,66926,943
San Francisco,3,2022-01-08,16285,16326,7528,8798,121372,121682,56226,65456,156
San Joaquin,3,2022-01-08,12926,12960,6997,5963,59817,59969,32317,27652,150
San Luis Obispo,3,2022-01-08,4269,4280,2568,1712,21780,21835,13085,8750,40
San Mateo,3,2022-01-08,15106,15145,10038,5107,114146,114435,75787,38648,97
Santa Barbara,3,2022-01-08,8332,8354,4690,3664,45769,45885,25786,20099,77
Santa Clara,3,2022-01-08,34981,35069,28088,6981,262209,262877,210583,52294,391
Santa Cruz,3,2022-01-08,4357,4368,2728,1640,41800,41906,26146,15760,18
Shasta,3,2022-01-08,991,991,496,495,8244,8265,4121,4144,54
Siskiyou,3,2022-01-08,106,106,65,41,874,875,535,340,5
Solano,3,2022-01-08,6545,6562,3746,2816,35748,35838,20421,15417,88
Sonoma,3,2022-01-08,8374,8395,4763,3632,46913,47033,26605,20428,71
Stanislaus,3,2022-01-08,5967,5982,2718,3264,27068,27137,12281,14856,168
Sutter,3,2022-01-08,1088,1089,590,499,4671,4683,2524,2159,0
Tehama,3,2022-01-08,460,460,197,263,2393,2398,1020,1378,12
Trinity,3,2022-01-08,33,33,16,17,263,263,125,138,0
Tulare,3,2022-01-08,4314,4326,1919,2407,22497,22554,9949,12605,62
Tuolumne,3,2022-01-08,702,702,358,344,4033,4045,2053,1992,14
Ventura,3,2022-01-08,17627,17671,11866,5805,87051,87272,58608,28664,228
Yolo,3,2022-01-08,3967,3978,2454,1524,50701,50829,31344,19485,8
Yuba,3,2022-01-08,925,925,524,401,3807,3818,2159,1659,35
Alameda,4,2022-01-15,26981,27055,19056,7999,185876,186381,131270,55111,402
Amador,4,2022-01-15,491,491,283,208,3823,3833,2203,1630,9
Butte,4,2022-01-15,2113,2119,1561,558,9634,9661,7104,2557,55
Calaveras,4,2022-01-15,612,612,376,236,2724,2731,1680,1051,5
Colusa,4,2022-01-15,165,165,103,62,799,801,499,302,2
Contra Costa,4,2022-01-15,16569,16614,9965,6649,95668,95930,57565,38365,238
Del Norte,4,2022-01-15,201,201,129,72,3970,3981,2552,1429,3
El Dorado,4,2022-01-15,2179,2185,1316,869,9015,9040,5450,3590,16
Fresno,4,2022-01-15,16746,16791,9791,7000,68078,68263,39756,28507,430
Glenn,4,2022-01-15,307,307,195,112,1061,1064,674,390,2
Humboldt,4,2022-01-15,1259,1262,792,470,8891,8916,5607,3309,24
Imperial,4,2022-01-15,3730,3740,2255,1485,14289,14327,8649,5678,94
Inyo,4,2022-01-15,397,397,269,128,1238,1242,842,400,3
Kern,4,2022-01-15,13181,13217,8303,4914,59453,59615,37430,22185,256
Kings,4,2022-01-15,3495,3506,2052,1454,16569,16614,9735,6879,46
Lake,4,2022-01-15,591,591,335,256,3193,3202,1816,1386,4
Lassen,4,2022-01-15,279,279,186,93,3783,3794,2536,1258,1
Los Angeles,4,2022-01-15,249870,250549,216437,34112,1800804,1805697,1560783,244914,4507
Madera,4,2022-01-15,2428,2434,1424,1010,11172,11203,6536,4667,32
Marin,4,2022-01-15,2675,2682,1639,1043,19354,19406,11864,7542,34
Mariposa,4,2022-01-15,189,189,109,80,1227,1232,717,515,0
Mendocino,4,2022-01-15,984,985,489,496,5575,5590,2770,2820,22
Merced,4,2022-01-15,4159,4170,2584,1586,14974,15015,9299,5716,53
Modoc,4,2022-01-15,10,10,6,4,110,110,70,40,0
Mono,4,2022-01-15,235,235,123,112,856,857,452,405,1
Monterey,4,2022-01-15,6067,6085,2884,3201,30168,30249,14273,15976,74
Napa,4,2022-01-15,2193,2198,1395,803,13379,13416,8515,4901,24
Nevada,4,2022-01-15,1316,1321,750,571,5720,5736,3249,2487,23
Orange,4,2022-01-15,47122,47251,30068,17183,282159,282926,180247,102679,1200
Placer,4,2022-01-15,4744,4757,2632,2125,21334,21393,11838,9555,207
Plumas,4,2022-01-15,186,186,105,81,806,808,458,350,4
Riverside,4,2022-01-15,45500,45623,26239,19384,182747,183243,105485,77758,1006
Sacramento,4,2022-01-15,23574,23638,14959,8679,111609,111912,70800,41112,533
San Benito,4,2022-01-15,945,945,639,306,4434,4446,3014,1432,8
San Bernardino,4,2022-01-15,42290,42405,29620,12785,181702,182195,127457,54738,1100
San Diego,4,2022-01-15,67474,67658,57320,10338,286886,287665,243803,43862,1206
San Francisco,4,2022-01-15,11817,11849,6342,5507,100550,100823,53976,46847,230
San Joaquin,4,2022-01-15,14286,14324,8718,5606,65102,65279,39726,25553,239
San Luis Obispo,4,2022-01-15,4102,4113,2743,1370,22532,22592,15069,7523,42
San Mateo,4,2022-01-15,13879,13917,10078,3839,109048,109343,79185,30158,111
Santa Barbara,4,2022-01-15,7602,7622,4806,2816,44892,45014,28413,16601,122
Santa Clara,4,2022-01-15,31571,31657,26690,4967,252854,253540,213801,39739,494
Santa Cruz,4,2022-01-15,4370,4381,3022,1359,45083,45205,31204,14001,34
Shasta,4,2022-01-15,1315,1320,759,561,9714,9740,5574,4166,74
Siskiyou,4,2022-01-15,160,160,109,51,1051,1054,712,342,5
Solano,4,2022-01-15,7019,7038,4512,2526,38497,38603,24723,13880,129
Sonoma,4,2022-01-15,8152,8174,5196,2978,46854,46981,29858,17123,91
Stanislaus,4,2022-01-15,7652,7674,4031,3643,30905,30989,16249,14740,219
Sutter,4,2022-01-15,1369,1374,838,536,5158,5172,3149,2023,0
Tehama,4,2022-01-15,634,634,317,317,2607,2614,1300,1314,15
Trinity,4,2022-01-15,43,43,23,20,272,272,148,124,0
Tulare,4,2022-01-15,7575,7596,3911,3685,28158,28234,14506,13728,96
Tuolumne,4,2022-01-15,942,942,548,394,4438,4450,2581,1869,9
Ventura,4,2022-01-15,13864,13901,10162,3739,76331,76537,55975,20562,338
Yolo,4,2022-01-15,3138,3148,2149,999,43893,44012,30088,13924,18
Yuba,4,2022-01-15,1105,1107,701,406,4012,4023,2546,1477,37
Alameda,5,2022-01-22,20511,20572,15671,4901,161682,162158,123654,38504,446
Amador,5,2022-01-22,561,561,363,198,4340,4354,2824,1530,11
Butte,5,2022-01-22,1951,1956,1543,413,8698,8724,6885,1839,88
Calaveras,5,2022-01-22,594,594,406,188,2441,2447,1671,776,7
Colusa,5,2022-01-22,160,160,110,50,810,811,560,251,5
Contra Costa,5,2022-01-22,13209,13247,8851,4396,81278,81516,54549,26967,302
Del Norte,5,2022-01-22,298,298,211,87,3830,3840,2710,1130,2
El Dorado,5,2022-01-22,1546,1551,1042,509,7237,7258,4878,2380,28
Fresno,5,2022-01-22,17603,17656,11498,6158,67808,68008,44319,23689,554
Glenn,5,2022-01-22,252,252,176,76,927,929,648,281,0
Humboldt,5,2022-01-22,981,982,682,300,7465,7488,5207,2281,22
Imperial,5,2022-01-22,3542,3553,2391,1162,12785,12822,8628,4194,85
Inyo,5,2022-01-22,158,158,117,41,609,609,449,160,1
Kern,5,2022-01-22,10695,10726,7458,3268,50520,50667,35251,15416,319
Kings,5,2022-01-22,4081,4094,2682,1412,16944,16994,11149,5845,43
Lake,5,2022-01-22,684,684,435,249,3179,3188,2021,1167,9
Lassen,5,2022-01-22,431,431,315,116,3492,3502,2554,948,1
Los Angeles,5,2022-01-22,171858,172363,154307,18056,1532726,1537238,1377326,159912,4569
Madera,5,2022-01-22,2758,2766,1809,957,11431,11463,7483,3980,54
Marin,5,2022-01-22,1958,1965,1333,632,17029,17079,11606,5473,51
Mariposa,5,2022-01-22,149,149,97,52,940,942,614,328,0
Mendocino,5,2022-01-22,963,966,550,416,4825,4840,2758,2082,22
Merced,5,2022-01-22,3185,3194,2192,1002,12392,12429,8537,3892,61
Modoc,5,2022-01-22,16,16,11,5,104,104,73,31,0
Mono,5,2022-01-22,97,97,58,39,462,462,276,186,1
Monterey,5,2022-01-22,5324,5338,2912,2426,31409,31502,17217,14285,102
Napa,5,2022-01-22,1704,1709,1198,511,11814,11848,8315,3533,24
Nevada,5,2022-01-22,1045,1048,668,380,4756,4770,3037,1733,26
Orange,5,2022-01-22,29975,30062,21093,8969,225863,226527,159392,67135,1162
Placer,5,2022-01-22,3820,3831,2397,1434,18211,18265,11428,6837,257
Plumas,5,2022-01-22,218,218,138,80,883,885,562,323,6
Riverside,5,2022-01-22,33748,33848,21852,11996,156238,156697,101299,55398,1048
Sacramento,5,2022-01-22,17934,17986,12565,5421,94895,95174,66555,28619,614
San Benito,5,2022-01-22,852,852,630,222,3958,3970,2939,1031,8
San Bernardino,5,2022-01-22,28526,28609,21675,6934,147872,148306,112513,35793,1207
San Diego,5,2022-01-22,53890,54049,47669,6380,247072,247799,218649,29150,1309
San Francisco,5,2022-01-22,8888,8913,5398,3515,86773,87028,52875,34153,278
San Joaquin,5,2022-01-22,11251,11285,7641,3644,56096,56260,38095,18165,296
San Luis Obispo,5,2022-01-22,3595,3606,2627,979,20759,20818,15185,5633,51
San Mateo,5,2022-01-22,9291,9318,7257,2061,90615,90880,70938,19942,154
Santa Barbara,5,2022-01-22,6569,6590,4596,1994,41115,41234,28785,12449,141
Santa Clara,5,2022-01-22,23347,23415,20575,2840,220211,220859,194180,26679,515
Santa Cruz,5,2022-01-22,5315,5331,4013,1318,48508,48652,36685,11967,43
Shasta,5,2022-01-22,1452,1457,937,520,9453,9482,6095,3387,81
Siskiyou,5,2022-01-22,156,156,115,41,821,823,606,217,6
Solano,5,2022-01-22,5039,5055,3566,1489,30893,30983,21857,9126,155
Sonoma,5,2022-01-22,7217,7238,5079,2159,41261,41381,29043,12338,106
Stanislaus,5,2022-01-22,6686,6707,4008,2699,27826,27909,16679,11230,303
Sutter,5,2022-01-22,1109,1113,754,359,4983,4998,3386,1612,0
Tehama,5,2022-01-22,578,578,330,248,2446,2452,1402,1050,20
Trinity,5,2022-01-22,66,66,41,25,311,311,192,119,0
Tulare,5,2022-01-22,7840,7862,4613,3249,28374,28457,16707,11750,130
Tuolumne,5,2022-01-22,887,887,578,309,3586,3597,2342,1255,17
Ventura,5,2022-01-22,9890,9919,7797,2122,64466,64656,50892,13764,355
Yolo,5,2022-01-22,2316,2323,1726,597,38322,38435,28632,9803,24
Yuba,5,2022-01-22,939,941,657,284,3727,3739,2614,1125,65
Alameda,6,2022-01-29,12532,12571,10179,2392,143344,143795,116520,27275,417
Amador,6,2022-01-29,364,364,258,106,3262,3272,2326,946,18
Butte,6,2022-01-29,1279,1283,1069,214,7910,7936,6610,1326,101
Calaveras,6,2022-01-29,282,282,208,74,1919,1924,1426,498,4
Colusa,6,2022-01-29,118,118,88,30,685,687,514,173,2
Contra Costa,6,2022-01-29,8238,8265,6011,2254,72227,72456,52829,19627,285
Del Norte,6,2022-01-29,357,357,272,85,4128,4142,3155,987,9
El Dorado,6,2022-01-29,840,842,616,226,6180,6200,4542,1658,20
Fresno,6,2022-01-29,12084,12122,8649,3473,58420,58603,41832,16771,586
Glenn,6,2022-01-29,208,208,157,51,762,763,576,187,4
Humboldt,6,2022-01-29,614,614,462,152,6164,6183,4652,1531,26
Imperial,6,2022-01-29,2542,2550,1863,687,12252,12292,9003,3289,103
Inyo,6,2022-01-29,66,66,52,14,507,508,400,108,4
Kern,6,2022-01-29,6422,6442,4843,1599,43960,44099,33192,10907,304
Kings,6,2022-01-29,2773,2781,1991,790,15067,15114,10827,4287,52
Lake,6,2022-01-29,561,562,392,170,3393,3404,2379,1025,10
Lassen,6,2022-01-29,347,347,272,75,3643,3654,2856,798,5
Los Angeles,6,2022-01-29,88321,88600,81427,7173,1339077,1343299,1235379,107920,3852
Madera,6,2022-01-29,1818,1823,1303,520,9844,9875,7051,2824,52
Marin,6,2022-01-29,1223,1228,906,322,14264,14309,10567,3742,48
Mariposa,6,2022-01-29,106,106,76,30,867,870,622,248,0
Mendocino,6,2022-01-29,541,541,344,197,3602,3614,2307,1307,14
Merced,6,2022-01-29,2298,2305,1715,590,10959,10994,8192,2802,64
Modoc,6,2022-01-29,12,12,9,3,98,98,74,24,2
Mono,6,2022-01-29,42,42,28,14,344,344,230,114,0
Monterey,6,2022-01-29,3862,3876,2387,1489,26896,26981,16640,10341,113
Napa,6,2022-01-29,1126,1130,856,274,9855,9886,7492,2394,22
Nevada,6,2022-01-29,676,677,473,204,4139,4152,2907,1245,30
Orange,6,2022-01-29,14346,14391,10912,3479,185332,185917,141255,44662,967
Placer,6,2022-01-29,2576,2585,1782,803,15846,15896,10973,4923,215
Plumas,6,2022-01-29,154,154,107,47,750,751,524,227,2
Riverside,6,2022-01-29,19205,19266,13627,5639,127209,127610,90486,37124,952
Sacramento,6,2022-01-29,11762,11798,8905,2893,81559,81816,61856,19960,588
San Benito,6,2022-01-29,528,528,417,111,3369,3379,2676,703,7
San Bernardino,6,2022-01-29,15547,15596,12569,3027,122428,122815,99177,23638,1004
San Diego,6,2022-01-29,29243,29335,26648,2687,193235,193844,176180,17664,1210
San Francisco,6,2022-01-29,4945,4960,3327,1633,75168,75406,50806,24600,259
San Joaquin,6,2022-01-29,6491,6511,4791,1720,45317,45459,33462,11997,306
San Luis Obispo,6,2022-01-29,2305,2311,1805,506,17373,17428,13629,3799,67
San Mateo,6,2022-01-29,5101,5117,4218,899,79526,79778,65868,13910,155
Santa Barbara,6,2022-01-29,4284,4298,3237,1061,36540,36656,27658,8998,112
Santa Clara,6,2022-01-29,15812,15862,14374,1488,209912,210574,190953,19621,518
Santa Cruz,6,2022-01-29,3560,3572,2861,711,46905,47053,37803,9250,45
Shasta,6,2022-01-29,1081,1084,764,320,8675,8703,6138,2565,82
Siskiyou,6,2022-01-29,125,125,99,26,699,700,552,148,13
Solano,6,2022-01-29,4155,4168,3180,988,29983,30078,22928,7150,165
Sonoma,6,2022-01-29,4222,4235,3204,1031,33736,33843,25643,8200,101
Stanislaus,6,2022-01-29,4096,4109,2728,1381,22822,22894,15215,7679,321
Sutter,6,2022-01-29,702,702,517,185,3940,3954,2912,1042,0
Tehama,6,2022-01-29,406,406,259,147,2160,2166,1385,781,22
Trinity,6,2022-01-29,39,39,27,12,221,221,150,71,0
Tulare,6,2022-01-29,5361,5378,3517,1861,24540,24616,16115,8501,149
Tuolumne,6,2022-01-29,829,832,592,240,3419,3429,2444,985,19
Ventura,6,2022-01-29,5571,5588,4637,951,55433,55607,46200,9407,312
Yolo,6,2022-01-29,1577,1582,1255,327,37794,37912,30182,7730,21
Yuba,6,2022-01-29,611,611,461,150,3072,3082,2329,753,75
Alameda,7,2022-02-05,6827,6851,5827,1024,121429,121855,103779,18076,347
Amador,7,2022-02-05,239,239,182,57,3060,3072,2353,719,16
Butte,7,2022-02-05,865,867,754,113,6582,6604,5746,858,85
Calaveras,7,2022-02-05,212,212,168,44,1565,1571,1244,327,2
Colusa,7,2022-02-05,89,89,71,18,569,570,454,116,4
Contra Costa,7,2022-02-05,4511,4527,3541,986,57646,57847,45307,12540,239
Del Norte,7,2022-02-05,240,240,195,45,3891,3905,3165,740,7
El Dorado,7,2022-02-05,501,501,393,108,5151,5170,4061,1109,29
Fresno,7,2022-02-05,7102,7127,5483,1644,45937,46098,35496,10602,561
Glenn,7,2022-02-05,138,138,111,27,641,642,516,126,4
Humboldt,7,2022-02-05,492,492,395,97,5034,5052,4057,995,21
Imperial,7,2022-02-05,1281,1286,1009,277,8876,8908,7000,1908,81
Inyo,7,2022-02-05,52,52,43,9,448,448,373,75,3
Kern,7,2022-02-05,3917,3931,3155,776,36332,36459,29286,7173,233
Kings,7,2022-02-05,1509,1514,1168,346,10783,10820,8355,2465,57
Lake,7,2022-02-05,386,386,292,94,2746,2755,2086,669,9
Lassen,7,2022-02-05,156,156,129,27,3202,3214,2659,555,5
Los Angeles,7,2022-02-05,43778,43931,41224,2707,1182302,1186445,1114001,72444,2841
Madera,7,2022-02-05,1234,1239,954,285,8417,8447,6509,1938,51
Marin,7,2022-02-05,719,719,569,150,12077,12119,9585,2534,33
Mariposa,7,2022-02-05,56,56,43,13,624,624,480,144,0
Mendocino,7,2022-02-05,353,353,248,105,2985,2996,2107,889,18
Merced,7,2022-02-05,1337,1342,1068,274,8425,8454,6736,1718,64
Modoc,7,2022-02-05,22,22,18,4,159,159,129,30,3
Mono,7,2022-02-05,46,46,33,13,270,270,196,74,0
Monterey,7,2022-02-05,2482,2492,1701,791,23043,23124,15790,7334,96
Napa,7,2022-02-05,791,793,641,152,8029,8057,6507,1550,23
Nevada,7,2022-02-05,396,396,300,96,3288,3299,2502,797,27
Orange,7,2022-02-05,7346,7371,5960,1411,156197,156745,126895,29850,627
Placer,7,2022-02-05,1508,1514,1133,381,12788,12833,9609,3224,184
Plumas,7,2022-02-05,99,99,75,24,575,576,434,142,1
Riverside,7,2022-02-05,9478,9511,7275,2236,100180,100531,76986,23545,720
Sacramento,7,2022-02-05,6924,6948,5600,1348,66342,66573,53682,12891,502
San Benito,7,2022-02-05,334,334,279,55,2819,2828,2364,464,8
San Bernardino,7,2022-02-05,7954,7982,6769,1213,94383,94714,80418,14296,720
San Diego,7,2022-02-05,15750,15804,14703,1101,158232,158786,147785,11001,991
San Francisco,7,2022-02-05,2647,2656,1951,705,57580,57783,42508,15275,225
San Joaquin,7,2022-02-05,3809,3823,3017,806,38104,38236,30191,8045,250
San Luis Obispo,7,2022-02-05,1429,1434,1187,247,13454,13501,11185,2316,40
San Mateo,7,2022-02-05,2843,2853,2463,390,64201,64426,55676,8750,125
Santa Barbara,7,2022-02-05,2702,2712,2182,530,33543,33660,27109,6551,102
Santa Clara,7,2022-02-05,9072,9103,8451,652,179011,179636,166838,12798,452
Santa Cruz,7,2022-02-05,2105,2112,1781,331,39283,39421,33250,6171,38
Shasta,7,2022-02-05,731,732,559,173,7223,7249,5525,1724,75
Siskiyou,7,2022-02-05,103,103,86,17,704,706,588,118,8
Solano,7,2022-02-05,2521,2529,2047,482,24720,24807,20108,4699,121
Sonoma,7,2022-02-05,2309,2318,1872,446,28057,28155,22747,5408,79
Stanislaus,7,2022-02-05,2800,2809,2040,769,19663,19733,14331,5402,285
Sutter,7,2022-02-05,429,429,338,91,3483,3497,2761,736,0
Tehama,7,2022-02-05,328,328,230,98,1720,1726,1213,513,24
Trinity,7,2022-02-05,24,24,18,6,151,151,111,40,0
Tulare,7,2022-02-05,3129,3140,2252,888,18700,18765,13469,5296,164
Tuolumne,7,2022-02-05,405,405,311,94,2681,2691,2069,622,13
Ventura,7,2022-02-05,3006,3016,2619,397,43484,43636,37892,5744,244
Yolo,7,2022-02-05,956,959,804,155,32578,32691,27433,5258,14
Yuba,7,2022-02-05,388,388,312,76,2519,2529,2038,491,58
Alameda,8,2022-02-12,4001,4018,3554,464,103060,103468,91593,11875,256
Amador,8,2022-02-12,112,112,91,21,2427,2435,1984,451,15
Butte,8,2022-02-12,542,542,488,54,5547,5569,5012,557,76
Calaveras,8,2022-02-12,114,114,95,19,1319,1323,1107,216,6
Colusa,8,2022-02-12,46,46,39,7,518,519,436,83,3
Contra Costa,8,2022-02-12,2700,2710,2245,465,46550,46735,38762,7973,172
Del Norte,8,2022-02-12,253,253,215,38,3671,3686,3134,552,9
El Dorado,8,2022-02-12,303,303,252,51,4674,4694,3900,794,25
Fresno,8,2022-02-12,4271,4286,3505,781,37069,37215,30446,6769,459
Glenn,8,2022-02-12,60,60,51,9,480,481,407,74,4
Humboldt,8,2022-02-12,396,396,335,61,4504,4522,3823,699,19
Imperial,8,2022-02-12,697,699,580,119,6674,6701,5569,1132,68
Inyo,8,2022-02-12,28,28,24,4,409,409,356,53,2
Kern,8,2022-02-12,2413,2423,2049,374,30141,30260,25593,4667,205
Kings,8,2022-02-12,914,917,751,166,8410,8444,6919,1525,52
Lake,8,2022-02-12,260,260,210,50,2426,2436,1965,471,10
Lassen,8,2022-02-12,140,140,122,18,3018,3030,2623,407,3
Los Angeles,8,2022-02-12,24933,25031,23868,1163,1084455,1088763,1038487,50276,2086
Madera,8,2022-02-12,708,709,580,129,7088,7117,5824,1293,44
Marin,8,2022-02-12,427,427,356,71,10398,10438,8726,1712,28
Mariposa,8,2022-02-12,28,28,23,5,436,436,357,79,0
Mendocino,8,2022-02-12,234,234,178,56,2482,2492,1895,597,18
Merced,8,2022-02-12,854,858,721,137,7279,7307,6140,1167,47
Modoc,8,2022-02-12,21,21,18,3,189,189,160,29,0
Mono,8,2022-02-12,14,14,11,3,180,180,140,40,0
Monterey,8,2022-02-12,1442,1447,1074,373,18799,18874,14007,4867,88
Napa,8,2022-02-12,474,474,402,72,6888,6916,5872,1044,17
Nevada,8,2022-02-12,206,206,166,40,2702,2711,2188,523,20
Orange,8,2022-02-12,4473,4492,3820,672,136323,136864,116384,20480,456
Placer,8,2022-02-12,757,758,605,153,10567,10609,8489,2120,141
Plumas,8,2022-02-12,49,49,39,10,441,442,355,87,2
Riverside,8,2022-02-12,5409,5430,4421,1009,79678,79995,65170,14825,503
Sacramento,8,2022-02-12,3944,3960,3357,603,55929,56153,47636,8517,427
San Benito,8,2022-02-12,212,212,184,28,2309,2318,2023,295,7
San Bernardino,8,2022-02-12,4426,4443,3919,524,77415,77723,68638,9085,511
San Diego,8,2022-02-12,9538,9576,9070,506,132346,132871,125890,6981,751
San Francisco,8,2022-02-12,1824,1830,1440,390,49106,49300,38885,10415,183
San Joaquin,8,2022-02-12,2296,2305,1924,381,32469,32597,27191,5406,189
San Luis Obispo,8,2022-02-12,878,882,764,118,10689,10732,9300,1432,30
San Mateo,8,2022-02-12,1564,1570,1405,165,56678,56902,50942,5960,75
Santa Barbara,8,2022-02-12,1282,1288,1091,197,23530,23623,20032,3591,78
Santa Clara,8,2022-02-12,5400,5421,5127,294,159885,160520,151852,8668,366
Santa Cruz,8,2022-02-12,1174,1179,1035,144,34162,34298,30120,4178,33
Shasta,8,2022-02-12,509,509,413,96,6178,6204,5033,1171,78
Siskiyou,8,2022-02-12,79,79,69,10,589,590,513,77,5
Solano,8,2022-02-12,1368,1374,1170,204,20375,20456,17421,3035,96
Sonoma,8,2022-02-12,1371,1377,1168,209,23426,23520,19974,3546,60
Stanislaus,8,2022-02-12,1642,1649,1286,363,16389,16453,12844,3609,242
Sutter,8,2022-02-12,248,248,207,41,2995,3009,2511,498,0
Tehama,8,2022-02-12,197,197,150,47,1453,1458,1111,347,19
Trinity,8,2022-02-12,21,21,17,4,162,162,128,34,0
Tulare,8,2022-02-12,1781,1788,1381,407,16305,16369,12674,3695,146
Tuolumne,8,2022-02-12,222,222,181,41,2349,2359,1928,431,12
Ventura,8,2022-02-12,1810,1817,1632,185,38398,38550,34640,3910,190
Yolo,8,2022-02-12,600,601,525,76,28982,29097,25475,3622,15
Yuba,8,2022-02-12,246,246,208,38,2191,2199,1864,335,41
Alameda,9,2022-02-19,2251,2261,2061,200,90480,90874,82868,8006,191
Amador,9,2022-02-19,91,91,78,13,2160,2169,1855,314,9
Butte,9,2022-02-19,307,307,284,23,4630,4650,4296,354,71
Calaveras,9,2022-02-19,52,52,45,7,957,961,839,122,6
Colusa,9,2022-02-19,29,29,25,4,381,381,335,46,6
Contra Costa,9,2022-02-19,1639,1647,1426,221,39867,40041,34711,5330,117
Del Norte,9,2022-02-19,154,154,136,18,3068,3082,2726,356,9
El Dorado,9,2022-02-19,169,169,147,22,4003,4021,3493,528,10
Fresno,9,2022-02-19,2458,2469,2117,352,30239,30371,26058,4313,360
Glenn,9,2022-02-19,33,33,29,4,405,406,357,49,2
Humboldt,9,2022-02-19,237,237,209,28,3796,3812,3357,455,20
Imperial,9,2022-02-19,456,456,396,60,5340,5364,4664,700,47
Inyo,9,2022-02-19,13,13,12,1,379,380,342,38,1
Kern,9,2022-02-19,1403,1409,1241,168,25883,25996,22907,3089,124
Kings,9,2022-02-19,571,572,492,80,7347,7379,6348,1031,33
Lake,9,2022-02-19,226,226,192,34,2194,2202,1870,332,9
Lassen,9,2022-02-19,143,143,128,15,2379,2389,2141,248,4
Los Angeles,9,2022-02-19,14106,14168,13673,495,986347,990649,956215,34434,1391
Madera,9,2022-02-19,416,416,357,59,5896,5921,5081,840,35
Marin,9,2022-02-19,262,262,228,34,9939,9982,8711,1271,20
Mariposa,9,2022-02-19,21,21,18,3,408,408,350,58,0
Mendocino,9,2022-02-19,141,141,114,27,2244,2253,1826,427,10
Merced,9,2022-02-19,555,556,487,69,5981,6006,5262,744,8
Modoc,9,2022-02-19,10,10,9,1,72,72,64,8,1
Mono,9,2022-02-19,8,8,7,1,172,172,142,30,0
Monterey,9,2022-02-19,902,907,721,186,14924,14988,11919,3069,61
Napa,9,2022-02-19,303,303,267,36,5768,5795,5120,675,10
Nevada,9,2022-02-19,129,129,109,20,2374,2383,2023,360,21
Orange,9,2022-02-19,2862,2875,2541,334,127003,127556,112791,14765,352
Placer,9,2022-02-19,380,380,320,60,9381,9421,7948,1473,114
Plumas,9,2022-02-19,25,25,21,4,384,384,324,60,1
Riverside,9,2022-02-19,2966,2979,2545,434,67143,67435,57695,9740,351
Sacramento,9,2022-02-19,2386,2396,2114,282,48769,48981,43232,5749,319
San Benito,9,2022-02-19,134,134,121,13,2050,2058,1857,201,4
San Bernardino,9,2022-02-19,2307,2317,2108,209,65986,66275,60352,5923,366
San Diego,9,2022-02-19,5509,5532,5312,220,111126,111610,107179,4431,589
San Francisco,9,2022-02-19,1133,1139,948,191,45320,45517,37955,7562,140
San Joaquin,9,2022-02-19,1295,1301,1133,168,27654,27775,24198,3577,129
San Luis Obispo,9,2022-02-19,585,586,526,60,9115,9155,8213,942,26
San Mateo,9,2022-02-19,894,898,825,73,49776,49993,45982,4011,60
Santa Barbara,9,2022-02-19,754,757,667,90,21656,21751,19183,2568,56
Santa Clara,9,2022-02-19,3002,3015,2891,124,139672,140278,134556,5722,296
Santa Cruz,9,2022-02-19,664,666,603,63,28324,28447,25794,2653,24
Shasta,9,2022-02-19,323,323,275,48,5418,5441,4638,803,65
Siskiyou,9,2022-02-19,53,53,48,5,534,535,481,54,11
Solano,9,2022-02-19,775,779,689,90,16728,16802,14879,1923,70
Sonoma,9,2022-02-19,786,790,697,93,18962,19045,16826,2219,40
Stanislaus,9,2022-02-19,917,922,762,160,13532,13590,11245,2345,187
Sutter,9,2022-02-19,156,156,136,20,2410,2421,2109,312,0
Tehama,9,2022-02-19,119,119,96,23,1255,1260,1022,238,14
Trinity,9,2022-02-19,16,16,13,3,224,224,187,37,0
Tulare,9,2022-02-19,963,968,794,174,12436,12489,10253,2236,99
Tuolumne,9,2022-02-19,123,123,105,18,1956,1964,1683,281,7
Ventura,9,2022-02-19,1020,1025,946,79,30888,31023,28620,2403,131
Yolo,9,2022-02-19,334,334,302,32,24102,24207,21896,2311,10
Yuba,9,2022-02-19,159,159,140,19,1791,1800,1587,213,29
Alameda,10,2022-02-26,1487,1494,1394,100,68945,69282,64691,4591,144
Amador,10,2022-02-26,64,64,57,7,1993,2003,1782,221,10
Butte,10,2022-02-26,189,189,178,11,3988,4008,3777,231,48
Calaveras,10,2022-02-26,35,35,32,3,1064,1068,965,103,0
Colusa,10,2022-02-26,11,11,10,1,362,363,329,34,3
Contra Costa,10,2022-02-26,963,968,869,99,31615,31770,28547,3223,85
Del Norte,10,2022-02-26,88,88,80,8,2691,2705,2467,238,6
El Dorado,10,2022-02-26,116,116,104,12,3361,3378,3039,339,9
Fresno,10,2022-02-26,1343,1350,1202,148,25156,25279,22522,2757,268
Glenn,10,2022-02-26,21,21,19,2,376,377,342,35,0
Humboldt,10,2022-02-26,137,137,124,13,2765,2779,2525,254,8
Imperial,10,2022-02-26,268,268,241,27,4537,4559,4101,458,24
Inyo,10,2022-02-26,10,10,9,1,326,327,302,25,0
Kern,10,2022-02-26,882,887,806,81,22362,22472,20426,2046,101
Kings,10,2022-02-26,257,257,229,28,5894,5923,5284,639,21
Lake,10,2022-02-26,126,126,111,15,1809,1817,1606,211,3
Lassen,10,2022-02-26,59,59,54,5,1995,2005,1846,159,1
Los Angeles,10,2022-02-26,8515,8557,8333,224,925242,929769,905816,23953,975
Madera,10,2022-02-26,205,205,183,22,4162,4182,3728,454,26
Marin,10,2022-02-26,146,146,132,14,7105,7139,6442,697,14
Mariposa,10,2022-02-26,34,34,30,4,324,324,288,36,0
Mendocino,10,2022-02-26,77,77,65,12,1713,1720,1466,254,10
Merced,10,2022-02-26,281,281,254,27,4724,4747,4297,450,31
Modoc,10,2022-02-26,6,6,5,1,50,50,45,5,1
Mono,10,2022-02-26,5,5,4,1,166,166,144,22,0
Monterey,10,2022-02-26,415,415,347,68,12742,12804,10754,2050,32
Napa,10,2022-02-26,173,173,158,15,4942,4967,4527,440,8
Nevada,10,2022-02-26,78,78,69,9,1985,1995,1764,231,12
Orange,10,2022-02-26,1855,1865,1700,165,114642,115203,105117,10086,252
Placer,10,2022-02-26,270,270,237,33,7931,7970,7005,965,99
Plumas,10,2022-02-26,26,26,23,3,342,342,301,41,0
Riverside,10,2022-02-26,1788,1796,1596,200,59326,59615,52986,6629,258
Sacramento,10,2022-02-26,1202,1209,1100,109,41223,41425,37721,3704,224
San Benito,10,2022-02-26,60,60,56,4,1583,1591,1473,118,1
San Bernardino,10,2022-02-26,1276,1283,1195,88,56427,56703,52862,3841,221
San Diego,10,2022-02-26,3389,3407,3305,102,93900,94358,91560,2798,450
San Francisco,10,2022-02-26,866,871,758,113,36445,36623,31923,4700,99
San Joaquin,10,2022-02-26,734,738,665,73,23401,23516,21201,2315,90
San Luis Obispo,10,2022-02-26,318,318,293,25,7644,7681,7083,598,16
San Mateo,10,2022-02-26,546,546,513,33,35219,35390,33256,2134,46
Santa Barbara,10,2022-02-26,412,412,375,37,19323,19419,17672,1747,44
Santa Clara,10,2022-02-26,1769,1777,1723,54,83548,83955,81408,2547,241
Santa Cruz,10,2022-02-26,480,481,447,34,23772,23890,22210,1680,19
Shasta,10,2022-02-26,173,173,153,20,4571,4593,4070,523,49
Siskiyou,10,2022-02-26,29,29,27,2,396,397,367,30,6
Solano,10,2022-02-26,484,484,441,43,14219,14290,13045,1245,65
Sonoma,10,2022-02-26,458,459,418,41,15053,15127,13786,1341,25
Stanislaus,10,2022-02-26,513,514,445,69,11908,11965,10366,1599,154
Sutter,10,2022-02-26,104,104,94,10,2211,2222,2004,218,0
Tehama,10,2022-02-26,58,58,49,9,1108,1113,949,164,10
Trinity,10,2022-02-26,6,6,5,1,111,111,97,14,0
Tulare,10,2022-02-26,507,508,437,71,11090,11144,9599,1545,82
Tuolumne,10,2022-02-26,82,82,73,9,1430,1435,1277,158,7
Ventura,10,2022-02-26,615,616,580,36,27322,27456,25853,1603,92
Yolo,10,2022-02-26,214,214,198,16,22507,22617,20989,1628,9
Yuba,10,2022-02-26,79,79,72,7,1703,1710,1556,154,20
Alameda,11,2022-03-05,1162,1168,1108,60,73819,74207,70439,3768,108
Amador,11,2022-03-05,75,75,69,6,1384,1391,1271,120,6
Butte,11,2022-03-05,134,134,128,6,3669,3687,3526,161,31
Calaveras,11,2022-03-05,28,28,26,2,1121,1126,1042,84,1
Colusa,11,2022-03-05,10,10,9,1,344,345,320,25,6
Contra Costa,11,2022-03-05,651,654,603,51,31784,31951,29452,2499,66
Del Norte,11,2022-03-05,54,54,50,4,1859,1868,1742,126,6
El Dorado,11,2022-03-05,91,91,84,7,3261,3278,3024,254,6
Fresno,11,2022-03-05,955,960,879,81,22827,22948,21020,1928,175
Glenn,11,2022-03-05,12,12,11,1,366,367,341,26,1
Humboldt,11,2022-03-05,110,110,102,8,3067,3083,2868,215,8
Imperial,11,2022-03-05,172,172,158,14,4543,4566,4214,352,21
Inyo,11,2022-03-05,9,9,8,1,371,373,351,22,1
Kern,11,2022-03-05,515,516,480,36,21597,21711,20193,1518,78
Kings,11,2022-03-05,165,165,151,14,5082,5108,4684,424,13
Lake,11,2022-03-05,69,69,63,6,1823,1832,1668,164,5
Lassen,11,2022-03-05,83,83,78,5,1824,1834,1722,112,0
Los Angeles,11,2022-03-05,6126,6159,6038,121,888318,893007,875550,17457,755
Madera,11,2022-03-05,131,131,120,11,4124,4145,3798,347,14
Marin,11,2022-03-05,169,169,156,13,7697,7737,7156,581,11
Mariposa,11,2022-03-05,14,14,13,1,304,304,278,26,0
Mendocino,11,2022-03-05,75,75,66,9,1773,1781,1576,205,10
Merced,11,2022-03-05,200,200,185,15,4671,4695,4354,341,25
Modoc,11,2022-03-05,1,1,1,0,52,52,48,4,0
Mono,11,2022-03-05,3,3,3,0,130,130,116,14,1
Monterey,11,2022-03-05,268,268,234,34,11526,11587,10134,1453,21
Napa,11,2022-03-05,200,200,186,14,5017,5043,4699,344,9
Nevada,11,2022-03-05,47,47,43,4,1755,1763,1606,157,5
Orange,11,2022-03-05,1337,1344,1254,90,109582,110158,102740,7418,189
Placer,11,2022-03-05,177,177,160,17,7852,7893,7157,736,77
Plumas,11,2022-03-05,4,4,4,0,274,274,248,26,0
Riverside,11,2022-03-05,1096,1102,1007,95,55178,55470,50717,4753,169
Sacramento,11,2022-03-05,848,853,794,59,40177,40389,37617,2772,161
San Benito,11,2022-03-05,37,37,35,2,1537,1545,1457,88,2
San Bernardino,11,2022-03-05,904,909,862,47,54033,54318,51511,2807,145
San Diego,11,2022-03-05,2513,2526,2470,56,96789,97301,95126,2175,314
San Francisco,11,2022-03-05,680,684,615,69,38174,38376,34551,3825,69
San Joaquin,11,2022-03-05,458,459,424,35,21409,21521,19889,1632,60
San Luis Obispo,11,2022-03-05,302,302,284,18,7482,7522,7073,449,9
San Mateo,11,2022-03-05,566,568,542,26,41692,41912,39977,1935,37
Santa Barbara,11,2022-03-05,220,220,205,15,18204,18300,17033,1267,26
Santa Clara,11,2022-03-05,1513,1521,1486,35,116403,117016,114319,2697,197
Santa Cruz,11,2022-03-05,343,343,324,19,25048,25180,23819,1361,17
Shasta,11,2022-03-05,145,145,132,13,4962,4988,4552,436,41
Siskiyou,11,2022-03-05,19,19,18,1,417,418,393,25,1
Solano,11,2022-03-05,386,386,360,26,13954,14027,13086,941,60
Sonoma,11,2022-03-05,374,374,349,25,15514,15597,14535,1062,29
Stanislaus,11,2022-03-05,316,316,283,33,11171,11229,10060,1169,115
Sutter,11,2022-03-05,87,87,80,7,2020,2031,1877,154,0
Tehama,11,2022-03-05,50,50,44,6,1201,1207,1069,138,8
Trinity,11,2022-03-05,6,6,5,1,111,111,100,11,0
Tulare,11,2022-03-05,343,343,306,37,10310,10365,9251,1114,46
Tuolumne,11,2022-03-05,54,54,49,5,1285,1291,1182,109,3
Ventura,11,2022-03-05,415,415,397,18,27243,27386,26170,1216,55
Yolo,11,2022-03-05,169,169,160,9,22594,22712,21452,1260,6
Yuba,11,2022-03-05,68,68,63,5,1618,1626,1514,112,18
Alameda,12,2022-03-12,965,971,933,38,68649,69067,66425,2642,78
Amador,12,2022-03-12,32,32,30,2,1460,1469,1372,97,5
Butte,12,2022-03-12,72,72,70,2,3444,3465,3351,114,19
Calaveras,12,2022-03-12,16,16,15,1,1052,1058,998,60,1
Colusa,12,2022-03-12,6,6,6,0,253,253,239,14,2
Contra Costa,12,2022-03-12,591,596,561,35,29187,29366,27625,1741,31
Del Norte,12,2022-03-12,44,44,42,2,1466,1475,1399,76,5
El Dorado,12,2022-03-12,54,54,51,3,3049,3067,2887,180,7
Fresno,12,2022-03-12,613,617,577,40,21803,21934,20534,1400,145
Glenn,12,2022-03-12,17,17,16,1,320,321,304,17,1
Humboldt,12,2022-03-12,63,63,60,3,2777,2794,2646,148,4
Imperial,12,2022-03-12,88,88,83,5,4678,4707,4431,276,13
Inyo,12,2022-03-12,10,10,10,0,165,165,158,7,0
Kern,12,2022-03-12,316,316,299,17,20080,20202,19136,1066,60
Kings,12,2022-03-12,218,218,204,14,4835,4865,4559,306,16
Lake,12,2022-03-12,65,65,61,4,1599,1608,1498,110,0
Lassen,12,2022-03-12,25,25,24,1,1502,1510,1440,70,0
Los Angeles,12,2022-03-12,4338,4364,4300,64,847928,853096,840629,12467,520
Madera,12,2022-03-12,83,83,78,5,3713,3736,3498,238,15
Marin,12,2022-03-12,163,163,154,9,6639,6678,6297,381,6
Mariposa,12,2022-03-12,7,7,7,0,223,223,209,14,0
Mendocino,12,2022-03-12,41,41,37,4,1481,1488,1357,131,5
Merced,12,2022-03-12,144,144,136,8,4221,4247,4014,233,25
Modoc,12,2022-03-12,3,3,3,0,56,56,53,3,1
Mono,12,2022-03-12,2,2,2,0,106,106,97,9,0
Monterey,12,2022-03-12,181,181,163,18,10340,10401,9397,1004,17
Napa,12,2022-03-12,149,149,141,8,4290,4316,4092,224,7
Nevada,12,2022-03-12,51,51,48,3,1588,1597,1489,108,3
Orange,12,2022-03-12,936,942,894,48,102404,103028,97782,5246,150
Placer,12,2022-03-12,158,158,147,11,7553,7598,7059,539,68
Plumas,12,2022-03-12,10,10,9,1,313,313,291,22,0
Riverside,12,2022-03-12,782,788,736,52,51384,51696,48329,3367,116
Sacramento,12,2022-03-12,628,633,600,33,37178,37404,35458,1946,134
San Benito,12,2022-03-12,27,27,26,1,1449,1457,1395,62,2
San Bernardino,12,2022-03-12,606,610,586,24,51098,51410,49405,2005,119
San Diego,12,2022-03-12,2006,2018,1984,34,96790,97379,95748,1631,225
San Francisco,12,2022-03-12,586,590,545,45,35041,35254,32573,2681,41
San Joaquin,12,2022-03-12,316,316,298,18,20439,20562,19379,1183,41
San Luis Obispo,12,2022-03-12,163,163,156,7,6985,7027,6709,318,6
San Mateo,12,2022-03-12,467,468,452,16,37439,37666,36359,1307,29
Santa Barbara,12,2022-03-12,193,193,183,10,17575,17681,16756,925,20
Santa Clara,12,2022-03-12,1136,1143,1123,20,101381,101998,100242,1756,131
Santa Cruz,12,2022-03-12,247,247,237,10,23057,23196,22250,946,11
Shasta,12,2022-03-12,105,105,98,7,4938,4968,4636,332,21
Siskiyou,12,2022-03-12,17,17,16,1,400,401,383,18,0
Solano,12,2022-03-12,244,244,232,12,12982,13061,12397,664,44
Sonoma,12,2022-03-12,235,235,223,12,13966,14051,13326,725,16
Stanislaus,12,2022-03-12,247,247,227,20,10206,10269,9453,816,106
Sutter,12,2022-03-12,56,56,53,3,1806,1818,1714,104,0
Tehama,12,2022-03-12,27,27,25,2,997,1002,914,88,1
Trinity,12,2022-03-12,2,2,2,0,97,97,90,7,0
Tulare,12,2022-03-12,212,212,194,18,9771,9830,9020,810,37
Tuolumne,12,2022-03-12,29,29,27,2,1246,1253,1172,81,2
Ventura,12,2022-03-12,352,352,340,12,25153,25306,24458,848,40
Yolo,12,2022-03-12,132,132,126,6,21586,21718,20809,909,4
Yuba,12,2022-03-12,44,44,42,2,1446,1455,1379,76,12
Alameda,13,2022-03-19,693,698,678,20,67206,67686,65738,1948,58
Amador,13,2022-03-19,29,29,28,1,1388,1399,1330,69,2
Butte,13,2022-03-19,85,85,83,2,2984,3006,2932,74,17
Calaveras,13,2022-03-19,14,14,13,1,655,660,632,28,0
Colusa,13,2022-03-19,1,1,1,0,241,241,231,10,2
Contra Costa,13,2022-03-19,465,468,447,21,27736,27933,26679,1254,41
Del Norte,13,2022-03-19,19,19,18,1,1282,1290,1240,50,2
El Dorado,13,2022-03-19,41,41,39,2,2826,2846,2720,126,2
Fresno,13,2022-03-19,350,352,335,17,19949,20091,19120,971,101
Glenn,13,2022-03-19,8,8,8,0,339,340,326,14,1
Humboldt,13,2022-03-19,35,35,34,1,2378,2394,2299,95,7
Imperial,13,2022-03-19,62,62,59,3,4066,4095,3914,181,9
Inyo,13,2022-03-19,1,1,1,0,156,156,151,5,0
Kern,13,2022-03-19,219,219,210,9,19391,19531,18751,780,40
Kings,13,2022-03-19,76,76,72,4,4410,4441,4229,212,6
Lake,13,2022-03-19,20,20,19,1,1447,1456,1380,76,0
Lassen,13,2022-03-19,10,10,10,0,1528,1538,1484,54,0
Los Angeles,13,2022-03-19,3982,4011,3967,44,826519,832428,823335,9093,422
Madera,13,2022-03-19,46,46,44,2,3419,3444,3278,166,13
Marin,13,2022-03-19,148,148,142,6,6359,6404,6128,276,7
Mariposa,13,2022-03-19,8,8,8,0,246,246,234,12,0
Mendocino,13,2022-03-19,32,32,30,2,1498,1511,1411,100,5
Merced,13,2022-03-19,97,97,93,4,3902,3929,3766,163,16
Modoc,13,2022-03-19,2,2,2,0,51,51,49,2,0
Mono,13,2022-03-19,2,2,2,0,131,131,123,8,1
Monterey,13,2022-03-19,150,150,139,11,10217,10291,9535,756,19
Napa,13,2022-03-19,65,65,62,3,3532,3556,3417,139,8
Nevada,13,2022-03-19,26,26,25,1,1539,1551,1471,80,1
Orange,13,2022-03-19,752,758,729,29,98292,98995,95192,3803,132
Placer,13,2022-03-19,110,110,104,6,6548,6595,6240,355,40
Plumas,13,2022-03-19,2,2,2,0,223,224,212,12,0
Riverside,13,2022-03-19,671,676,643,33,54660,55049,52330,2719,98
Sacramento,13,2022-03-19,472,476,457,19,32735,32968,31678,1290,113
San Benito,13,2022-03-19,26,26,25,1,1401,1411,1366,45,2
San Bernardino,13,2022-03-19,484,488,474,14,51329,51697,50183,1514,86
San Diego,13,2022-03-19,1536,1547,1528,19,88322,88954,87839,1115,203
San Francisco,13,2022-03-19,653,659,621,38,33550,33792,31844,1948,40
San Joaquin,13,2022-03-19,231,231,221,10,15543,15653,14974,679,34
San Luis Obispo,13,2022-03-19,114,114,110,4,6678,6725,6496,229,3
San Mateo,13,2022-03-19,383,385,375,10,34155,34399,33505,894,28
Santa Barbara,13,2022-03-19,180,180,173,7,16141,16256,15614,642,17
Santa Clara,13,2022-03-19,1022,1029,1016,13,94811,95489,94264,1225,125
Santa Cruz,13,2022-03-19,212,212,205,7,20686,20834,20194,640,10
Shasta,13,2022-03-19,56,56,53,3,4332,4362,4141,221,1
Siskiyou,13,2022-03-19,9,9,9,0,360,362,350,12,1
Solano,13,2022-03-19,195,195,187,8,11622,11705,11257,448,22
Sonoma,13,2022-03-19,225,225,216,9,13337,13432,12912,520,14
Stanislaus,13,2022-03-19,154,154,145,9,8609,8670,8148,522,72
Sutter,13,2022-03-19,30,30,29,1,1488,1500,1435,65,0
Tehama,13,2022-03-19,9,9,8,1,926,931,869,62,1
Trinity,13,2022-03-19,1,1,1,0,96,96,90,6,0
Tulare,13,2022-03-19,129,129,121,8,8465,8525,7992,533,30
Tuolumne,13,2022-03-19,18,18,17,1,1167,1175,1117,58,2
Ventura,13,2022-03-19,288,288,281,7,23858,24029,23426,603,35
Yolo,13,2022-03-19,97,97,94,3,22347,22507,21799,708,4
Yuba,13,2022-03-19,34,34,33,1,1326,1336,1284,52,7
Alameda,14,2022-03-26,877,885,866,19,59342,59835,58544,1291,52
Amador,14,2022-03-26,11,11,11,0,1311,1323,1273,50,3
Butte,14,2022-03-26,69,69,68,1,2731,2753,2702,51,14
Calaveras,14,2022-03-26,14,14,14,0,601,606,587,19,0
Colusa,14,2022-03-26,4,4,4,0,197,197,191,6,0
Contra Costa,14,2022-03-26,508,513,496,17,24835,25043,24198,845,32
Del Norte,14,2022-03-26,17,17,16,1,1036,1046,1016,30,0
El Dorado,14,2022-03-26,51,51,49,2,2789,2811,2717,94,0
Fresno,14,2022-03-26,304,305,294,11,18557,18711,18030,681,95
Glenn,14,2022-03-26,7,7,7,0,308,309,300,9,0
Humboldt,14,2022-03-26,27,27,26,1,2594,2615,2536,79,5
Imperial,14,2022-03-26,54,54,52,2,3711,3741,3616,125,7
Inyo,14,2022-03-26,3,3,3,0,164,164,160,4,1
Kern,14,2022-03-26,154,154,149,5,18451,18604,18045,559,26
Kings,14,2022-03-26,65,65,63,2,4404,4441,4282,159,2
Lake,14,2022-03-26,13,13,12,1,1149,1157,1112,45,0
Lassen,14,2022-03-26,6,6,6,0,1361,1373,1337,36,0
Los Angeles,14,2022-03-26,4347,4384,4348,36,786984,793536,787071,6465,341
Madera,14,2022-03-26,24,24,23,1,3366,3394,3271,123,4
Marin,14,2022-03-26,166,166,161,5,5887,5937,5745,192,3
Mariposa,14,2022-03-26,6,6,6,0,178,178,171,7,0
Mendocino,14,2022-03-26,29,29,28,1,1290,1302,1236,66,0
Merced,14,2022-03-26,64,64,62,2,3337,3364,3259,105,12
Modoc,14,2022-03-26,2,2,2,0,52,52,50,2,0
Mono,14,2022-03-26,3,3,3,0,132,132,126,6,0
Monterey,14,2022-03-26,164,164,155,9,9445,9522,8992,530,19
Napa,14,2022-03-26,62,62,60,2,3330,3358,3259,99,1
Nevada,14,2022-03-26,25,25,24,1,1476,1490,1432,58,1
Orange,14,2022-03-26,798,805,782,23,90148,90899,88278,2621,100
Placer,14,2022-03-26,113,113,108,5,6158,6208,5955,253,33
Plumas,14,2022-03-26,2,2,2,0,272,274,263,11,0
Riverside,14,2022-03-26,519,525,506,19,44556,44927,43261,1666,75
Sacramento,14,2022-03-26,462,467,453,14,31674,31936,30995,941,96
San Benito,14,2022-03-26,10,10,10,0,1305,1315,1283,32,0
San Bernardino,14,2022-03-26,493,498,487,11,41179,41523,40611,912,69
San Diego,14,2022-03-26,1327,1339,1327,12,74032,74646,73948,698,155
San Francisco,14,2022-03-26,770,777,743,34,32750,33024,31587,1437,30
San Joaquin,14,2022-03-26,191,191,185,6,16610,16748,16203,545,31
San Luis Obispo,14,2022-03-26,98,98,95,3,5878,5927,5776,151,5
San Mateo,14,2022-03-26,510,513,503,10,34367,34653,33977,676,28
Santa Barbara,14,2022-03-26,120,120,116,4,8878,8951,8687,264,21
Santa Clara,14,2022-03-26,1224,1233,1221,12,91029,91787,90909,878,102
Santa Cruz,14,2022-03-26,136,136,133,3,18709,18864,18431,433,7
Shasta,14,2022-03-26,41,41,39,2,3902,3934,3784,150,8
Siskiyou,14,2022-03-26,8,8,8,0,305,306,298,8,0
Solano,14,2022-03-26,157,157,153,4,10903,10994,10677,317,26
Sonoma,14,2022-03-26,232,232,225,7,8218,8287,8047,240,14
Stanislaus,14,2022-03-26,127,127,121,6,8025,8091,7723,368,41
Sutter,14,2022-03-26,27,27,26,1,1516,1529,1479,50,0
Tehama,14,2022-03-26,14,14,13,1,808,814,773,41,2
Trinity,14,2022-03-26,0,0,0,0,102,102,97,5,0
Tulare,14,2022-03-26,95,95,90,5,7870,7936,7561,375,19
Tuolumne,14,2022-03-26,9,9,9,0,1113,1122,1081,41,3
Ventura,14,2022-03-26,332,333,327,6,21752,21932,21520,412,23
Yolo,14,2022-03-26,97,97,95,2,17164,17308,16901,407,3
Yuba,14,2022-03-26,34,34,33,1,1254,1265,1228,37,3
Alameda,15,2022-04-02,958,967,952,15,58357,58928,57977,951,37
Amador,15,2022-04-02,4,4,4,0,1178,1189,1155,34,1
Butte,15,2022-04-02,50,50,49,1,2483,2507,2472,35,10
Calaveras,15,2022-04-02,12,12,12,0,586,592,578,14,0
Colusa,15,2022-04-02,4,4,4,0,199,199,194,5,0
Contra Costa,15,2022-04-02,546,553,539,14,24552,24792,24164,628,20
Del Norte,15,2022-04-02,11,11,11,0,1126,1138,1113,25,0
El Dorado,15,2022-04-02,52,52,51,1,2778,2805,2735,70,2
Fresno,15,2022-04-02,199,199,194,5,17047,17213,16742,471,75
Glenn,15,2022-04-02,5,5,5,0,261,262,256,6,0
Humboldt,15,2022-04-02,21,21,21,0,2510,2533,2476,57,5
Imperial,15,2022-04-02,55,55,54,1,3486,3519,3431,88,6
Inyo,15,2022-04-02,8,8,8,0,182,182,179,3,0
Kern,15,2022-04-02,163,163,159,4,17196,17363,16972,391,23
Kings,15,2022-04-02,49,49,48,1,4156,4196,4083,113,3
Lake,15,2022-04-02,12,12,12,0,986,995,966,29,0
Lassen,15,2022-04-02,4,4,4,0,1218,1231,1207,24,0
Los Angeles,15,2022-04-02,5036,5085,5054,31,732577,739780,735322,4458,288
Madera,15,2022-04-02,28,28,27,1,3276,3309,3219,90,5
Marin,15,2022-04-02,155,155,151,4,6555,6618,6458,160,2
Mariposa,15,2022-04-02,5,5,5,0,215,216,210,6,0
Mendocino,15,2022-04-02,26,26,25,1,1252,1265,1216,49,0
Merced,15,2022-04-02,58,58,57,1,3286,3319,3241,78,4
Modoc,15,2022-04-02,4,4,4,0,42,42,41,1,0
Mono,15,2022-04-02,1,1,1,0,154,154,149,5,0
Monterey,15,2022-04-02,127,127,122,5,7539,7613,7294,319,11
Napa,15,2022-04-02,59,59,58,1,3245,3277,3205,72,3
Nevada,15,2022-04-02,28,28,27,1,1401,1415,1374,41,0
Orange,15,2022-04-02,901,910,891,19,88525,89392,87457,1935,72
Placer,15,2022-04-02,124,124,120,4,6578,6644,6441,203,29
Plumas,15,2022-04-02,4,4,4,0,233,234,227,7,0
Riverside,15,2022-04-02,605,612,595,17,39288,39672,38563,1109,51
Sacramento,15,2022-04-02,431,436,426,10,32765,33085,32354,731,63
San Benito,15,2022-04-02,13,13,13,0,1229,1243,1220,23,0
San Bernardino,15,2022-04-02,586,592,582,10,41542,41949,41259,690,35
San Diego,15,2022-04-02,1504,1518,1508,10,65985,66630,66165,465,133
San Francisco,15,2022-04-02,962,971,939,32,28739,29018,28063,955,25
San Joaquin,15,2022-04-02,208,208,203,5,16036,16193,15794,399,16
San Luis Obispo,15,2022-04-02,101,101,99,2,5599,5654,5546,108,4
San Mateo,15,2022-04-02,649,656,647,9,29623,29911,29474,437,16
Santa Barbara,15,2022-04-02,177,177,173,4,15222,15371,15030,341,11
Santa Clara,15,2022-04-02,1402,1415,1405,10,91279,92170,91509,661,102
Santa Cruz,15,2022-04-02,188,189,186,3,20063,20260,19909,351,5
Shasta,15,2022-04-02,25,25,24,1,3526,3560,3458,102,5
Siskiyou,15,2022-04-02,4,4,4,0,313,315,309,6,0
Solano,15,2022-04-02,148,148,145,3,10215,10314,10090,224,26
Sonoma,15,2022-04-02,287,288,282,6,10643,10746,10512,234,9
Stanislaus,15,2022-04-02,102,102,99,3,7811,7886,7615,271,25
Sutter,15,2022-04-02,23,23,22,1,1272,1285,1253,32,0
Tehama,15,2022-04-02,4,4,4,0,746,752,723,29,0
Trinity,15,2022-04-02,1,1,1,0,77,77,75,2,0
Tulare,15,2022-04-02,54,54,52,2,7606,7680,7406,274,15
Tuolumne,15,2022-04-02,11,11,11,0,972,981,954,27,1
Ventura,15,2022-04-02,296,297,293,4,20920,21125,20829,296,22
Yolo,15,2022-04-02,64,64,63,1,28221,28497,27991,506,1
Yuba,15,2022-04-02,12,12,12,0,1023,1035,1012,23,4
Alameda,16,2022-04-09,1355,1370,1354,16,48772,49318,48725,593,49
Amador,16,2022-04-09,7,7,7,0,1099,1112,1088,24,1
Butte,16,2022-04-09,36,36,36,0,2088,2111,2089,22,8
Calaveras,16,2022-04-09,10,10,10,0,643,650,638,12,0
Colusa,16,2022-04-09,4,4,4,0,195,196,192,4,0
Contra Costa,16,2022-04-09,623,630,618,12,19569,19787,19413,374,23
Del Norte,16,2022-04-09,7,7,7,0,982,993,977,16,1
El Dorado,16,2022-04-09,51,51,50,1,2570,2599,2550,49,1
Fresno,16,2022-04-09,196,196,192,4,16687,16876,16530,346,64
Glenn,16,2022-04-09,3,3,3,0,229,230,226,4,0
Humboldt,16,2022-04-09,38,38,37,1,2329,2355,2315,40,7
Imperial,16,2022-04-09,25,25,25,0,3490,3529,3463,66,3
Inyo,16,2022-04-09,5,5,5,0,199,200,197,3,0
Kern,16,2022-04-09,148,148,146,2,17195,17388,17096,292,20
Kings,16,2022-04-09,33,33,32,1,4206,4253,4167,86,3
Lake,16,2022-04-09,19,19,19,0,848,856,837,19,0
Lassen,16,2022-04-09,1,1,1,0,1301,1315,1296,19,1
Los Angeles,16,2022-04-09,6415,6486,6457,29,751020,759429,755995,3434,262
Madera,16,2022-04-09,28,28,27,1,3153,3188,3123,65,3
Marin,16,2022-04-09,188,189,186,3,5447,5508,5408,100,5
Mariposa,16,2022-04-09,7,7,7,0,245,249,244,5,0
Mendocino,16,2022-04-09,30,30,29,1,1152,1165,1132,33,0
Merced,16,2022-04-09,64,64,63,1,3306,3344,3285,59,10
Modoc,16,2022-04-09,1,1,1,0,50,50,49,1,0
Mono,16,2022-04-09,3,3,3,0,135,135,132,3,0
Monterey,16,2022-04-09,115,115,111,4,7161,7242,7014,228,12
Napa,16,2022-04-09,108,108,106,2,3081,3115,3064,51,2
Nevada,16,2022-04-09,34,34,33,1,1508,1525,1492,33,2
Orange,16,2022-04-09,1101,1113,1095,18,54491,55101,54208,893,79
Placer,16,2022-04-09,112,112,109,3,6221,6291,6147,144,23
Plumas,16,2022-04-09,5,5,5,0,260,263,257,6,0
Riverside,16,2022-04-09,724,732,717,15,37752,38174,37374,800,37
Sacramento,16,2022-04-09,480,486,478,8,31231,31580,31057,523,48
San Benito,16,2022-04-09,18,18,18,0,1186,1200,1184,16,0
San Bernardino,16,2022-04-09,815,826,816,10,41904,42372,41852,520,32
San Diego,16,2022-04-09,1820,1840,1830,10,73754,74580,74193,387,111
San Francisco,16,2022-04-09,1145,1157,1128,29,30151,30488,29738,750,27
San Joaquin,16,2022-04-09,231,232,228,4,15608,15782,15492,290,19
San Luis Obispo,16,2022-04-09,109,109,107,2,5012,5068,4995,73,2
San Mateo,16,2022-04-09,833,842,833,9,30505,30846,30510,336,6
Santa Barbara,16,2022-04-09,247,247,243,4,15188,15357,15102,255,9
Santa Clara,16,2022-04-09,1592,1610,1601,9,79314,80201,79774,427,89
Santa Cruz,16,2022-04-09,273,277,273,4,8149,8242,8136,106,6
Shasta,16,2022-04-09,19,19,19,0,3305,3342,3270,72,3
Siskiyou,16,2022-04-09,1,1,1,0,317,321,317,4,0
Solano,16,2022-04-09,218,219,215,4,9633,9742,9585,157,17
Sonoma,16,2022-04-09,397,403,396,7,10563,10681,10507,174,6
Stanislaus,16,2022-04-09,129,129,126,3,7865,7952,7746,206,21
Sutter,16,2022-04-09,23,23,23,0,1324,1338,1313,25,0
Tehama,16,2022-04-09,10,10,10,0,759,767,745,22,0
Trinity,16,2022-04-09,0,0,0,0,82,82,80,2,0
Tulare,16,2022-04-09,46,46,45,1,7907,7996,7781,215,7
Tuolumne,16,2022-04-09,16,16,16,0,1076,1089,1066,23,1
Ventura,16,2022-04-09,301,304,301,3,18086,18289,18098,191,20
Yolo,16,2022-04-09,94,94,93,1,18606,18814,18565,249,1
Yuba,16,2022-04-09,14,14,14,0,1074,1087,1069,18,4
Alameda,17,2022-04-16,1751,1773,1757,16,54528,55216,54720,496,41
Amador,17,2022-04-16,7,7,7,0,1135,1150,1132,18,2
Butte,17,2022-04-16,47,47,47,0,2048,2074,2058,16,5
Calaveras,17,2022-04-16,15,15,15,0,616,624,616,8,0
Colusa,17,2022-04-16,4,4,4,0,169,170,168,2,0
Contra Costa,17,2022-04-16,986,999,985,14,24948,25264,24906,358,29
Del Norte,17,2022-04-16,11,11,11,0,1022,1035,1022,13,0
El Dorado,17,2022-04-16,59,59,58,1,2359,2388,2354,34,0
Fresno,17,2022-04-16,196,196,193,3,13923,14099,13883,216,48
Glenn,17,2022-04-16,3,3,3,0,237,238,235,3,0
Humboldt,17,2022-04-16,79,79,78,1,1974,1998,1973,25,6
Imperial,17,2022-04-16,41,41,40,1,3378,3421,3373,48,3
Inyo,17,2022-04-16,0,0,0,0,152,152,150,2,0
Kern,17,2022-04-16,129,129,127,2,13373,13542,13372,170,19
Kings,17,2022-04-16,38,38,37,1,3615,3661,3606,55,2
Lake,17,2022-04-16,19,19,19,0,815,826,812,14,2
Lassen,17,2022-04-16,2,2,2,0,1317,1334,1319,15,0
Los Angeles,17,2022-04-16,7573,7669,7643,26,371132,375812,374539,1273,213
Madera,17,2022-04-16,23,23,23,0,2603,2637,2597,40,3
Marin,17,2022-04-16,282,285,281,4,6106,6184,6100,84,5
Mariposa,17,2022-04-16,11,11,11,0,257,260,256,4,0
Mendocino,17,2022-04-16,42,42,41,1,1303,1319,1291,28,4
Merced,17,2022-04-16,71,71,70,1,3158,3199,3157,42,9
Modoc,17,2022-04-16,1,1,1,0,36,37,36,1,0
Mono,17,2022-04-16,13,13,13,0,170,172,169,3,0
Monterey,17,2022-04-16,131,131,128,3,6342,6421,6269,152,6
Napa,17,2022-04-16,141,141,139,2,2697,2731,2698,33,1
Nevada,17,2022-04-16,42,42,41,1,1240,1256,1235,21,2
Orange,17,2022-04-16,1346,1363,1346,17,82374,83413,82401,1012,67
Placer,17,2022-04-16,153,153,150,3,4701,4761,4679,82,25
Plumas,17,2022-04-16,7,7,7,0,209,210,206,4,0
Riverside,17,2022-04-16,848,860,847,13,37162,37630,37040,590,45
Sacramento,17,2022-04-16,652,660,652,8,27828,28178,27830,348,53
San Benito,17,2022-04-16,24,24,24,0,1181,1195,1183,12,0
San Bernardino,17,2022-04-16,1021,1034,1025,9,39293,39789,39423,366,43
San Diego,17,2022-04-16,1879,1904,1897,7,68492,69356,69087,269,96
San Francisco,17,2022-04-16,1324,1341,1316,25,30543,30929,30360,569,32
San Joaquin,17,2022-04-16,220,221,218,3,14841,15027,14821,206,13
San Luis Obispo,17,2022-04-16,138,138,137,1,4860,4922,4870,52,3
San Mateo,17,2022-04-16,1054,1067,1058,9,29930,30308,30062,246,11
Santa Barbara,17,2022-04-16,330,335,331,4,14850,15038,14852,186,8
Santa Clara,17,2022-04-16,2027,2052,2044,8,74216,75150,74850,300,74
Santa Cruz,17,2022-04-16,409,413,409,4,12638,12796,12669,127,4
Shasta,17,2022-04-16,27,27,27,0,2836,2871,2825,46,4
Siskiyou,17,2022-04-16,4,4,4,0,325,328,325,3,1
Solano,17,2022-04-16,226,228,225,3,9056,9170,9060,110,10
Sonoma,17,2022-04-16,479,485,479,6,11405,11549,11408,141,15
Stanislaus,17,2022-04-16,147,147,144,3,7857,7956,7802,154,19
Sutter,17,2022-04-16,20,20,20,0,1181,1196,1180,16,0
Tehama,17,2022-04-16,7,7,7,0,649,657,643,14,1
Trinity,17,2022-04-16,0,0,0,0,69,69,68,1,0
Tulare,17,2022-04-16,72,72,71,1,6822,6908,6769,139,13
Tuolumne,17,2022-04-16,26,26,26,0,1060,1073,1056,17,0
Ventura,17,2022-04-16,356,361,358,3,15806,16004,15879,125,9
Yolo,17,2022-04-16,111,111,110,1,18753,18990,18802,188,2
Yuba,17,2022-04-16,21,21,21,0,1004,1017,1004,13,1
Alameda,18,2022-04-23,2241,2272,2257,15,55683,56485,56108,377,53
Amador,18,2022-04-23,18,18,18,0,1320,1339,1323,16,0
Butte,18,2022-04-23,38,38,38,0,2189,2220,2207,13,9
Calaveras,18,2022-04-23,22,22,22,0,611,620,614,6,0
Colusa,18,2022-04-23,3,3,3,0,175,177,175,2,0
Contra Costa,18,2022-04-23,1351,1369,1355,14,25376,25742,25470,272,31
Del Norte,18,2022-04-23,17,17,17,0,1068,1082,1072,10,1
El Dorado,18,2022-04-23,99,99,98,1,2663,2701,2673,28,0
Fresno,18,2022-04-23,327,332,328,4,15695,15921,15739,182,36
Glenn,18,2022-04-23,4,4,4,0,254,256,254,2,0
Humboldt,18,2022-04-23,169,170,168,2,2755,2795,2769,26,4
Imperial,18,2022-04-23,54,54,53,1,3366,3415,3379,36,5
Inyo,18,2022-04-23,6,6,6,0,183,185,184,1,2
Kern,18,2022-04-23,217,221,219,2,16989,17232,17071,161,21
Kings,18,2022-04-23,54,54,53,1,4408,4472,4422,50,2
Lake,18,2022-04-23,15,15,15,0,795,806,796,10,2
Lassen,18,2022-04-23,0,0,0,0,1523,1544,1531,13,0
Los Angeles,18,2022-04-23,10696,10850,10823,27,854822,867119,864944,2175,218
Madera,18,2022-04-23,30,30,30,0,2828,2869,2836,33,2
Marin,18,2022-04-23,347,354,350,4,6082,6170,6108,62,9
Mariposa,18,2022-04-23,15,15,15,0,213,217,214,3,0
Mendocino,18,2022-04-23,64,64,63,1,1192,1210,1191,19,1
Merced,18,2022-04-23,86,86,85,1,2910,2952,2923,29,6
Modoc,18,2022-04-23,1,1,1,0,35,36,35,1,0
Mono,18,2022-04-23,4,4,4,0,88,88,87,1,0
Monterey,18,2022-04-23,251,254,250,4,7378,7483,7351,132,4
Napa,18,2022-04-23,204,206,204,2,3325,3372,3341,31,0
Nevada,18,2022-04-23,48,48,47,1,1345,1365,1348,17,3
Orange,18,2022-04-23,1813,1840,1823,17,83849,85058,84293,765,66
Placer,18,2022-04-23,207,209,206,3,5684,5767,5693,74,25
Plumas,18,2022-04-23,2,2,2,0,233,237,234,3,0
Riverside,18,2022-04-23,1184,1201,1187,14,38956,39517,39056,461,44
Sacramento,18,2022-04-23,921,933,924,9,30663,31104,30818,286,52
San Benito,18,2022-04-23,33,33,33,0,1134,1151,1142,9,0
San Bernardino,18,2022-04-23,1274,1292,1283,9,41872,42474,42184,290,31
San Diego,18,2022-04-23,2719,2759,2751,8,72408,73451,73240,211,97
San Francisco,18,2022-04-23,1817,1843,1818,25,31020,31468,31035,433,32
San Joaquin,18,2022-04-23,352,358,354,4,15214,15432,15274,158,13
San Luis Obispo,18,2022-04-23,190,191,189,2,4988,5060,5020,40,5
San Mateo,18,2022-04-23,1384,1402,1394,8,31636,32092,31898,194,19
Santa Barbara,18,2022-04-23,351,357,354,3,14664,14875,14738,137,7
Santa Clara,18,2022-04-23,2801,2841,2833,8,68868,69859,69653,206,83
Santa Cruz,18,2022-04-23,456,463,460,3,19435,19715,19574,141,2
Shasta,18,2022-04-23,50,50,49,1,3053,3097,3060,37,0
Siskiyou,18,2022-04-23,8,8,8,0,329,334,331,3,0
Solano,18,2022-04-23,405,411,407,4,10102,10247,10155,92,11
Sonoma,18,2022-04-23,625,634,628,6,11568,11734,11628,106,18
Stanislaus,18,2022-04-23,205,207,204,3,7441,7547,7438,109,21
Sutter,18,2022-04-23,33,33,33,0,1307,1326,1313,13,0
Tehama,18,2022-04-23,15,15,15,0,658,668,657,11,1
Trinity,18,2022-04-23,2,2,2,0,77,77,76,1,0
Tulare,18,2022-04-23,81,81,80,1,6943,7042,6936,106,12
Tuolumne,18,2022-04-23,34,34,34,0,1105,1120,1107,13,1
Ventura,18,2022-04-23,554,560,557,3,18620,18888,18778,110,16
Yolo,18,2022-04-23,184,185,184,1,18477,18745,18608,137,0
Yuba,18,2022-04-23,34,34,34,0,1084,1099,1089,10,1
Alameda,19,2022-04-30,3069,3120,3104,16,69152,70299,69947,352,43
Amador,19,2022-04-30,32,32,32,0,1344,1366,1354,12,0
Butte,19,2022-04-30,89,89,89,0,2284,2322,2312,10,4
Calaveras,19,2022-04-30,32,32,32,0,737,750,744,6,0
Colusa,19,2022-04-30,4,4,4,0,219,223,221,2,0
Contra Costa,19,2022-04-30,1689,1717,1703,14,28708,29186,28955,231,42
Del Norte,19,2022-04-30,37,37,37,0,1205,1224,1216,8,0
El Dorado,19,2022-04-30,115,115,114,1,2747,2792,2770,22,3
Fresno,19,2022-04-30,455,462,458,4,16944,17225,17078,147,39
Glenn,19,2022-04-30,4,4,4,0,244,246,244,2,0
Humboldt,19,2022-04-30,203,207,206,1,2908,2955,2934,21,7
Imperial,19,2022-04-30,110,110,109,1,3707,3767,3737,30,2
Inyo,19,2022-04-30,5,5,5,0,207,211,210,1,0
Kern,19,2022-04-30,277,282,280,2,17908,18205,18077,128,15
Kings,19,2022-04-30,45,45,45,0,4736,4814,4774,40,3
Lake,19,2022-04-30,28,28,28,0,1023,1040,1030,10,1
Lassen,19,2022-04-30,9,9,9,0,1606,1633,1623,10,0
Los Angeles,19,2022-04-30,13679,13907,13881,26,921381,936671,934917,1754,226
Madera,19,2022-04-30,67,67,66,1,3225,3279,3251,28,3
Marin,19,2022-04-30,381,388,385,3,6395,6501,6452,49,9
Mariposa,19,2022-04-30,7,7,7,0,239,244,242,2,0
Mendocino,19,2022-04-30,48,48,47,1,1259,1280,1265,15,0
Merced,19,2022-04-30,116,116,115,1,3249,3303,3279,24,6
Modoc,19,2022-04-30,0,0,0,0,44,45,44,1,0
Mono,19,2022-04-30,4,4,4,0,81,81,80,1,0
Monterey,19,2022-04-30,325,332,328,4,8330,8468,8355,113,8
Napa,19,2022-04-30,215,219,218,1,3492,3550,3526,24,5
Nevada,19,2022-04-30,69,69,68,1,1505,1530,1516,14,2
Orange,19,2022-04-30,2451,2492,2475,17,87791,89249,88648,601,83
Placer,19,2022-04-30,265,270,267,3,6280,6384,6323,61,27
Plumas,19,2022-04-30,7,7,7,0,253,257,254,3,0
Riverside,19,2022-04-30,1752,1781,1766,15,41932,42628,42256,372,41
Sacramento,19,2022-04-30,1234,1254,1245,9,32558,33098,32871,227,51
San Benito,19,2022-04-30,44,44,44,0,1203,1223,1216,7,0
San Bernardino,19,2022-04-30,1333,1356,1349,7,42632,43339,43118,221,37
San Diego,19,2022-04-30,3717,3779,3771,8,71457,72641,72485,156,97
San Francisco,19,2022-04-30,2282,2320,2296,24,35037,35620,35254,366,44
San Joaquin,19,2022-04-30,476,483,479,4,15176,15427,15309,118,17
San Luis Obispo,19,2022-04-30,254,257,255,2,5149,5234,5203,31,9
San Mateo,19,2022-04-30,1680,1707,1699,8,36023,36621,36456,165,20
Santa Barbara,19,2022-04-30,387,394,391,3,15587,15846,15737,109,9
Santa Clara,19,2022-04-30,3877,3942,3933,9,95280,96862,96649,213,86
Santa Cruz,19,2022-04-30,635,646,643,3,22270,22640,22519,121,3
Shasta,19,2022-04-30,60,60,59,1,3423,3480,3449,31,7
Siskiyou,19,2022-04-30,11,11,11,0,323,328,326,2,0
Solano,19,2022-04-30,572,582,578,4,11370,11558,11481,77,14
Sonoma,19,2022-04-30,763,776,771,5,12394,12601,12516,85,19
Stanislaus,19,2022-04-30,274,280,277,3,8274,8412,8321,91,20
Sutter,19,2022-04-30,48,48,48,0,1277,1297,1287,10,0
Tehama,19,2022-04-30,17,17,17,0,676,689,681,8,0
Trinity,19,2022-04-30,1,1,1,0,84,84,83,1,0
Tulare,19,2022-04-30,142,142,140,2,7123,7241,7160,81,10
Tuolumne,19,2022-04-30,81,81,80,1,1236,1256,1245,11,5
Ventura,19,2022-04-30,658,670,667,3,19477,19802,19716,86,16
Yolo,19,2022-04-30,240,244,243,1,19188,19507,19400,107,2
Yuba,19,2022-04-30,36,36,36,0,1041,1058,1051,7,2
Alameda,20,2022-05-07,3945,4023,4008,15,70078,71470,71205,265,68
Amador,20,2022-05-07,12,12,12,0,1400,1428,1419,9,0
Butte,20,2022-05-07,114,115,115,0,2380,2427,2419,8,4
Calaveras,20,2022-05-07,27,27,27,0,694,707,703,4,1
Colusa,20,2022-05-07,3,3,3,0,216,221,220,1,0
Contra Costa,20,2022-05-07,2347,2393,2379,14,30556,31162,30979,183,50
Del Norte,20,2022-05-07,42,42,42,0,1226,1251,1245,6,0
El Dorado,20,2022-05-07,169,173,172,1,2814,2869,2852,17,4
Fresno,20,2022-05-07,660,673,669,4,17890,18245,18129,116,32
Glenn,20,2022-05-07,6,6,6,0,229,232,231,1,0
Humboldt,20,2022-05-07,296,303,301,2,3267,3332,3315,17,4
Imperial,20,2022-05-07,108,108,107,1,3757,3831,3809,22,1
Inyo,20,2022-05-07,18,18,18,0,200,205,204,1,0
Kern,20,2022-05-07,424,433,431,2,18521,18888,18789,99,23
Kings,20,2022-05-07,88,88,87,1,4934,5032,5000,32,2
Lake,20,2022-05-07,30,30,30,0,1009,1029,1022,7,1
Lassen,20,2022-05-07,2,2,2,0,1681,1713,1705,8,0
Los Angeles,20,2022-05-07,17436,17782,17757,25,912667,930763,929467,1296,248
Madera,20,2022-05-07,129,130,129,1,3754,3830,3806,24,3
Marin,20,2022-05-07,638,651,647,4,7596,7747,7703,44,12
Mariposa,20,2022-05-07,25,25,25,0,271,278,276,2,0
Mendocino,20,2022-05-07,87,87,86,1,1236,1261,1250,11,1
Merced,20,2022-05-07,179,184,183,1,3425,3492,3473,19,5
Modoc,20,2022-05-07,2,2,2,0,38,39,38,1,0
Mono,20,2022-05-07,10,10,10,0,126,127,126,1,0
Monterey,20,2022-05-07,433,441,437,4,9205,9388,9295,93,8
Napa,20,2022-05-07,228,233,232,1,3251,3317,3300,17,2
Nevada,20,2022-05-07,100,100,99,1,1637,1669,1658,11,3
Orange,20,2022-05-07,3331,3396,3379,17,90844,92647,92183,464,108
Placer,20,2022-05-07,465,474,471,3,6703,6835,6786,49,27
Plumas,20,2022-05-07,13,13,13,0,275,280,278,2,0
Riverside,20,2022-05-07,2357,2404,2388,16,44934,45824,45526,298,43
Sacramento,20,2022-05-07,1962,2001,1991,10,36289,37008,36819,189,70
San Benito,20,2022-05-07,62,62,62,0,1433,1461,1455,6,0
San Bernardino,20,2022-05-07,1757,1791,1784,7,45264,46161,45986,175,38
San Diego,20,2022-05-07,4902,4999,4991,8,85771,87472,87332,140,94
San Francisco,20,2022-05-07,2834,2890,2868,22,37441,38185,37892,293,52
San Joaquin,20,2022-05-07,677,691,687,4,15785,16098,16007,91,14
San Luis Obispo,20,2022-05-07,286,292,291,1,5194,5296,5273,23,2
San Mateo,20,2022-05-07,2147,2190,2183,7,36737,37465,37339,126,27
Santa Barbara,20,2022-05-07,585,597,594,3,15279,15581,15501,80,14
Santa Clara,20,2022-05-07,5421,5528,5519,9,102417,104447,104276,171,110
Santa Cruz,20,2022-05-07,692,705,702,3,23026,23484,23391,93,5
Shasta,20,2022-05-07,93,93,92,1,3457,3525,3501,24,7
Siskiyou,20,2022-05-07,14,14,14,0,292,298,297,1,0
Solano,20,2022-05-07,798,815,811,4,12187,12427,12365,62,19
Sonoma,20,2022-05-07,1143,1167,1161,6,13907,14182,14110,72,23
Stanislaus,20,2022-05-07,387,393,390,3,8632,8803,8732,71,27
Sutter,20,2022-05-07,44,44,44,0,1523,1553,1544,9,0
Tehama,20,2022-05-07,25,25,25,0,692,705,699,6,1
Trinity,20,2022-05-07,2,2,2,0,68,68,67,1,0
Tulare,20,2022-05-07,173,176,175,1,7588,7737,7672,65,12
Tuolumne,20,2022-05-07,80,80,79,1,1330,1356,1347,9,1
Ventura,20,2022-05-07,1054,1075,1072,3,20973,21390,21321,69,16
Yolo,20,2022-05-07,331,338,337,1,19401,19788,19708,80,1
Yuba,20,2022-05-07,63,63,63,0,1210,1235,1229,6,2
Alameda,21,2022-05-14,4688,4806,4793,13,73998,75868,75658,210,69
Amador,21,2022-05-14,45,45,45,0,1679,1721,1713,8,1
Butte,21,2022-05-14,157,162,162,0,2561,2626,2620,6,6
Calaveras,21,2022-05-14,36,36,36,0,745,765,762,3,2
Colusa,21,2022-05-14,5,5,5,0,202,207,206,1,0
Contra Costa,21,2022-05-14,3023,3099,3085,14,32139,32952,32807,145,55
Del Norte,21,2022-05-14,108,109,109,0,1745,1790,1783,7,0
El Dorado,21,2022-05-14,231,237,236,1,3012,3088,3075,13,6
Fresno,21,2022-05-14,949,973,968,5,18856,19334,19242,92,44
Glenn,21,2022-05-14,12,12,12,0,244,251,250,1,0
Humboldt,21,2022-05-14,280,287,286,1,3199,3280,3267,13,10
Imperial,21,2022-05-14,197,203,202,1,4187,4293,4274,19,4
Inyo,21,2022-05-14,20,20,20,0,226,232,231,1,1
Kern,21,2022-05-14,564,578,576,2,19458,19948,19871,77,20
Kings,21,2022-05-14,164,169,168,1,5253,5386,5361,25,0
Lake,21,2022-05-14,57,57,57,0,1122,1151,1145,6,0
Lassen,21,2022-05-14,14,14,14,0,1683,1724,1718,6,0
Los Angeles,21,2022-05-14,19871,20375,20354,21,924789,948133,947150,983,318
Madera,21,2022-05-14,169,174,173,1,3588,3678,3661,17,3
Marin,21,2022-05-14,726,746,743,3,8053,8257,8222,35,11
Mariposa,21,2022-05-14,27,27,27,0,349,357,355,2,0
Mendocino,21,2022-05-14,97,97,96,1,1322,1356,1347,9,2
Merced,21,2022-05-14,260,266,265,1,3807,3903,3887,16,8
Modoc,21,2022-05-14,2,2,2,0,39,40,39,1,0
Mono,21,2022-05-14,9,9,9,0,116,118,117,1,0
Monterey,21,2022-05-14,489,502,498,4,9402,9638,9567,71,10
Napa,21,2022-05-14,291,298,297,1,3495,3583,3570,13,3
Nevada,21,2022-05-14,134,138,137,1,1837,1883,1874,9,3
Orange,21,2022-05-14,4139,4245,4229,16,93161,95520,95164,356,88
Placer,21,2022-05-14,620,636,633,3,7350,7535,7495,40,37
Plumas,21,2022-05-14,41,41,41,0,256,262,261,1,1
Riverside,21,2022-05-14,2933,3009,2995,14,46325,47496,47266,230,59
Sacramento,21,2022-05-14,2793,2864,2853,11,38374,39345,39195,150,71
San Benito,21,2022-05-14,99,100,100,0,1523,1560,1555,5,3
San Bernardino,21,2022-05-14,2236,2293,2287,6,47382,48580,48443,137,47
San Diego,21,2022-05-14,6045,6200,6193,7,91902,94225,94113,112,111
San Francisco,21,2022-05-14,3318,3401,3381,20,38728,39706,39478,228,63
San Joaquin,21,2022-05-14,1103,1130,1125,5,17907,18359,18282,77,12
San Luis Obispo,21,2022-05-14,349,358,357,1,5771,5916,5897,19,2
San Mateo,21,2022-05-14,2638,2704,2697,7,39410,40406,40305,101,37
Santa Barbara,21,2022-05-14,781,801,798,3,16391,16804,16740,64,10
Santa Clara,21,2022-05-14,6636,6805,6797,8,109558,112324,112187,137,124
Santa Cruz,21,2022-05-14,883,905,902,3,24848,25476,25401,75,4
Shasta,21,2022-05-14,116,118,117,1,3726,3818,3799,19,6
Siskiyou,21,2022-05-14,19,19,19,0,383,394,393,1,1
Solano,21,2022-05-14,1076,1105,1101,4,13284,13620,13569,51,24
Sonoma,21,2022-05-14,1433,1469,1464,5,15219,15604,15545,59,23
Stanislaus,21,2022-05-14,638,655,651,4,9649,9891,9832,59,35
Sutter,21,2022-05-14,102,102,102,0,1753,1797,1789,8,0
Tehama,21,2022-05-14,22,22,22,0,799,819,814,5,2
Trinity,21,2022-05-14,5,5,5,0,68,69,68,1,0
Tulare,21,2022-05-14,294,301,299,2,7838,8036,7986,50,11
Tuolumne,21,2022-05-14,93,94,94,0,1442,1478,1471,7,2
Ventura,21,2022-05-14,1367,1400,1397,3,22943,23525,23468,57,25
Yolo,21,2022-05-14,463,476,475,1,21372,21916,21850,66,2
Yuba,21,2022-05-14,105,106,106,0,1251,1283,1278,5,2
Alameda,22,2022-05-21,5488,5681,5669,12,75979,78655,78493,162,92
Amador,22,2022-05-21,69,70,70,0,1573,1627,1621,6,0
Butte,22,2022-05-21,262,272,272,0,2722,2817,2812,5,7
Calaveras,22,2022-05-21,58,59,59,0,763,790,788,2,0
Colusa,22,2022-05-21,6,6,6,0,223,232,231,1,0
Contra Costa,22,2022-05-21,3769,3901,3888,13,34585,35804,35687,117,76
Del Norte,22,2022-05-21,120,122,122,0,1566,1619,1614,5,0
El Dorado,22,2022-05-21,329,341,340,1,3300,3416,3405,11,4
Fresno,22,2022-05-21,1521,1574,1568,6,21013,21754,21677,77,66
Glenn,22,2022-05-21,17,17,17,0,274,283,282,1,0
Humboldt,22,2022-05-21,242,250,249,1,2864,2964,2955,9,13
Imperial,22,2022-05-21,306,316,315,1,4625,4786,4771,15,4
Inyo,22,2022-05-21,26,26,26,0,236,244,243,1,0
Kern,22,2022-05-21,911,943,940,3,20264,20974,20913,61,39
Kings,22,2022-05-21,249,258,257,1,5611,5807,5787,20,0
Lake,22,2022-05-21,79,81,81,0,1235,1278,1273,5,0
Lassen,22,2022-05-21,32,32,32,0,1704,1764,1760,4,0
Los Angeles,22,2022-05-21,25627,26535,26515,20,931908,964618,963874,744,385
Madera,22,2022-05-21,207,213,212,1,3737,3869,3855,14,2
Marin,22,2022-05-21,830,858,855,3,8830,9141,9112,29,16
Mariposa,22,2022-05-21,32,32,32,0,335,346,345,1,0
Mendocino,22,2022-05-21,137,143,142,1,1618,1676,1668,8,5
Merced,22,2022-05-21,412,426,425,1,4133,4279,4266,13,3
Modoc,22,2022-05-21,2,2,2,0,42,43,42,1,0
Mono,22,2022-05-21,16,16,16,0,148,155,154,1,0
Monterey,22,2022-05-21,650,673,669,4,9636,9971,9916,55,11
Napa,22,2022-05-21,298,309,308,1,3968,4109,4097,12,5
Nevada,22,2022-05-21,152,157,156,1,1830,1896,1889,7,1
Orange,22,2022-05-21,5318,5505,5490,15,95314,98673,98398,275,112
Placer,22,2022-05-21,877,908,904,4,7912,8189,8157,32,39
Plumas,22,2022-05-21,43,43,43,0,256,265,264,1,0
Riverside,22,2022-05-21,4233,4384,4368,16,50693,52477,52288,189,79
Sacramento,22,2022-05-21,3737,3870,3859,11,40673,42101,41981,120,116
San Benito,22,2022-05-21,157,163,163,0,1560,1614,1610,4,0
San Bernardino,22,2022-05-21,3046,3153,3146,7,49163,50894,50787,107,51
San Diego,22,2022-05-21,8542,8844,8836,8,102051,105638,105545,93,142
San Francisco,22,2022-05-21,3686,3815,3799,16,41383,42843,42660,183,94
San Joaquin,22,2022-05-21,1471,1522,1517,5,20346,21058,20992,66,26
San Luis Obispo,22,2022-05-21,588,609,608,1,6880,7123,7106,17,11
San Mateo,22,2022-05-21,3090,3199,3193,6,40433,41851,41773,78,47
Santa Barbara,22,2022-05-21,1076,1114,1111,3,17926,18556,18503,53,20
Santa Clara,22,2022-05-21,7771,8046,8039,7,111403,115307,115202,105,129
Santa Cruz,22,2022-05-21,515,532,531,1,7980,8259,8241,18,13
Shasta,22,2022-05-21,178,183,182,1,3552,3675,3661,14,7
Siskiyou,22,2022-05-21,21,21,21,0,338,350,349,1,1
Solano,22,2022-05-21,1409,1458,1454,4,14193,14692,14651,41,27
Sonoma,22,2022-05-21,1542,1594,1590,4,16205,16776,16729,47,36
Stanislaus,22,2022-05-21,860,889,885,4,10436,10800,10752,48,42
Sutter,22,2022-05-21,136,140,140,0,1797,1860,1854,6,0
Tehama,22,2022-05-21,66,67,67,0,746,773,769,4,1
Trinity,22,2022-05-21,4,4,4,0,88,92,91,1,0
Tulare,22,2022-05-21,535,555,552,3,9001,9314,9271,43,22
Tuolumne,22,2022-05-21,174,181,180,1,1587,1643,1637,6,1
Ventura,22,2022-05-21,1886,1953,1950,3,24020,24865,24820,45,36
Yolo,22,2022-05-21,565,585,584,1,22306,23096,23044,52,2
Yuba,22,2022-05-21,153,159,159,0,1430,1481,1477,4,6
Alameda,23,2022-05-28,5496,5855,5846,9,73477,78185,78064,121,97
Amador,23,2022-05-28,98,104,104,0,1290,1373,1369,4,1
Butte,23,2022-05-28,296,317,317,0,3130,3333,3329,4,14
Calaveras,23,2022-05-28,53,57,57,0,722,768,766,2,0
Colusa,23,2022-05-28,8,8,8,0,207,220,219,1,0
Contra Costa,23,2022-05-28,3654,3887,3877,10,34043,36249,36161,88,77
Del Norte,23,2022-05-28,48,51,51,0,1128,1202,1199,3,2
El Dorado,23,2022-05-28,374,398,397,1,3438,3658,3649,9,6
Fresno,23,2022-05-28,1825,1944,1939,5,22083,23511,23449,62,64
Glenn,23,2022-05-28,29,30,30,0,310,328,327,1,2
Humboldt,23,2022-05-28,214,228,228,0,2803,2982,2976,6,13
Imperial,23,2022-05-28,371,397,396,1,4948,5273,5260,13,4
Inyo,23,2022-05-28,26,27,27,0,197,211,210,1,0
Kern,23,2022-05-28,1191,1268,1265,3,21147,22499,22450,49,31
Kings,23,2022-05-28,329,351,350,1,5365,5706,5691,15,3
Lake,23,2022-05-28,105,110,110,0,1151,1225,1222,3,0
Lassen,23,2022-05-28,60,64,64,0,1846,1962,1958,4,1
Los Angeles,23,2022-05-28,28623,30475,30457,18,911420,969723,969165,558,438
Madera,23,2022-05-28,264,281,280,1,3720,3963,3953,10,6
Marin,23,2022-05-28,730,777,775,2,8374,8918,8897,21,16
Mariposa,23,2022-05-28,35,37,37,0,344,367,366,1,0
Mendocino,23,2022-05-28,141,150,149,1,1434,1527,1521,6,4
Merced,23,2022-05-28,431,460,459,1,4073,4335,4325,10,6
Modoc,23,2022-05-28,5,5,5,0,45,48,47,1,0
Mono,23,2022-05-28,8,8,8,0,126,135,134,1,0
Monterey,23,2022-05-28,588,626,623,3,8844,9399,9360,39,11
Napa,23,2022-05-28,318,339,338,1,3751,3994,3986,8,5
Nevada,23,2022-05-28,180,191,190,1,1953,2079,2073,6,2
Orange,23,2022-05-28,6076,6474,6461,13,94723,100869,100660,209,129
Placer,23,2022-05-28,847,903,900,3,7338,7808,7785,23,54
Plumas,23,2022-05-28,35,35,35,0,258,274,273,1,1
Riverside,23,2022-05-28,4343,4624,4612,12,51556,54872,54724,148,99
Sacramento,23,2022-05-28,4198,4472,4463,9,38921,41429,41341,88,142
San Benito,23,2022-05-28,176,188,188,0,1554,1653,1650,3,0
San Bernardino,23,2022-05-28,3643,3877,3871,6,49152,52326,52244,82,63
San Diego,23,2022-05-28,9087,9683,9677,6,100097,106532,106462,70,189
San Francisco,23,2022-05-28,3365,3585,3574,11,38327,40809,40679,130,88
San Joaquin,23,2022-05-28,1494,1589,1585,4,19974,21239,21189,50,37
San Luis Obispo,23,2022-05-28,751,798,797,1,6865,7298,7285,13,14
San Mateo,23,2022-05-28,3054,3251,3246,5,37823,40233,40177,56,40
Santa Barbara,23,2022-05-28,1106,1177,1174,3,17276,18387,18348,39,32
Santa Clara,23,2022-05-28,7626,8119,8113,6,100013,106366,106294,72,161
Santa Cruz,23,2022-05-28,519,554,553,1,7454,7926,7913,13,8
Shasta,23,2022-05-28,165,177,177,0,3496,3712,3702,10,11
Siskiyou,23,2022-05-28,51,54,54,0,379,402,401,1,3
Solano,23,2022-05-28,1255,1337,1334,3,13183,14035,14006,29,45
Sonoma,23,2022-05-28,1362,1451,1448,3,15553,16553,16518,35,46
Stanislaus,23,2022-05-28,855,910,907,3,10382,11039,11002,37,58
Sutter,23,2022-05-28,159,169,169,0,1953,2076,2071,5,0
Tehama,23,2022-05-28,46,49,49,0,820,873,870,3,4
Trinity,23,2022-05-28,5,5,5,0,97,104,103,1,0
Tulare,23,2022-05-28,621,661,659,2,9042,9610,9577,33,20
Tuolumne,23,2022-05-28,112,119,119,0,1531,1631,1627,4,2
Ventura,23,2022-05-28,1878,2000,1997,3,22872,24345,24312,33,38
Yolo,23,2022-05-28,541,578,577,1,20815,22184,22147,37,3
Yuba,23,2022-05-28,151,161,161,0,1430,1523,1520,3,11
Alameda,24,2022-06-04,6406,14168,14151,17,76791,162537,162344,193,118
Amador,24,2022-06-04,55,143,143,0,1825,4588,4578,10,3
Butte,24,2022-06-04,366,964,963,1,3470,8062,8054,8,26
Calaveras,24,2022-06-04,45,136,136,0,739,1567,1564,3,0
Colusa,24,2022-06-04,17,39,39,0,254,584,583,1,3
Contra Costa,24,2022-06-04,3990,9447,9429,18,37191,84068,83909,159,97
Del Norte,24,2022-06-04,54,127,127,0,1185,2217,2213,4,1
El Dorado,24,2022-06-04,375,947,945,2,3644,7990,7975,15,9
Fresno,24,2022-06-04,2202,5383,5372,11,23657,56914,56798,116,100
Glenn,24,2022-06-04,40,169,169,0,346,840,839,1,3
Humboldt,24,2022-06-04,243,540,539,1,2958,6112,6102,10,15
Imperial,24,2022-06-04,354,726,725,1,4998,10145,10126,19,5
Inyo,24,2022-06-04,15,21,21,0,175,412,411,1,0
Kern,24,2022-06-04,1353,2960,2955,5,22951,43771,43698,73,45
Kings,24,2022-06-04,393,768,766,2,5971,11898,11874,24,8
Lake,24,2022-06-04,137,383,382,1,1223,2929,2923,6,5
Lassen,24,2022-06-04,78,186,186,0,2513,4381,4375,6,1
Los Angeles,24,2022-06-04,30995,63260,63232,28,546972,722829,722507,322,540
Madera,24,2022-06-04,297,815,813,2,4036,9322,9303,19,5
Marin,24,2022-06-04,690,1842,1839,3,8210,20067,20031,36,11
Mariposa,24,2022-06-04,76,139,139,0,435,1072,1070,2,0
Mendocino,24,2022-06-04,170,444,443,1,1709,4249,4237,12,9
Merced,24,2022-06-04,394,896,894,2,4420,9161,9145,16,11
Modoc,24,2022-06-04,8,11,11,0,46,88,87,1,0
Mono,24,2022-06-04,11,30,30,0,123,371,370,1,0
Monterey,24,2022-06-04,865,2248,2241,7,11052,24230,24153,77,22
Napa,24,2022-06-04,429,1140,1138,2,4075,9658,9642,16,10
Nevada,24,2022-06-04,229,503,502,1,2060,4100,4091,9,5
Orange,24,2022-06-04,7476,16249,16223,26,72382,156628,156376,252,138
Placer,24,2022-06-04,780,1850,1846,4,7456,16614,16576,38,79
Plumas,24,2022-06-04,28,43,43,0,315,654,652,2,0
Riverside,24,2022-06-04,4655,10684,10662,22,55117,117706,117461,245,107
Sacramento,24,2022-06-04,4769,11564,11545,19,43561,95501,95345,156,146
San Benito,24,2022-06-04,272,566,565,1,2158,4692,4686,6,0
San Bernardino,24,2022-06-04,4389,9158,9147,11,54546,110864,110729,135,88
San Diego,24,2022-06-04,10479,22665,22653,12,101109,218642,218531,111,207
San Francisco,24,2022-06-04,3536,9218,9195,23,41512,102342,102090,252,89
San Joaquin,24,2022-06-04,1845,4185,4177,8,21013,44317,44237,80,46
San Luis Obispo,24,2022-06-04,820,1730,1728,2,7589,15419,15397,22,13
San Mateo,24,2022-06-04,3155,7569,7561,8,39779,88937,88842,95,32
Santa Barbara,24,2022-06-04,1307,3023,3018,5,16907,36726,36666,60,23
Santa Clara,24,2022-06-04,8217,22087,22075,12,109076,240474,240348,126,180
Santa Cruz,24,2022-06-04,623,1735,1733,2,8735,18591,18567,24,17
Shasta,24,2022-06-04,160,277,276,1,4611,7179,7164,15,11
Siskiyou,24,2022-06-04,39,101,101,0,469,1059,1058,1,2
Solano,24,2022-06-04,1499,3686,3680,6,14418,33039,32986,53,33
Sonoma,24,2022-06-04,1494,3997,3991,6,14732,35466,35409,57,42
Stanislaus,24,2022-06-04,1059,2538,2531,7,11391,24420,24357,63,55
Sutter,24,2022-06-04,208,650,649,1,2270,4997,4988,9,0
Tehama,24,2022-06-04,66,105,105,0,918,1686,1681,5,1
Trinity,24,2022-06-04,10,45,45,0,110,281,280,1,0
Tulare,24,2022-06-04,724,1573,1569,4,10373,19812,19759,53,27
Tuolumne,24,2022-06-04,114,318,317,1,1839,4193,4184,9,2
Ventura,24,2022-06-04,1758,4184,4180,4,26448,57178,57119,59,48
Yolo,24,2022-06-04,579,1332,1330,2,22562,51777,51709,68,2
Yuba,24,2022-06-04,154,445,444,1,1597,3846,3840,6,6
