county,time,date,cases,est_cases,est_omicron_cases,est_other_cases,tests,est_tests,est_omicron_tests,est_other_tests,hospitalizations
Alameda,1,2021-12-25,5406,5420,2691,2729,83118,83342,41002,42340,117
Amador,1,2021-12-25,75,75,27,48,1474,1478,528,950,4
Butte,1,2021-12-25,347,347,188,159,3808,3818,2034,1784,31
Calaveras,1,2021-12-25,72,72,29,43,965,967,381,586,2
Colusa,1,2021-12-25,15,15,6,9,239,239,97,142,2
Contra Costa,1,2021-12-25,3259,3268,1254,2014,43046,43162,16371,26791,66
Del Norte,1,2021-12-25,20,20,9,11,1225,1230,524,706,0
El Dorado,1,2021-12-25,384,384,150,234,4121,4132,1582,2550,12
Fresno,1,2021-12-25,1525,1530,559,971,22566,22625,8176,14449,168
Glenn,1,2021-12-25,37,37,15,22,412,412,170,242,0
Humboldt,1,2021-12-25,334,334,139,195,3141,3149,1277,1872,11
Imperial,1,2021-12-25,658,658,254,404,5432,5446,2090,3356,51
Inyo,1,2021-12-25,81,81,39,42,419,419,196,223,0
Kern,1,2021-12-25,1201,1205,497,708,19628,19680,8036,11644,99
Kings,1,2021-12-25,352,352,131,221,5355,5367,1958,3409,20
Lake,1,2021-12-25,43,43,15,28,1144,1148,398,750,0
Lassen,1,2021-12-25,19,19,9,10,2322,2329,1060,1269,0
Los Angeles,1,2021-12-25,66246,66425,48168,18257,659863,661633,477613,184020,1005
Madera,1,2021-12-25,209,209,77,132,4152,4163,1508,2655,18
Marin,1,2021-12-25,1159,1161,460,701,14384,14423,5684,8739,6
Mariposa,1,2021-12-25,31,31,11,20,504,504,183,321,0
Mendocino,1,2021-12-25,86,86,25,61,2497,2503,715,1788,6
Merced,1,2021-12-25,428,428,172,256,4860,4873,1940,2933,18
Modoc,1,2021-12-25,5,5,2,3,57,57,24,33,2
Mono,1,2021-12-25,93,93,30,63,356,356,111,245,1
Monterey,1,2021-12-25,723,723,197,526,12220,12252,3274,8978,36
Napa,1,2021-12-25,559,559,237,322,5566,5580,2341,3239,5
Nevada,1,2021-12-25,204,204,72,132,2513,2519,871,1648,6
Orange,1,2021-12-25,10758,10788,4571,6217,106590,106875,44795,62080,274
Placer,1,2021-12-25,911,911,311,600,10314,10341,3467,6874,92
Plumas,1,2021-12-25,11,11,4,7,395,395,141,254,0
Riverside,1,2021-12-25,9285,9311,3359,5952,76506,76711,27302,49409,389
Sacramento,1,2021-12-25,3375,3385,1413,1972,47931,48060,19830,28230,180
San Benito,1,2021-12-25,204,204,96,108,2097,2101,978,1123,5
San Bernardino,1,2021-12-25,8847,8870,4363,4507,79721,79936,38895,41041,449
San Diego,1,2021-12-25,17458,17505,12195,5310,156995,157414,109162,48252,371
San Francisco,1,2021-12-25,5593,5608,1804,3804,62128,62295,19914,42381,36
San Joaquin,1,2021-12-25,1556,1562,616,946,20818,20873,8109,12764,78
San Luis Obispo,1,2021-12-25,718,718,326,392,10144,10172,4569,5603,22
San Mateo,1,2021-12-25,3545,3555,1865,1690,50458,50594,26281,24313,30
Santa Barbara,1,2021-12-25,1417,1423,596,827,13837,13875,5714,8161,37
Santa Clara,1,2021-12-25,6164,6180,4281,1899,97866,98128,67457,30671,134
Santa Cruz,1,2021-12-25,654,654,315,339,11583,11614,5505,6109,14
Shasta,1,2021-12-25,197,197,71,126,4589,4603,1618,2985,37
Siskiyou,1,2021-12-25,15,15,7,8,344,344,161,183,0
Solano,1,2021-12-25,835,836,354,482,15109,15150,6369,8781,44
Sonoma,1,2021-12-25,1325,1328,561,767,18923,18973,7901,11072,16
Stanislaus,1,2021-12-25,882,882,278,604,10381,10408,3230,7178,116
Sutter,1,2021-12-25,177,177,70,107,2013,2017,787,1230,0
Tehama,1,2021-12-25,64,64,19,45,1047,1050,302,748,11
Trinity,1,2021-12-25,3,3,1,2,96,96,32,64,0
Tulare,1,2021-12-25,561,561,172,389,10434,10462,3137,7325,48
Tuolumne,1,2021-12-25,133,133,49,84,1743,1748,631,1117,5
Ventura,1,2021-12-25,3578,3588,1912,1676,34019,34110,17979,16131,83
Yolo,1,2021-12-25,542,542,258,284,20050,20104,9415,10689,8
Yuba,1,2021-12-25,116,116,49,67,1501,1505,623,882,13
Alameda,2,2022-01-01,13881,13921,7906,6015,102092,102388,57963,44425,181
Amador,2,2022-01-01,148,148,64,84,1850,1855,798,1057,8
Butte,2,2022-01-01,894,894,545,349,5682,5700,3455,2245,30
Calaveras,2,2022-01-01,170,170,80,90,1148,1152,539,613,3
Colusa,2,2022-01-01,53,53,25,28,299,299,143,156,4
Contra Costa,2,2022-01-01,11111,11143,5052,6091,59677,59849,27035,32814,113
Del Norte,2,2022-01-01,61,61,31,30,1963,1968,980,988,0
El Dorado,2,2022-01-01,1002,1004,462,542,5333,5347,2444,2903,17
Fresno,2,2022-01-01,5030,5045,2194,2851,34833,34935,15143,19792,209
Glenn,2,2022-01-01,68,68,33,35,517,517,251,266,0
Humboldt,2,2022-01-01,721,721,348,373,4664,4677,2249,2428,10
Imperial,2,2022-01-01,1498,1503,687,816,8205,8229,3756,4473,57
Inyo,2,2022-01-01,207,207,112,95,598,598,324,274,3
Kern,2,2022-01-01,4269,4282,2081,2201,30062,30148,14523,15625,126
Kings,2,2022-01-01,872,872,384,488,7435,7456,3263,4193,17
Lake,2,2022-01-01,144,144,61,83,1470,1474,616,858,2
Lassen,2,2022-01-01,45,45,24,21,2511,2517,1325,1192,2
Los Angeles,2,2022-01-01,175102,175609,136674,38935,911779,914423,711265,203158,1933
Madera,2,2022-01-01,660,660,289,371,5686,5702,2475,3227,19
Marin,2,2022-01-01,2212,2218,1027,1191,17588,17639,8147,9492,25
Mariposa,2,2022-01-01,73,73,32,41,533,534,232,302,0
Mendocino,2,2022-01-01,325,325,115,210,2901,2910,1020,1890,6
Merced,2,2022-01-01,1223,1227,580,647,7403,7423,3510,3913,22
Modoc,2,2022-01-01,11,11,6,5,52,52,26,26,0
Mono,2,2022-01-01,170,170,64,106,386,387,146,241,2
Monterey,2,2022-01-01,1975,1980,658,1322,17496,17547,5801,11746,29
Napa,2,2022-01-01,1518,1522,749,773,10129,10159,4993,5166,10
Nevada,2,2022-01-01,468,468,199,269,2183,2190,925,1265,6
Orange,2,2022-01-01,39388,39502,19497,20005,199474,200052,98518,101534,540
Placer,2,2022-01-01,2379,2386,977,1409,14037,14078,5709,8369,142
Plumas,2,2022-01-01,36,36,16,20,352,352,151,201,2
Riverside,2,2022-01-01,26628,26705,11461,15244,125613,125977,53838,72139,578
Sacramento,2,2022-01-01,11290,11324,5540,5784,71511,71717,34938,36779,271
San Benito,2,2022-01-01,618,618,333,285,3032,3042,1640,1402,5
San Bernardino,2,2022-01-01,27955,28036,15762,12274,122893,123251,69182,54069,668
San Diego,2,2022-01-01,53209,53362,40221,13141,229966,230632,173654,56978,645
San Francisco,2,2022-01-01,9652,9680,3759,5921,74983,75200,29113,46087,89
San Joaquin,2,2022-01-01,5515,5531,2578,2953,32321,32415,14990,17425,98
San Luis Obispo,2,2022-01-01,2118,2122,1110,1012,14800,14842,7766,7076,19
San Mateo,2,2022-01-01,8993,9019,5350,3669,67504,67699,40076,27623,41
Santa Barbara,2,2022-01-01,4182,4193,2048,2145,22302,22367,10893,11474,57
Santa Clara,2,2022-01-01,17643,17694,13277,4417,134008,134396,100558,33838,224
Santa Cruz,2,2022-01-01,1857,1863,1031,832,15280,15323,8413,6910,21
Shasta,2,2022-01-01,438,438,188,250,5442,5459,2310,3149,13
Siskiyou,2,2022-01-01,57,57,31,26,456,456,247,209,0
Solano,2,2022-01-01,3490,3499,1732,1767,24087,24156,11914,12242,77
Sonoma,2,2022-01-01,3695,3706,1824,1882,27935,28015,13713,14302,30
Stanislaus,2,2022-01-01,2632,2639,1009,1630,15970,16015,6061,9954,129
Sutter,2,2022-01-01,402,402,188,214,2617,2624,1216,1408,0
Tehama,2,2022-01-01,169,169,61,108,1173,1177,414,763,4
Trinity,2,2022-01-01,9,9,4,5,101,101,40,61,0
Tulare,2,2022-01-01,1604,1610,598,1012,14668,14709,5396,9313,55
Tuolumne,2,2022-01-01,284,284,124,160,1902,1908,827,1081,6
Ventura,2,2022-01-01,11374,11407,6867,4540,55650,55811,33495,22316,129
Yolo,2,2022-01-01,1621,1626,890,736,25313,25386,13750,11636,10
Yuba,2,2022-01-01,358,358,177,181,2056,2061,1010,1051,22
Alameda,3,2022-01-08,31039,31136,19955,11181,191103,191700,122741,68959,338
Amador,3,2022-01-08,374,374,189,185,2778,2788,1400,1388,6
Butte,3,2022-01-08,1927,1934,1309,625,10000,10031,6780,3251,47
Calaveras,3,2022-01-08,454,454,249,205,2435,2442,1330,1112,2
Colusa,3,2022-01-08,78,78,44,34,658,658,363,295,5
Contra Costa,3,2022-01-08,18926,18985,10025,8960,102127,102446,54133,48313,204
Del Norte,3,2022-01-08,161,161,93,68,3855,3868,2241,1627,2
El Dorado,3,2022-01-08,2116,2122,1131,991,8873,8899,4739,4160,18
Fresno,3,2022-01-08,12029,12066,6169,5897,57987,58167,29669,28498,306
Glenn,3,2022-01-08,181,181,103,78,872,875,492,383,2
Humboldt,3,2022-01-08,1412,1417,791,626,8252,8278,4622,3656,16
Imperial,3,2022-01-08,3425,3436,1828,1608,13756,13799,7336,6463,74
Inyo,3,2022-01-08,392,392,240,152,1243,1247,766,481,4
Kern,3,2022-01-08,10964,10998,6146,4852,55469,55642,31025,24617,191
Kings,3,2022-01-08,1949,1955,1006,949,11902,11940,6131,5809,22
Lake,3,2022-01-08,455,455,224,231,2672,2681,1317,1364,2
Lassen,3,2022-01-08,119,119,72,47,3627,3638,2173,1465,2
Los Angeles,3,2022-01-08,333463,334505,276484,58021,1908960,1914929,1583034,331895,3510
Madera,3,2022-01-08,1702,1708,877,831,10067,10098,5151,4947,29
Marin,3,2022-01-08,3077,3087,1666,1421,21674,21741,11747,9994,30
Mariposa,3,2022-01-08,181,181,92,89,1104,1109,566,543,0
Mendocino,3,2022-01-08,807,807,342,465,5478,5495,2324,3171,7
Merced,3,2022-01-08,3159,3170,1744,1426,13337,13378,7345,6033,39
Modoc,3,2022-01-08,16,16,9,7,95,95,54,41,0
Mono,3,2022-01-08,261,261,118,143,841,842,383,459,1
Monterey,3,2022-01-08,4464,4478,1798,2680,32076,32177,12879,19298,65
Napa,3,2022-01-08,2692,2701,1528,1173,14847,14894,8418,6476,15
Nevada,3,2022-01-08,1104,1108,551,557,4900,4916,2430,2486,15
Orange,3,2022-01-08,61440,61633,34971,26662,312984,313962,178354,135608,934
Placer,3,2022-01-08,4813,4829,2332,2497,21301,21366,10288,11078,180
Plumas,3,2022-01-08,120,120,60,60,784,786,393,393,4
Riverside,3,2022-01-08,47545,47693,23997,23696,185242,185821,93480,92341,893
Sacramento,3,2022-01-08,26572,26654,15037,11617,119994,120369,67770,52599,424
San Benito,3,2022-01-08,964,968,592,376,4320,4334,2653,1681,6
San Bernardino,3,2022-01-08,47377,47524,30172,17352,188405,188992,120030,68962,961
San Diego,3,2022-01-08,85948,86216,69405,16811,343332,344403,277274,67129,986
San Francisco,3,2022-01-08,16269,16320,7518,8802,121369,121748,56202,65546,158
San Joaquin,3,2022-01-08,12924,12965,6996,5969,59812,59999,32317,27682,158
San Luis Obispo,3,2022-01-08,4269,4284,2569,1715,21779,21847,13086,8761,41
San Mateo,3,2022-01-08,15104,15151,10038,5113,114145,114500,75806,38694,109
Santa Barbara,3,2022-01-08,8331,8357,4693,3664,45770,45913,25806,20107,77
Santa Clara,3,2022-01-08,34985,35094,28105,6989,262209,263028,210682,52346,432
Santa Cruz,3,2022-01-08,4357,4370,2728,1642,41798,41929,26144,15785,18
Shasta,3,2022-01-08,990,992,496,496,8244,8270,4121,4149,57
Siskiyou,3,2022-01-08,106,106,65,41,869,870,531,339,5
Solano,3,2022-01-08,6545,6565,3747,2818,35746,35858,20428,15430,103
Sonoma,3,2022-01-08,8376,8401,4767,3634,46915,47061,26624,20437,73
Stanislaus,3,2022-01-08,5955,5974,2716,3258,27070,27154,12296,14858,184
Sutter,3,2022-01-08,1089,1092,592,500,4671,4684,2524,2160,0
Tehama,3,2022-01-08,460,460,197,263,2393,2400,1020,1380,12
Trinity,3,2022-01-08,32,32,15,17,263,263,125,138,0
Tulare,3,2022-01-08,4322,4334,1923,2411,22498,22568,9957,12611,65
Tuolumne,3,2022-01-08,702,702,357,345,4033,4046,2053,1993,14
Ventura,3,2022-01-08,17627,17683,11875,5808,87041,87312,58641,28671,233
Yolo,3,2022-01-08,3960,3972,2453,1519,50694,50852,31389,19463,8
Yuba,3,2022-01-08,925,927,526,401,3807,3819,2161,1658,35
Alameda,4,2022-01-15,26992,27085,19081,8004,185873,186512,131385,55127,442
Amador,4,2022-01-15,492,492,284,208,3823,3836,2207,1629,9
Butte,4,2022-01-15,2115,2122,1564,558,9636,9668,7114,2554,58
Calaveras,4,2022-01-15,612,612,376,236,2724,2732,1681,1051,5
Colusa,4,2022-01-15,165,165,103,62,799,802,498,304,2
Contra Costa,4,2022-01-15,16560,16616,9968,6648,95667,95997,57612,38385,261
Del Norte,4,2022-01-15,201,201,129,72,3970,3982,2548,1434,3
El Dorado,4,2022-01-15,2178,2186,1316,870,9015,9045,5451,3594,16
Fresno,4,2022-01-15,16755,16812,9805,7007,68093,68328,39802,28526,446
Glenn,4,2022-01-15,306,306,194,112,1061,1065,674,391,2
Humboldt,4,2022-01-15,1259,1264,792,472,8891,8922,5604,3318,37
Imperial,4,2022-01-15,3742,3755,2262,1493,14317,14367,8666,5701,94
Inyo,4,2022-01-15,397,397,269,128,1238,1242,842,400,3
Kern,4,2022-01-15,13181,13228,8304,4924,59456,59660,37433,22227,264
Kings,4,2022-01-15,3496,3508,2054,1454,16569,16625,9743,6882,46
Lake,4,2022-01-15,589,589,333,256,3189,3199,1812,1387,4
Lassen,4,2022-01-15,279,279,186,93,3783,3797,2529,1268,1
Los Angeles,4,2022-01-15,249883,250742,216607,34135,1800629,1806823,1561785,245038,4673
Madera,4,2022-01-15,2428,2437,1425,1012,11171,11209,6539,4670,38
Marin,4,2022-01-15,2677,2686,1642,1044,19355,19421,11883,7538,37
Mariposa,4,2022-01-15,189,189,109,80,1227,1232,717,515,0
Mendocino,4,2022-01-15,983,987,490,497,5575,5594,2773,2821,25
Merced,4,2022-01-15,4142,4158,2577,1581,14974,15026,9307,5719,53
Modoc,4,2022-01-15,10,10,6,4,110,110,70,40,0
Mono,4,2022-01-15,235,235,123,112,856,859,454,405,1
Monterey,4,2022-01-15,6066,6087,2885,3202,30168,30270,14283,15987,75
Napa,4,2022-01-15,2193,2201,1397,804,13379,13425,8520,4905,24
Nevada,4,2022-01-15,1319,1324,751,573,5720,5739,3251,2488,23
Orange,4,2022-01-15,47122,47283,30091,17192,282138,283106,180378,102728,1223
Placer,4,2022-01-15,4744,4760,2631,2129,21335,21408,11833,9575,222
Plumas,4,2022-01-15,186,186,106,80,806,808,460,348,4
Riverside,4,2022-01-15,45478,45634,26251,19383,182743,183371,105582,77789,1047
Sacramento,4,2022-01-15,23556,23637,14955,8682,111627,112009,70848,41161,545
San Benito,4,2022-01-15,944,947,640,307,4434,4450,3016,1434,8
San Bernardino,4,2022-01-15,42239,42383,29602,12781,181706,182331,127539,54792,1145
San Diego,4,2022-01-15,67474,67706,57334,10372,286881,287866,243860,44006,1230
San Francisco,4,2022-01-15,11800,11840,6332,5508,100550,100896,53972,46924,243
San Joaquin,4,2022-01-15,14281,14329,8717,5612,65095,65316,39732,25584,245
San Luis Obispo,4,2022-01-15,4101,4117,2745,1372,22530,22608,15074,7534,44
San Mateo,4,2022-01-15,13883,13930,10085,3845,109048,109421,79222,30199,126
Santa Barbara,4,2022-01-15,7602,7628,4811,2817,44892,45048,28439,16609,123
Santa Clara,4,2022-01-15,31572,31679,26707,4972,252852,253718,213935,39783,516
Santa Cruz,4,2022-01-15,4369,4383,3022,1361,45079,45235,31210,14025,35
Shasta,4,2022-01-15,1315,1320,758,562,9712,9745,5573,4172,83
Siskiyou,4,2022-01-15,158,158,107,51,1043,1046,706,340,5
Solano,4,2022-01-15,7020,7044,4515,2529,38497,38630,24736,13894,146
Sonoma,4,2022-01-15,8149,8178,5199,2979,46853,47014,29882,17132,96
Stanislaus,4,2022-01-15,7649,7674,4034,3640,30905,31011,16270,14741,234
Sutter,4,2022-01-15,1370,1375,838,537,5157,5176,3151,2025,0
Tehama,4,2022-01-15,634,634,316,318,2606,2614,1299,1315,15
Trinity,4,2022-01-15,43,43,23,20,272,272,148,124,0
Tulare,4,2022-01-15,7583,7609,3918,3691,28155,28252,14518,13734,98
Tuolumne,4,2022-01-15,940,943,548,395,4438,4453,2582,1871,9
Ventura,4,2022-01-15,13862,13910,10170,3740,76328,76590,56019,20571,346
Yolo,4,2022-01-15,3086,3096,2115,981,43889,44040,30131,13909,18
Yuba,4,2022-01-15,1105,1109,703,406,4013,4027,2550,1477,57
Alameda,5,2022-01-22,20457,20536,15646,4890,161679,162312,123790,38522,484
Amador,5,2022-01-22,561,562,364,198,4340,4357,2827,1530,11
Butte,5,2022-01-22,1953,1961,1549,412,8698,8732,6896,1836,88
Calaveras,5,2022-01-22,594,595,406,189,2441,2452,1675,777,7
Colusa,5,2022-01-22,160,160,110,50,810,813,560,253,5
Contra Costa,5,2022-01-22,13206,13257,8858,4399,81277,81596,54609,26987,331
Del Norte,5,2022-01-22,298,298,211,87,3830,3845,2709,1136,2
El Dorado,5,2022-01-22,1545,1551,1041,510,7237,7264,4881,2383,28
Fresno,5,2022-01-22,17596,17665,11506,6159,67817,68081,44374,23707,578
Glenn,5,2022-01-22,252,252,176,76,927,931,649,282,0
Humboldt,5,2022-01-22,981,986,684,302,7465,7494,5206,2288,22
Imperial,5,2022-01-22,3542,3557,2392,1165,12806,12858,8647,4211,85
Inyo,5,2022-01-22,158,158,117,41,609,611,451,160,1
Kern,5,2022-01-22,10694,10736,7461,3275,50520,50718,35268,15450,322
Kings,5,2022-01-22,4083,4098,2686,1412,16943,17008,11161,5847,43
Lake,5,2022-01-22,683,684,435,249,3178,3191,2020,1171,9
Lassen,5,2022-01-22,432,432,315,117,3492,3506,2549,957,1
Los Angeles,5,2022-01-22,171755,172429,154369,18060,1532570,1538593,1378563,160030,4730
Madera,5,2022-01-22,2757,2769,1811,958,11431,11477,7491,3986,58
Marin,5,2022-01-22,1958,1966,1335,631,17031,17098,11627,5471,60
Mariposa,5,2022-01-22,149,149,97,52,940,944,615,329,0
Mendocino,5,2022-01-22,963,967,551,416,4821,4840,2759,2081,22
Merced,5,2022-01-22,3176,3189,2189,1000,12392,12440,8546,3894,65
Modoc,5,2022-01-22,16,16,11,5,104,104,73,31,0
Mono,5,2022-01-22,97,97,58,39,462,462,276,186,1
Monterey,5,2022-01-22,5326,5347,2917,2430,31409,31532,17235,14297,108
Napa,5,2022-01-22,1704,1709,1198,511,11814,11860,8323,3537,24
Nevada,5,2022-01-22,1044,1049,669,380,4755,4774,3040,1734,26
Orange,5,2022-01-22,29967,30084,21110,8974,225842,226727,159546,67181,1181
Placer,5,2022-01-22,3827,3843,2402,1441,18217,18288,11432,6856,275
Plumas,5,2022-01-22,219,219,140,79,883,888,566,322,6
Riverside,5,2022-01-22,33701,33833,21847,11986,156234,156847,101415,55432,1096
Sacramento,5,2022-01-22,17920,17989,12565,5424,94895,95268,66610,28658,654
San Benito,5,2022-01-22,853,857,633,224,3958,3973,2940,1033,8
San Bernardino,5,2022-01-22,28485,28596,21664,6932,147874,148455,112618,35837,1235
San Diego,5,2022-01-22,53876,54087,47686,6401,247067,248037,218781,29256,1348
San Francisco,5,2022-01-22,8879,8914,5395,3519,86771,87111,52892,34219,291
San Joaquin,5,2022-01-22,11241,11286,7639,3647,56092,56312,38118,18194,308
San Luis Obispo,5,2022-01-22,3595,3609,2629,980,20758,20841,15197,5644,51
San Mateo,5,2022-01-22,9291,9329,7264,2065,90614,90969,70994,19975,177
Santa Barbara,5,2022-01-22,6568,6594,4599,1995,41114,41276,28817,12459,142
Santa Clara,5,2022-01-22,23368,23458,20612,2846,220206,221069,194354,26715,546
Santa Cruz,5,2022-01-22,5314,5335,4014,1321,48507,48699,36708,11991,43
Shasta,5,2022-01-22,1449,1454,935,519,9453,9489,6096,3393,87
Siskiyou,5,2022-01-22,156,156,115,41,816,819,603,216,6
Solano,5,2022-01-22,5041,5061,3570,1491,30893,31015,21876,9139,166
Sonoma,5,2022-01-22,7216,7243,5083,2160,41260,41423,29075,12348,106
Stanislaus,5,2022-01-22,6688,6714,4014,2700,27831,27939,16706,11233,315
Sutter,5,2022-01-22,1109,1114,754,360,4982,5000,3387,1613,0
Tehama,5,2022-01-22,577,577,329,248,2446,2455,1403,1052,20
Trinity,5,2022-01-22,66,66,41,25,311,311,192,119,0
Tulare,5,2022-01-22,7850,7881,4625,3256,28371,28483,16725,11758,136
Tuolumne,5,2022-01-22,889,893,581,312,3587,3601,2345,1256,17
Ventura,5,2022-01-22,9885,9924,7802,2122,64460,64714,50942,13772,362
Yolo,5,2022-01-22,2312,2321,1726,595,38319,38470,28677,9793,24
Yuba,5,2022-01-22,940,944,660,284,3728,3742,2617,1125,68
Alameda,6,2022-01-29,12508,12561,10172,2389,143343,143957,116666,27291,451
Amador,6,2022-01-29,365,365,259,106,3264,3278,2331,947,19
Butte,6,2022-01-29,1273,1278,1065,213,7911,7944,6620,1324,102
Calaveras,6,2022-01-29,281,281,208,73,1919,1926,1428,498,4
Colusa,6,2022-01-29,118,118,88,30,685,688,514,174,2
Contra Costa,6,2022-01-29,8234,8269,6014,2255,72225,72533,52890,19643,295
Del Norte,6,2022-01-29,357,357,271,86,4128,4146,3154,992,9
El Dorado,6,2022-01-29,840,844,617,227,6180,6205,4545,1660,20
Fresno,6,2022-01-29,12089,12140,8664,3476,58433,58683,41895,16788,603
Glenn,6,2022-01-29,209,209,158,51,763,766,578,188,4
Humboldt,6,2022-01-29,614,614,461,153,6164,6189,4653,1536,26
Imperial,6,2022-01-29,2548,2560,1869,691,12271,12323,9021,3302,103
Inyo,6,2022-01-29,66,66,52,14,507,508,400,108,4
Kern,6,2022-01-29,6411,6439,4839,1600,43960,44147,33213,10934,309
Kings,6,2022-01-29,2776,2789,1997,792,15067,15131,10841,4290,53
Lake,6,2022-01-29,558,559,389,170,3391,3405,2378,1027,10
Lassen,6,2022-01-29,347,347,272,75,3643,3658,2852,806,5
Los Angeles,6,2022-01-29,88247,88626,81453,7173,1338877,1344604,1236599,108005,3997
Madera,6,2022-01-29,1818,1826,1305,521,9844,9887,7060,2827,58
Marin,6,2022-01-29,1223,1229,907,322,14265,14326,10585,3741,48
Mariposa,6,2022-01-29,106,106,76,30,867,872,624,248,0
Mendocino,6,2022-01-29,541,543,346,197,3602,3618,2310,1308,14
Merced,6,2022-01-29,2291,2301,1712,589,10959,11006,8202,2804,64
Modoc,6,2022-01-29,12,12,9,3,98,98,74,24,2
Mono,6,2022-01-29,42,42,28,14,344,344,230,114,0
Monterey,6,2022-01-29,3862,3878,2389,1489,26896,27011,16659,10352,121
Napa,6,2022-01-29,1126,1131,857,274,9855,9896,7500,2396,25
Nevada,6,2022-01-29,677,679,475,204,4139,4157,2910,1247,30
Orange,6,2022-01-29,14326,14389,10912,3477,185297,186089,141396,44693,979
Placer,6,2022-01-29,2580,2590,1784,806,15849,15916,10978,4938,232
Plumas,6,2022-01-29,154,154,108,46,750,754,528,226,2
Riverside,6,2022-01-29,19162,19243,13613,5630,127209,127754,90603,37151,1001
Sacramento,6,2022-01-29,11745,11795,8902,2893,81546,81896,61910,19986,602
San Benito,6,2022-01-29,527,528,417,111,3368,3383,2679,704,7
San Bernardino,6,2022-01-29,15497,15563,12542,3021,122426,122950,99280,23670,1027
San Diego,6,2022-01-29,29251,29376,26678,2698,193231,194059,176327,17732,1237
San Francisco,6,2022-01-29,4945,4966,3329,1637,75165,75486,50834,24652,267
San Joaquin,6,2022-01-29,6457,6485,4771,1714,45315,45509,33490,12019,312
San Luis Obispo,6,2022-01-29,2304,2313,1806,507,17372,17446,13640,3806,67
San Mateo,6,2022-01-29,5101,5124,4223,901,79526,79867,65933,13934,161
Santa Barbara,6,2022-01-29,4285,4303,3241,1062,36540,36696,27691,9005,117
Santa Clara,6,2022-01-29,15905,15973,14474,1499,209912,210810,191160,19650,554
Santa Cruz,6,2022-01-29,3542,3557,2848,709,46903,47105,37834,9271,45
Shasta,6,2022-01-29,1081,1086,765,321,8676,8714,6143,2571,90
Siskiyou,6,2022-01-29,125,125,99,26,699,701,553,148,13
Solano,6,2022-01-29,4154,4172,3183,989,29982,30111,22950,7161,175
Sonoma,6,2022-01-29,4219,4237,3206,1031,33733,33877,25671,8206,103
Stanislaus,6,2022-01-29,4093,4110,2729,1381,22826,22924,15241,7683,340
Sutter,6,2022-01-29,702,703,518,185,3939,3955,2913,1042,0
Tehama,6,2022-01-29,406,406,259,147,2159,2167,1385,782,22
Trinity,6,2022-01-29,39,39,27,12,221,221,150,71,0
Tulare,6,2022-01-29,5359,5383,3521,1862,24535,24639,16132,8507,152
Tuolumne,6,2022-01-29,827,831,591,240,3418,3434,2447,987,19
Ventura,6,2022-01-29,5571,5595,4643,952,55428,55666,46252,9414,321
Yolo,6,2022-01-29,1567,1574,1249,325,37787,37949,30227,7722,21
Yuba,6,2022-01-29,611,612,462,150,3073,3087,2334,753,86
Alameda,7,2022-02-05,6826,6858,5833,1025,121430,122016,103927,18089,378
Amador,7,2022-02-05,239,239,182,57,3060,3076,2356,720,16
Butte,7,2022-02-05,863,868,755,113,6582,6615,5757,858,90
Calaveras,7,2022-02-05,212,212,168,44,1565,1572,1245,327,2
Colusa,7,2022-02-05,89,89,71,18,569,572,455,117,4
Contra Costa,7,2022-02-05,4511,4534,3547,987,57648,57924,45371,12553,261
Del Norte,7,2022-02-05,240,240,195,45,3891,3909,3165,744,7
El Dorado,7,2022-02-05,501,502,394,108,5151,5175,4065,1110,29
Fresno,7,2022-02-05,7110,7144,5497,1647,45949,46170,35556,10614,577
Glenn,7,2022-02-05,138,138,111,27,641,643,517,126,4
Humboldt,7,2022-02-05,492,493,395,98,5034,5059,4060,999,22
Imperial,7,2022-02-05,1282,1289,1011,278,8893,8935,7018,1917,81
Inyo,7,2022-02-05,52,52,43,9,448,449,374,75,3
Kern,7,2022-02-05,3903,3922,3147,775,36332,36508,29315,7193,233
Kings,7,2022-02-05,1509,1517,1170,347,10783,10835,8368,2467,57
Lake,7,2022-02-05,383,383,289,94,2746,2760,2088,672,9
Lassen,7,2022-02-05,156,156,129,27,3202,3218,2657,561,5
Los Angeles,7,2022-02-05,43697,43908,41203,2705,1182029,1187741,1115233,72508,2971
Madera,7,2022-02-05,1232,1238,953,285,8417,8458,6517,1941,56
Marin,7,2022-02-05,718,721,571,150,12080,12138,9604,2534,33
Mariposa,7,2022-02-05,56,56,43,13,624,627,483,144,0
Mendocino,7,2022-02-05,353,353,249,104,2985,2999,2109,890,18
Merced,7,2022-02-05,1333,1339,1065,274,8425,8466,6746,1720,64
Modoc,7,2022-02-05,22,22,18,4,159,159,129,30,3
Mono,7,2022-02-05,46,46,33,13,270,270,197,73,0
Monterey,7,2022-02-05,2481,2493,1702,791,23043,23154,15811,7343,96
Napa,7,2022-02-05,791,795,642,153,8029,8068,6516,1552,23
Nevada,7,2022-02-05,394,394,299,95,3287,3304,2505,799,27
Orange,7,2022-02-05,7339,7375,5963,1412,156182,156936,127058,29878,640
Placer,7,2022-02-05,1519,1527,1142,385,12794,12856,9620,3236,201
Plumas,7,2022-02-05,99,99,75,24,575,577,436,141,1
Riverside,7,2022-02-05,9441,9488,7258,2230,100179,100662,77097,23565,759
Sacramento,7,2022-02-05,6894,6927,5583,1344,66324,66645,53736,12909,525
San Benito,7,2022-02-05,332,332,277,55,2818,2832,2367,465,8
San Bernardino,7,2022-02-05,7937,7976,6764,1212,94378,94833,80515,14318,742
San Diego,7,2022-02-05,15747,15823,14718,1105,158227,158991,147945,11046,1017
San Francisco,7,2022-02-05,2646,2659,1952,707,57579,57858,42546,15312,233
San Joaquin,7,2022-02-05,3794,3813,3009,804,38102,38285,30223,8062,256
San Luis Obispo,7,2022-02-05,1429,1435,1188,247,13453,13518,11196,2322,41
San Mateo,7,2022-02-05,2843,2857,2467,390,64200,64510,55743,8767,134
Santa Barbara,7,2022-02-05,2703,2716,2185,531,33543,33705,27147,6558,105
Santa Clara,7,2022-02-05,9140,9183,8525,658,179009,179874,167054,12820,481
Santa Cruz,7,2022-02-05,2096,2106,1776,330,39281,39470,33284,6186,38
Shasta,7,2022-02-05,730,734,560,174,7223,7257,5529,1728,81
Siskiyou,7,2022-02-05,103,103,86,17,704,707,589,118,8
Solano,7,2022-02-05,2521,2533,2050,483,24719,24838,20131,4707,135
Sonoma,7,2022-02-05,2310,2321,1875,446,28054,28189,22776,5413,80
Stanislaus,7,2022-02-05,2799,2813,2044,769,19664,19759,14355,5404,300
Sutter,7,2022-02-05,429,429,338,91,3482,3499,2762,737,0
Tehama,7,2022-02-05,327,327,230,97,1720,1727,1214,513,24
Trinity,7,2022-02-05,24,24,18,6,151,151,111,40,0
Tulare,7,2022-02-05,3135,3150,2259,891,18694,18783,13484,5299,165
Tuolumne,7,2022-02-05,404,405,311,94,2680,2693,2071,622,13
Ventura,7,2022-02-05,3003,3018,2620,398,43480,43690,37941,5749,249
Yolo,7,2022-02-05,916,922,773,149,32575,32733,27479,5254,14
Yuba,7,2022-02-05,388,388,312,76,2520,2533,2042,491,60
Alameda,8,2022-02-12,3992,4014,3551,463,103063,103599,91716,11883,289
Amador,8,2022-02-12,112,112,91,21,2427,2440,1988,452,15
Butte,8,2022-02-12,539,540,486,54,5547,5576,5020,556,78
Calaveras,8,2022-02-12,114,114,95,19,1319,1326,1109,217,6
Colusa,8,2022-02-12,46,46,39,7,518,521,438,83,3
Contra Costa,8,2022-02-12,2697,2710,2245,465,46549,46792,38812,7980,189
Del Norte,8,2022-02-12,253,253,215,38,3671,3690,3135,555,9
El Dorado,8,2022-02-12,302,302,251,51,4674,4699,3904,795,25
Fresno,8,2022-02-12,4264,4286,3505,781,37084,37277,30500,6777,510
Glenn,8,2022-02-12,60,60,51,9,480,481,407,74,4
Humboldt,8,2022-02-12,396,396,334,62,4504,4527,3826,701,19
Imperial,8,2022-02-12,697,701,581,120,6682,6717,5581,1136,70
Inyo,8,2022-02-12,28,28,24,4,409,410,357,53,2
Kern,8,2022-02-12,2402,2415,2042,373,30140,30297,25618,4679,210
Kings,8,2022-02-12,904,909,744,165,8410,8453,6927,1526,52
Lake,8,2022-02-12,260,260,210,50,2426,2439,1966,473,10
Lassen,8,2022-02-12,140,140,122,18,3018,3035,2624,411,3
Los Angeles,8,2022-02-12,24838,24967,23807,1160,1084120,1089774,1039464,50310,2203
Madera,8,2022-02-12,708,713,583,130,7087,7124,5830,1294,48
Marin,8,2022-02-12,427,427,357,70,10400,10453,8742,1711,31
Mariposa,8,2022-02-12,28,28,23,5,436,437,357,80,0
Mendocino,8,2022-02-12,234,234,178,56,2482,2496,1899,597,18
Merced,8,2022-02-12,852,857,720,137,7279,7317,6149,1168,47
Modoc,8,2022-02-12,21,21,18,3,189,189,160,29,0
Mono,8,2022-02-12,14,14,11,3,180,180,140,40,0
Monterey,8,2022-02-12,1441,1449,1076,373,18800,18898,14025,4873,89
Napa,8,2022-02-12,474,475,403,72,6888,6924,5879,1045,17
Nevada,8,2022-02-12,207,207,167,40,2702,2718,2194,524,20
Orange,8,2022-02-12,4467,4490,3819,671,136290,137000,116506,20494,462
Placer,8,2022-02-12,763,768,613,155,10568,10624,8497,2127,157
Plumas,8,2022-02-12,49,49,39,10,441,442,356,86,2
Riverside,8,2022-02-12,5388,5416,4410,1006,79675,80090,65255,14835,536
Sacramento,8,2022-02-12,3933,3952,3350,602,55917,56208,47680,8528,445
San Benito,8,2022-02-12,212,212,184,28,2309,2321,2025,296,7
San Bernardino,8,2022-02-12,4416,4440,3917,523,77413,77817,68719,9098,536
San Diego,8,2022-02-12,9531,9580,9073,507,132342,133034,126025,7009,767
San Francisco,8,2022-02-12,1823,1833,1442,391,49105,49362,38922,10440,198
San Joaquin,8,2022-02-12,2292,2305,1923,382,32462,32632,27216,5416,191
San Luis Obispo,8,2022-02-12,876,881,763,118,10686,10742,9307,1435,30
San Mateo,8,2022-02-12,1563,1571,1405,166,56675,56971,51000,5971,79
Santa Barbara,8,2022-02-12,1279,1286,1089,197,23530,23653,20059,3594,81
Santa Clara,8,2022-02-12,5444,5473,5176,297,159885,160718,152036,8682,387
Santa Cruz,8,2022-02-12,1174,1180,1035,145,34161,34339,30151,4188,33
Shasta,8,2022-02-12,507,508,412,96,6178,6211,5037,1174,86
Siskiyou,8,2022-02-12,79,79,69,10,589,591,513,78,5
Solano,8,2022-02-12,1368,1375,1171,204,20374,20479,17440,3039,104
Sonoma,8,2022-02-12,1370,1377,1168,209,23425,23547,19998,3549,61
Stanislaus,8,2022-02-12,1642,1650,1287,363,16394,16479,12869,3610,258
Sutter,8,2022-02-12,248,248,207,41,2994,3009,2511,498,0
Tehama,8,2022-02-12,194,194,148,46,1453,1459,1112,347,19
Trinity,8,2022-02-12,21,21,17,4,162,162,128,34,0
Tulare,8,2022-02-12,1790,1799,1390,409,16312,16398,12698,3700,151
Tuolumne,8,2022-02-12,221,221,180,41,2349,2363,1931,432,12
Ventura,8,2022-02-12,1807,1816,1631,185,38386,38586,34674,3912,200
Yolo,8,2022-02-12,598,600,524,76,28979,29130,25512,3618,15
Yuba,8,2022-02-12,246,246,208,38,2192,2205,1870,335,45
Alameda,9,2022-02-19,2250,2264,2063,201,90479,91015,83002,8013,227
Amador,9,2022-02-19,91,91,78,13,2160,2173,1859,314,9
Butte,9,2022-02-19,313,313,289,24,4630,4656,4302,354,72
Calaveras,9,2022-02-19,52,52,45,7,957,962,840,122,6
Colusa,9,2022-02-19,29,29,25,4,381,383,336,47,6
Contra Costa,9,2022-02-19,1639,1649,1428,221,39866,40102,34766,5336,146
Del Norte,9,2022-02-19,154,154,136,18,3067,3086,2728,358,9
El Dorado,9,2022-02-19,169,169,147,22,4003,4028,3499,529,10
Fresno,9,2022-02-19,2468,2482,2128,354,30252,30431,26112,4319,413
Glenn,9,2022-02-19,33,33,29,4,405,406,357,49,2
Humboldt,9,2022-02-19,236,236,208,28,3796,3818,3361,457,20
Imperial,9,2022-02-19,443,444,385,59,5310,5342,4644,698,47
Inyo,9,2022-02-19,13,13,12,1,379,381,343,38,1
Kern,9,2022-02-19,1403,1411,1242,169,25883,26036,22938,3098,124
Kings,9,2022-02-19,571,575,495,80,7347,7391,6359,1032,33
Lake,9,2022-02-19,225,225,191,34,2194,2207,1873,334,9
Lassen,9,2022-02-19,143,143,128,15,2379,2393,2142,251,4
Los Angeles,9,2022-02-19,14042,14125,13631,494,986005,991843,957378,34465,1476
Madera,9,2022-02-19,415,416,357,59,5895,5931,5090,841,42
Marin,9,2022-02-19,262,262,228,34,9940,10000,8729,1271,27
Mariposa,9,2022-02-19,20,20,17,3,408,409,351,58,0
Mendocino,9,2022-02-19,141,141,114,27,2244,2258,1830,428,10
Merced,9,2022-02-19,555,557,488,69,5981,6016,5271,745,38
Modoc,9,2022-02-19,10,10,9,1,72,72,64,8,1
Mono,9,2022-02-19,8,8,7,1,172,172,142,30,0
Monterey,9,2022-02-19,901,906,721,185,14923,15011,11938,3073,63
Napa,9,2022-02-19,303,303,267,36,5768,5802,5126,676,10
Nevada,9,2022-02-19,129,129,110,19,2374,2389,2029,360,21
Orange,9,2022-02-19,2859,2877,2543,334,126975,127724,112945,14779,360
Placer,9,2022-02-19,381,381,321,60,9382,9437,7958,1479,144
Plumas,9,2022-02-19,25,25,21,4,384,385,326,59,1
Riverside,9,2022-02-19,2957,2973,2540,433,67139,67537,57788,9749,380
Sacramento,9,2022-02-19,2377,2391,2109,282,48762,49050,43291,5759,342
San Benito,9,2022-02-19,133,133,120,13,2049,2062,1861,201,4
San Bernardino,9,2022-02-19,2305,2318,2109,209,65982,66373,60440,5933,380
San Diego,9,2022-02-19,5507,5541,5320,221,111116,111772,107322,4450,613
San Francisco,9,2022-02-19,1133,1140,949,191,45319,45588,38006,7582,144
San Joaquin,9,2022-02-19,1294,1301,1133,168,27652,27814,24229,3585,134
San Luis Obispo,9,2022-02-19,585,589,528,61,9113,9167,8223,944,26
San Mateo,9,2022-02-19,895,900,827,73,49776,50069,46050,4019,65
Santa Barbara,9,2022-02-19,754,758,668,90,21656,21783,19212,2571,58
Santa Clara,9,2022-02-19,3018,3036,2911,125,139673,140498,134765,5733,320
Santa Cruz,9,2022-02-19,665,670,607,63,28323,28491,25831,2660,24
Shasta,9,2022-02-19,323,323,275,48,5418,5450,4644,806,74
Siskiyou,9,2022-02-19,53,53,48,5,534,538,484,54,11
Solano,9,2022-02-19,773,778,688,90,16727,16827,14901,1926,88
Sonoma,9,2022-02-19,786,791,698,93,18959,19071,16849,2222,41
Stanislaus,9,2022-02-19,913,919,759,160,13531,13609,11264,2345,203
Sutter,9,2022-02-19,156,156,136,20,2410,2424,2111,313,0
Tehama,9,2022-02-19,120,120,97,23,1255,1262,1023,239,14
Trinity,9,2022-02-19,16,16,13,3,224,224,187,37,0
Tulare,9,2022-02-19,963,969,794,175,12440,12512,10273,2239,99
Tuolumne,9,2022-02-19,123,123,105,18,1956,1968,1686,282,7
Ventura,9,2022-02-19,1017,1024,945,79,30884,31068,28663,2405,137
Yolo,9,2022-02-19,334,334,302,32,24097,24241,21932,2309,11
Yuba,9,2022-02-19,159,159,140,19,1791,1802,1590,212,29
Alameda,10,2022-02-26,1483,1495,1395,100,68946,69432,64835,4597,164
Amador,10,2022-02-26,64,64,57,7,1993,2007,1786,221,10
Butte,10,2022-02-26,192,192,181,11,3990,4018,3787,231,48
Calaveras,10,2022-02-26,35,35,32,3,1064,1071,968,103,0
Colusa,10,2022-02-26,11,11,10,1,362,364,330,34,3
Contra Costa,10,2022-02-26,961,969,870,99,31615,31838,28609,3229,116
Del Norte,10,2022-02-26,88,88,80,8,2691,2709,2469,240,6
El Dorado,10,2022-02-26,113,113,101,12,3361,3384,3044,340,10
Fresno,10,2022-02-26,1345,1354,1206,148,25162,25339,22577,2762,288
Glenn,10,2022-02-26,20,20,18,2,376,378,343,35,0
Humboldt,10,2022-02-26,137,137,124,13,2765,2785,2530,255,8
Imperial,10,2022-02-26,261,261,235,26,4472,4504,4051,453,24
Inyo,10,2022-02-26,10,10,9,1,326,328,303,25,0
Kern,10,2022-02-26,883,889,808,81,22361,22518,20465,2053,101
Kings,10,2022-02-26,257,257,229,28,5893,5935,5295,640,21
Lake,10,2022-02-26,126,126,111,15,1808,1821,1609,212,3
Lassen,10,2022-02-26,59,59,54,5,1995,2008,1847,161,1
Los Angeles,10,2022-02-26,8471,8529,8306,223,924876,931392,907404,23988,1041
Madera,10,2022-02-26,204,204,182,22,4162,4191,3736,455,31
Marin,10,2022-02-26,146,146,132,14,7104,7153,6456,697,15
Mariposa,10,2022-02-26,34,34,30,4,324,325,289,36,0
Mendocino,10,2022-02-26,78,78,66,12,1713,1725,1471,254,10
Merced,10,2022-02-26,281,281,254,27,4724,4758,4308,450,31
Modoc,10,2022-02-26,6,6,5,1,50,50,45,5,1
Mono,10,2022-02-26,5,5,4,1,166,166,144,22,0
Monterey,10,2022-02-26,415,417,349,68,12741,12830,10776,2054,32
Napa,10,2022-02-26,173,173,158,15,4942,4977,4536,441,9
Nevada,10,2022-02-26,78,78,69,9,1985,1999,1768,231,12
Orange,10,2022-02-26,1853,1865,1700,165,114625,115430,105328,10102,254
Placer,10,2022-02-26,271,271,238,33,7933,7988,7019,969,115
Plumas,10,2022-02-26,26,26,23,3,342,343,302,41,0
Riverside,10,2022-02-26,1786,1799,1598,201,59322,59739,53100,6639,279
Sacramento,10,2022-02-26,1200,1208,1099,109,41219,41508,37796,3712,248
San Benito,10,2022-02-26,60,60,56,4,1583,1595,1477,118,1
San Bernardino,10,2022-02-26,1274,1282,1194,88,56432,56828,52977,3851,229
San Diego,10,2022-02-26,3381,3404,3302,102,93887,94545,91734,2811,461
San Francisco,10,2022-02-26,866,873,760,113,36440,36696,31982,4714,109
San Joaquin,10,2022-02-26,725,731,659,72,23399,23561,21239,2322,94
San Luis Obispo,10,2022-02-26,318,320,295,25,7643,7695,7095,600,17
San Mateo,10,2022-02-26,543,547,514,33,35218,35466,33326,2140,51
Santa Barbara,10,2022-02-26,412,413,376,37,19323,19459,17709,1750,45
Santa Clara,10,2022-02-26,1775,1787,1732,55,83547,84134,81581,2553,253
Santa Cruz,10,2022-02-26,479,481,447,34,23772,23940,22255,1685,19
Shasta,10,2022-02-26,173,173,153,20,4571,4602,4077,525,52
Siskiyou,10,2022-02-26,29,29,27,2,396,397,367,30,6
Solano,10,2022-02-26,483,488,445,43,14218,14319,13071,1248,78
Sonoma,10,2022-02-26,458,460,419,41,15053,15159,13815,1344,27
Stanislaus,10,2022-02-26,510,514,445,69,11907,11990,10389,1601,170
Sutter,10,2022-02-26,103,103,93,10,2209,2224,2006,218,0
Tehama,10,2022-02-26,58,58,49,9,1108,1115,950,165,10
Trinity,10,2022-02-26,6,6,5,1,111,111,97,14,0
Tulare,10,2022-02-26,510,513,441,72,11098,11175,9627,1548,86
Tuolumne,10,2022-02-26,82,82,73,9,1430,1441,1282,159,7
Ventura,10,2022-02-26,615,620,583,37,27317,27508,25903,1605,99
Yolo,10,2022-02-26,214,214,198,16,22504,22664,21037,1627,9
Yuba,10,2022-02-26,79,79,72,7,1703,1716,1561,155,20
Alameda,11,2022-03-05,1160,1170,1110,60,73797,74397,70622,3775,138
Amador,11,2022-03-05,75,75,69,6,1380,1391,1271,120,6
Butte,11,2022-03-05,134,134,128,6,3669,3699,3538,161,31
Calaveras,11,2022-03-05,29,29,27,2,1122,1130,1046,84,1
Colusa,11,2022-03-05,10,10,9,1,344,346,321,25,6
Contra Costa,11,2022-03-05,648,655,604,51,31779,32038,29534,2504,94
Del Norte,11,2022-03-05,54,54,50,4,1859,1874,1747,127,6
El Dorado,11,2022-03-05,91,91,84,7,3260,3286,3031,255,6
Fresno,11,2022-03-05,956,965,884,81,22833,23019,21086,1933,191
Glenn,11,2022-03-05,12,12,11,1,366,367,341,26,1
Humboldt,11,2022-03-05,110,110,102,8,3067,3093,2877,216,9
Imperial,11,2022-03-05,168,168,155,13,4470,4506,4159,347,21
Inyo,11,2022-03-05,9,9,8,1,371,373,351,22,1
Kern,11,2022-03-05,515,520,484,36,21593,21769,20245,1524,78
Kings,11,2022-03-05,165,165,151,14,5082,5124,4699,425,13
Lake,11,2022-03-05,69,69,63,6,1822,1836,1671,165,5
Lassen,11,2022-03-05,83,83,78,5,1824,1838,1725,113,0
Los Angeles,11,2022-03-05,6073,6121,6001,120,886833,894061,876587,17474,834
Madera,11,2022-03-05,131,131,120,11,4124,4157,3809,348,19
Marin,11,2022-03-05,169,169,156,13,7697,7761,7179,582,13
Mariposa,11,2022-03-05,14,14,13,1,304,305,279,26,0
Mendocino,11,2022-03-05,75,75,66,9,1772,1786,1581,205,10
Merced,11,2022-03-05,200,200,185,15,4671,4709,4368,341,25
Modoc,11,2022-03-05,1,1,1,0,52,52,48,4,0
Mono,11,2022-03-05,3,3,3,0,130,130,116,14,1
Monterey,11,2022-03-05,268,269,235,34,11525,11619,10162,1457,21
Napa,11,2022-03-05,200,200,186,14,5016,5056,4711,345,9
Nevada,11,2022-03-05,47,47,43,4,1755,1770,1612,158,5
Orange,11,2022-03-05,1335,1347,1256,91,109551,110444,103010,7434,200
Placer,11,2022-03-05,175,175,159,16,7852,7916,7176,740,96
Plumas,11,2022-03-05,4,4,4,0,274,275,249,26,0
Riverside,11,2022-03-05,1095,1104,1009,95,55148,55598,50836,4762,187
Sacramento,11,2022-03-05,844,851,792,59,40173,40499,37719,2780,177
San Benito,11,2022-03-05,37,37,35,2,1537,1550,1462,88,2
San Bernardino,11,2022-03-05,904,912,865,47,54010,54451,51637,2814,149
San Diego,11,2022-03-05,2512,2533,2476,57,96779,97567,95380,2187,330
San Francisco,11,2022-03-05,678,685,616,69,38171,38483,34643,3840,75
San Joaquin,11,2022-03-05,459,464,429,35,21403,21576,19938,1638,63
San Luis Obispo,11,2022-03-05,302,303,285,18,7481,7542,7091,451,9
San Mateo,11,2022-03-05,567,573,547,26,41691,42029,40087,1942,43
Santa Barbara,11,2022-03-05,220,220,205,15,18204,18351,17081,1270,26
Santa Clara,11,2022-03-05,1517,1529,1494,35,116399,117346,114641,2705,207
Santa Cruz,11,2022-03-05,343,345,326,19,25047,25250,23884,1366,19
Shasta,11,2022-03-05,145,145,132,13,4962,5003,4565,438,42
Siskiyou,11,2022-03-05,19,19,18,1,417,420,395,25,4
Solano,11,2022-03-05,386,390,364,26,13952,14067,13123,944,73
Sonoma,11,2022-03-05,375,378,352,26,15510,15636,14572,1064,30
Stanislaus,11,2022-03-05,315,317,284,33,11171,11262,10092,1170,122
Sutter,11,2022-03-05,87,87,80,7,2020,2037,1883,154,0
Tehama,11,2022-03-05,50,50,44,6,1201,1210,1071,139,8
Trinity,11,2022-03-05,6,6,5,1,111,111,100,11,0
Tulare,11,2022-03-05,349,351,313,38,10313,10396,9280,1116,48
Tuolumne,11,2022-03-05,54,54,49,5,1285,1297,1187,110,3
Ventura,11,2022-03-05,414,417,399,18,27234,27456,26238,1218,58
Yolo,11,2022-03-05,169,169,160,9,22592,22775,21515,1260,6
Yuba,11,2022-03-05,68,68,63,5,1618,1632,1520,112,18
Alameda,12,2022-03-12,962,971,934,37,68636,69290,66641,2649,101
Amador,12,2022-03-12,32,32,30,2,1460,1474,1377,97,5
Butte,12,2022-03-12,72,72,70,2,3445,3478,3364,114,19
Calaveras,12,2022-03-12,16,16,15,1,1052,1061,1001,60,1
Colusa,12,2022-03-12,6,6,6,0,253,254,240,14,2
Contra Costa,12,2022-03-12,586,592,557,35,29182,29461,27715,1746,59
Del Norte,12,2022-03-12,44,44,42,2,1466,1480,1404,76,5
El Dorado,12,2022-03-12,54,54,51,3,3048,3076,2895,181,8
Fresno,12,2022-03-12,614,620,580,40,21806,22014,20610,1404,159
Glenn,12,2022-03-12,17,17,16,1,320,321,304,17,1
Humboldt,12,2022-03-12,63,63,60,3,2777,2804,2655,149,5
Imperial,12,2022-03-12,89,89,84,5,4634,4677,4402,275,13
Inyo,12,2022-03-12,10,10,10,0,165,165,158,7,0
Kern,12,2022-03-12,315,318,301,17,20079,20271,19199,1072,60
Kings,12,2022-03-12,217,218,204,14,4834,4881,4574,307,16
Lake,12,2022-03-12,63,63,59,4,1599,1614,1503,111,0
Lassen,12,2022-03-12,25,25,24,1,1502,1517,1446,71,0
Los Angeles,12,2022-03-12,4310,4352,4288,64,847669,855773,843272,12501,571
Madera,12,2022-03-12,83,83,78,5,3713,3748,3509,239,21
Marin,12,2022-03-12,163,163,154,9,6639,6703,6322,381,14
Mariposa,12,2022-03-12,7,7,7,0,223,223,209,14,0
Mendocino,12,2022-03-12,41,41,37,4,1481,1494,1363,131,5
Merced,12,2022-03-12,144,144,136,8,4221,4261,4027,234,25
Modoc,12,2022-03-12,3,3,3,0,56,56,53,3,1
Mono,12,2022-03-12,2,2,2,0,106,106,97,9,0
Monterey,12,2022-03-12,181,181,163,18,10340,10438,9431,1007,17
Napa,12,2022-03-12,148,148,140,8,4290,4330,4106,224,7
Nevada,12,2022-03-12,51,51,48,3,1588,1604,1495,109,3
Orange,12,2022-03-12,934,942,894,48,102395,103373,98112,5261,157
Placer,12,2022-03-12,157,157,146,11,7550,7621,7079,542,90
Plumas,12,2022-03-12,10,10,9,1,313,316,294,22,0
Riverside,12,2022-03-12,778,785,734,51,51381,51871,48495,3376,131
Sacramento,12,2022-03-12,624,631,598,33,37171,37525,35572,1953,143
San Benito,12,2022-03-12,27,27,26,1,1449,1464,1401,63,2
San Bernardino,12,2022-03-12,603,609,585,24,51097,51585,49573,2012,129
San Diego,12,2022-03-12,2005,2025,1991,34,96786,97710,96068,1642,232
San Francisco,12,2022-03-12,585,592,547,45,35039,35373,32680,2693,44
San Joaquin,12,2022-03-12,314,315,297,18,20440,20636,19448,1188,46
San Luis Obispo,12,2022-03-12,162,162,155,7,6985,7052,6733,319,6
San Mateo,12,2022-03-12,467,473,457,16,37437,37794,36482,1312,31
Santa Barbara,12,2022-03-12,194,194,184,10,17575,17742,16814,928,20
Santa Clara,12,2022-03-12,1130,1140,1120,20,101371,102339,100577,1762,142
Santa Cruz,12,2022-03-12,248,248,238,10,23057,23278,22327,951,12
Shasta,12,2022-03-12,105,105,98,7,4938,4985,4652,333,21
Siskiyou,12,2022-03-12,17,17,16,1,400,404,386,18,0
Solano,12,2022-03-12,244,246,233,13,12980,13103,12436,667,66
Sonoma,12,2022-03-12,235,235,223,12,13966,14098,13371,727,18
Stanislaus,12,2022-03-12,245,245,226,19,10206,10303,9485,818,116
Sutter,12,2022-03-12,56,56,53,3,1805,1823,1718,105,0
Tehama,12,2022-03-12,27,27,25,2,997,1005,917,88,1
Trinity,12,2022-03-12,2,2,2,0,97,97,90,7,0
Tulare,12,2022-03-12,215,216,198,18,9773,9866,9053,813,40
Tuolumne,12,2022-03-12,29,29,27,2,1246,1259,1178,81,2
Ventura,12,2022-03-12,352,354,342,12,25148,25386,24536,850,44
Yolo,12,2022-03-12,132,132,126,6,21585,21791,20882,909,4
Yuba,12,2022-03-12,44,44,42,2,1446,1461,1385,76,13
Alameda,13,2022-03-19,696,703,683,20,67199,67938,65984,1954,69
Amador,13,2022-03-19,29,29,28,1,1388,1404,1334,70,3
Butte,13,2022-03-19,86,86,84,2,2984,3016,2942,74,17
Calaveras,13,2022-03-19,14,14,13,1,655,662,634,28,0
Colusa,13,2022-03-19,1,1,1,0,241,244,234,10,2
Contra Costa,13,2022-03-19,467,472,451,21,27733,28039,26781,1258,68
Del Norte,13,2022-03-19,19,19,18,1,1282,1296,1246,50,2
El Dorado,13,2022-03-19,41,41,39,2,2825,2857,2730,127,2
Fresno,13,2022-03-19,352,356,339,17,19956,20177,19202,975,122
Glenn,13,2022-03-19,8,8,8,0,339,342,328,14,1
Humboldt,13,2022-03-19,35,35,34,1,2378,2404,2308,96,8
Imperial,13,2022-03-19,62,62,59,3,4025,4069,3889,180,9
Inyo,13,2022-03-19,1,1,1,0,156,156,151,5,0
Kern,13,2022-03-19,217,218,209,9,19388,19602,18818,784,40
Kings,13,2022-03-19,76,76,72,4,4409,4458,4246,212,6
Lake,13,2022-03-19,20,20,19,1,1447,1462,1386,76,0
Lassen,13,2022-03-19,10,10,10,0,1528,1545,1490,55,0
Los Angeles,13,2022-03-19,3971,4014,3970,44,824818,833906,824801,9105,484
Madera,13,2022-03-19,45,45,43,2,3418,3456,3290,166,20
Marin,13,2022-03-19,148,148,142,6,6359,6429,6153,276,13
Mariposa,13,2022-03-19,8,8,8,0,246,247,235,12,0
Mendocino,13,2022-03-19,32,32,30,2,1498,1514,1414,100,5
Merced,13,2022-03-19,97,97,93,4,3902,3945,3782,163,16
Modoc,13,2022-03-19,2,2,2,0,51,51,49,2,0
Mono,13,2022-03-19,2,2,2,0,131,131,123,8,1
Monterey,13,2022-03-19,150,150,139,11,10216,10327,9568,759,19
Napa,13,2022-03-19,65,65,62,3,3532,3571,3431,140,8
Nevada,13,2022-03-19,26,26,25,1,1539,1555,1475,80,1
Orange,13,2022-03-19,752,761,732,29,98277,99359,95545,3814,137
Placer,13,2022-03-19,111,111,105,6,6547,6620,6262,358,52
Plumas,13,2022-03-19,2,2,2,0,223,224,212,12,0
Riverside,13,2022-03-19,671,678,644,34,54652,55254,52527,2727,110
Sacramento,13,2022-03-19,469,474,455,19,32731,33092,31797,1295,123
San Benito,13,2022-03-19,26,26,25,1,1401,1417,1371,46,2
San Bernardino,13,2022-03-19,485,490,476,14,51320,51886,50366,1520,93
San Diego,13,2022-03-19,1537,1553,1533,20,88315,89287,88165,1122,209
San Francisco,13,2022-03-19,653,660,622,38,33548,33917,31959,1958,42
San Joaquin,13,2022-03-19,230,232,222,10,15544,15715,15032,683,38
San Luis Obispo,13,2022-03-19,114,114,110,4,6673,6745,6515,230,3
San Mateo,13,2022-03-19,383,388,378,10,34153,34528,33630,898,31
Santa Barbara,13,2022-03-19,181,181,174,7,16141,16318,15674,644,18
Santa Clara,13,2022-03-19,1028,1039,1026,13,94798,95842,94612,1230,145
Santa Cruz,13,2022-03-19,212,214,207,7,20686,20913,20270,643,10
Shasta,13,2022-03-19,56,56,53,3,4332,4379,4157,222,1
Siskiyou,13,2022-03-19,9,9,9,0,360,364,352,12,1
Solano,13,2022-03-19,194,195,187,8,11621,11749,11299,450,43
Sonoma,13,2022-03-19,226,227,218,9,13337,13484,12962,522,18
Stanislaus,13,2022-03-19,155,155,146,9,8608,8703,8180,523,87
Sutter,13,2022-03-19,31,31,30,1,1487,1503,1438,65,0
Tehama,13,2022-03-19,9,9,8,1,926,935,873,62,1
Trinity,13,2022-03-19,1,1,1,0,96,96,90,6,0
Tulare,13,2022-03-19,128,128,120,8,8465,8559,8024,535,30
Tuolumne,13,2022-03-19,18,18,17,1,1166,1181,1123,58,2
Ventura,13,2022-03-19,288,291,284,7,23834,24096,23491,605,38
Yolo,13,2022-03-19,98,98,95,3,22345,22592,21883,709,4
Yuba,13,2022-03-19,34,34,33,1,1326,1341,1288,53,7
Alameda,14,2022-03-26,874,886,867,19,59322,60055,58760,1295,70
Amador,14,2022-03-26,11,11,11,0,1311,1326,1276,50,3
Butte,14,2022-03-26,68,68,67,1,2731,2766,2715,51,15
Calaveras,14,2022-03-26,14,14,14,0,601,608,588,20,0
Colusa,14,2022-03-26,4,4,4,0,197,199,193,6,0
Contra Costa,14,2022-03-26,505,511,494,17,24829,25136,24289,847,54
Del Norte,14,2022-03-26,16,16,16,0,1036,1049,1018,31,0
El Dorado,14,2022-03-26,51,51,49,2,2789,2824,2730,94,0
Fresno,14,2022-03-26,303,307,296,11,18560,18790,18106,684,108
Glenn,14,2022-03-26,8,8,8,0,308,312,302,10,0
Humboldt,14,2022-03-26,27,27,26,1,2593,2623,2544,79,6
Imperial,14,2022-03-26,54,54,52,2,3688,3734,3609,125,7
Inyo,14,2022-03-26,3,3,3,0,164,164,160,4,1
Kern,14,2022-03-26,154,155,150,5,18450,18678,18116,562,26
Kings,14,2022-03-26,65,65,63,2,4404,4458,4298,160,2
Lake,14,2022-03-26,13,13,12,1,1149,1163,1117,46,0
Lassen,14,2022-03-26,6,6,6,0,1361,1378,1341,37,0
Los Angeles,14,2022-03-26,4339,4392,4356,36,785482,795223,788747,6476,393
Madera,14,2022-03-26,24,24,23,1,3366,3409,3286,123,7
Marin,14,2022-03-26,166,167,162,5,5887,5961,5769,192,8
Mariposa,14,2022-03-26,6,6,6,0,178,178,171,7,0
Mendocino,14,2022-03-26,29,29,28,1,1290,1306,1240,66,0
Merced,14,2022-03-26,64,64,62,2,3331,3372,3267,105,12
Modoc,14,2022-03-26,2,2,2,0,52,52,50,2,0
Mono,14,2022-03-26,3,3,3,0,132,132,126,6,0
Monterey,14,2022-03-26,163,164,155,9,9444,9561,9029,532,19
Napa,14,2022-03-26,62,62,60,2,3328,3369,3270,99,1
Nevada,14,2022-03-26,25,25,24,1,1476,1495,1437,58,1
Orange,14,2022-03-26,798,808,785,23,90123,91242,88612,2630,107
Placer,14,2022-03-26,113,113,108,5,6158,6234,5980,254,62
Plumas,14,2022-03-26,2,2,2,0,272,275,264,11,0
Riverside,14,2022-03-26,517,524,505,19,44550,45103,43431,1672,87
Sacramento,14,2022-03-26,461,467,453,14,31669,32061,31117,944,117
San Benito,14,2022-03-26,10,10,10,0,1305,1321,1289,32,0
San Bernardino,14,2022-03-26,492,499,488,11,41170,41681,40765,916,80
San Diego,14,2022-03-26,1328,1346,1333,13,74020,74937,74234,703,161
San Francisco,14,2022-03-26,771,780,746,34,32748,33154,31709,1445,35
San Joaquin,14,2022-03-26,191,191,185,6,16609,16815,16267,548,34
San Luis Obispo,14,2022-03-26,98,98,95,3,5877,5949,5798,151,5
San Mateo,14,2022-03-26,512,519,509,10,34362,34787,34108,679,31
Santa Barbara,14,2022-03-26,120,120,116,4,8878,8988,8723,265,21
Santa Clara,14,2022-03-26,1246,1261,1249,12,90980,92109,91228,881,120
Santa Cruz,14,2022-03-26,136,136,133,3,18709,18941,18506,435,7
Shasta,14,2022-03-26,41,41,39,2,3902,3950,3799,151,10
Siskiyou,14,2022-03-26,8,8,8,0,305,308,300,8,0
Solano,14,2022-03-26,157,157,152,5,10899,11033,10715,318,42
Sonoma,14,2022-03-26,232,233,226,7,8218,8321,8080,241,14
Stanislaus,14,2022-03-26,125,125,119,6,8025,8125,7756,369,56
Sutter,14,2022-03-26,27,27,26,1,1515,1534,1484,50,0
Tehama,14,2022-03-26,13,13,12,1,808,818,776,42,2
Trinity,14,2022-03-26,0,0,0,0,102,102,98,4,0
Tulare,14,2022-03-26,95,95,90,5,7869,7966,7590,376,22
Tuolumne,14,2022-03-26,9,9,9,0,1113,1127,1086,41,3
Ventura,14,2022-03-26,332,337,331,6,21738,22006,21593,413,26
Yolo,14,2022-03-26,97,97,95,2,17163,17377,16969,408,3
Yuba,14,2022-03-26,34,34,33,1,1255,1270,1232,38,3
Alameda,15,2022-04-02,953,967,952,15,58338,59160,58206,954,57
Amador,15,2022-04-02,4,4,4,0,1178,1195,1161,34,1
Butte,15,2022-04-02,51,51,50,1,2483,2518,2483,35,10
Calaveras,15,2022-04-02,12,12,12,0,586,594,580,14,0
Colusa,15,2022-04-02,4,4,4,0,199,201,196,5,0
Contra Costa,15,2022-04-02,543,551,537,14,24543,24890,24260,630,55
Del Norte,15,2022-04-02,11,11,11,0,1126,1141,1116,25,1
El Dorado,15,2022-04-02,52,52,51,1,2777,2815,2744,71,2
Fresno,15,2022-04-02,197,199,194,5,17048,17289,16816,473,89
Glenn,15,2022-04-02,4,4,4,0,261,264,258,6,0
Humboldt,15,2022-04-02,21,21,21,0,2510,2545,2487,58,7
Imperial,15,2022-04-02,55,55,54,1,3449,3497,3409,88,6
Inyo,15,2022-04-02,8,8,8,0,182,184,181,3,0
Kern,15,2022-04-02,161,162,158,4,17194,17436,17042,394,23
Kings,15,2022-04-02,49,49,48,1,4156,4214,4101,113,3
Lake,15,2022-04-02,12,12,12,0,985,1000,971,29,0
Lassen,15,2022-04-02,4,4,4,0,1218,1234,1210,24,0
Los Angeles,15,2022-04-02,5032,5103,5072,31,731549,741895,737426,4469,339
Madera,15,2022-04-02,28,28,27,1,3276,3323,3233,90,9
Marin,15,2022-04-02,155,156,152,4,6557,6650,6489,161,14
Mariposa,15,2022-04-02,5,5,5,0,215,217,211,6,0
Mendocino,15,2022-04-02,26,26,25,1,1252,1270,1221,49,0
Merced,15,2022-04-02,58,58,57,1,3285,3331,3253,78,4
Modoc,15,2022-04-02,4,4,4,0,42,42,41,1,0
Mono,15,2022-04-02,1,1,1,0,154,154,149,5,0
Monterey,15,2022-04-02,127,127,122,5,7535,7641,7321,320,11
Napa,15,2022-04-02,59,59,58,1,3245,3292,3219,73,3
Nevada,15,2022-04-02,28,28,27,1,1401,1420,1379,41,0
Orange,15,2022-04-02,899,912,892,20,88467,89713,87772,1941,81
Placer,15,2022-04-02,123,123,119,4,6576,6669,6465,204,48
Plumas,15,2022-04-02,4,4,4,0,233,236,229,7,0
Riverside,15,2022-04-02,601,609,592,17,39275,39827,38714,1113,62
Sacramento,15,2022-04-02,430,436,426,10,32760,33221,32487,734,80
San Benito,15,2022-04-02,13,13,13,0,1229,1246,1223,23,0
San Bernardino,15,2022-04-02,578,586,576,10,41528,42113,41420,693,46
San Diego,15,2022-04-02,1505,1525,1514,11,65970,66898,66430,468,151
San Francisco,15,2022-04-02,962,976,944,32,28736,29141,28181,960,31
San Joaquin,15,2022-04-02,208,210,205,5,16037,16261,15860,401,23
San Luis Obispo,15,2022-04-02,101,101,99,2,5598,5676,5567,109,4
San Mateo,15,2022-04-02,649,658,648,10,29622,30038,29599,439,20
Santa Barbara,15,2022-04-02,177,177,173,4,15222,15437,15095,342,11
Santa Clara,15,2022-04-02,1424,1444,1434,10,91238,92522,91859,663,120
Santa Cruz,15,2022-04-02,189,190,187,3,20062,20344,19992,352,5
Shasta,15,2022-04-02,25,25,24,1,3526,3575,3472,103,5
Siskiyou,15,2022-04-02,4,4,4,0,313,318,312,6,0
Solano,15,2022-04-02,146,146,143,3,10206,10348,10124,224,41
Sonoma,15,2022-04-02,287,292,286,6,10643,10793,10558,235,14
Stanislaus,15,2022-04-02,100,100,97,3,7810,7919,7647,272,33
Sutter,15,2022-04-02,23,23,22,1,1271,1289,1257,32,0
Tehama,15,2022-04-02,5,5,5,0,746,756,727,29,0
Trinity,15,2022-04-02,1,1,1,0,77,77,75,2,0
Tulare,15,2022-04-02,55,55,53,2,7607,7713,7438,275,19
Tuolumne,15,2022-04-02,11,11,11,0,972,986,959,27,1
Ventura,15,2022-04-02,297,303,299,4,20905,21199,20902,297,22
Yolo,15,2022-04-02,64,64,63,1,28217,28613,28106,507,1
Yuba,15,2022-04-02,12,12,12,0,1024,1038,1015,23,4
Alameda,16,2022-04-09,1342,1364,1348,16,48755,49547,48952,595,75
Amador,16,2022-04-09,7,7,7,0,1099,1116,1092,24,1
Butte,16,2022-04-09,35,35,35,0,2088,2121,2099,22,8
Calaveras,16,2022-04-09,9,9,9,0,643,652,640,12,0
Colusa,16,2022-04-09,4,4,4,0,195,198,194,4,0
Contra Costa,16,2022-04-09,619,630,618,12,19554,19872,19496,376,51
Del Norte,16,2022-04-09,7,7,7,0,982,999,983,16,1
El Dorado,16,2022-04-09,51,51,50,1,2569,2610,2561,49,1
Fresno,16,2022-04-09,196,199,195,4,16691,16963,16616,347,91
Glenn,16,2022-04-09,3,3,3,0,229,232,228,4,0
Humboldt,16,2022-04-09,38,38,37,1,2329,2368,2328,40,10
Imperial,16,2022-04-09,27,27,26,1,3436,3492,3426,66,3
Inyo,16,2022-04-09,5,5,5,0,199,202,199,3,0
Kern,16,2022-04-09,148,148,146,2,17196,17476,17182,294,20
Kings,16,2022-04-09,33,33,32,1,4206,4274,4188,86,3
Lake,16,2022-04-09,19,19,19,0,848,862,843,19,0
Lassen,16,2022-04-09,1,1,1,0,1301,1321,1301,20,1
Los Angeles,16,2022-04-09,6384,6488,6459,29,749543,761720,758277,3443,314
Madera,16,2022-04-09,28,28,27,1,3153,3204,3139,65,6
Marin,16,2022-04-09,190,192,188,4,5445,5534,5434,100,9
Mariposa,16,2022-04-09,7,7,7,0,245,249,244,5,0
Mendocino,16,2022-04-09,30,30,29,1,1152,1170,1136,34,0
Merced,16,2022-04-09,64,64,63,1,3305,3357,3298,59,10
Modoc,16,2022-04-09,1,1,1,0,50,50,49,1,0
Mono,16,2022-04-09,3,3,3,0,135,135,132,3,0
Monterey,16,2022-04-09,114,114,110,4,7157,7275,7046,229,12
Napa,16,2022-04-09,107,107,105,2,3075,3124,3073,51,2
Nevada,16,2022-04-09,36,36,35,1,1511,1535,1501,34,2
Orange,16,2022-04-09,1099,1118,1100,18,54171,55050,54159,891,86
Placer,16,2022-04-09,110,110,108,2,6219,6319,6174,145,42
Plumas,16,2022-04-09,5,5,5,0,260,264,258,6,0
Riverside,16,2022-04-09,725,736,721,15,37710,38320,37518,802,51
Sacramento,16,2022-04-09,471,478,470,8,31219,31725,31200,525,64
San Benito,16,2022-04-09,17,17,17,0,1185,1203,1187,16,0
San Bernardino,16,2022-04-09,808,821,811,10,41857,42538,42016,522,34
San Diego,16,2022-04-09,1820,1850,1840,10,73517,74711,74323,388,130
San Francisco,16,2022-04-09,1146,1166,1137,29,30147,30638,29883,755,35
San Joaquin,16,2022-04-09,226,230,226,4,15608,15860,15568,292,26
San Luis Obispo,16,2022-04-09,109,109,107,2,5009,5090,5017,73,2
San Mateo,16,2022-04-09,815,828,819,9,30505,31001,30663,338,10
Santa Barbara,16,2022-04-09,249,254,250,4,15188,15433,15177,256,9
Santa Clara,16,2022-04-09,1587,1612,1603,9,79294,80580,80151,429,112
Santa Cruz,16,2022-04-09,273,277,273,4,8148,8280,8173,107,6
Shasta,16,2022-04-09,19,19,19,0,3304,3358,3286,72,3
Siskiyou,16,2022-04-09,1,1,1,0,315,320,316,4,0
Solano,16,2022-04-09,217,221,217,4,9619,9776,9618,158,37
Sonoma,16,2022-04-09,394,401,394,7,10563,10734,10559,175,8
Stanislaus,16,2022-04-09,132,132,129,3,7865,7992,7786,206,36
Sutter,16,2022-04-09,23,23,23,0,1323,1344,1319,25,0
Tehama,16,2022-04-09,10,10,10,0,758,770,748,22,0
Trinity,16,2022-04-09,0,0,0,0,82,82,80,2,0
Tulare,16,2022-04-09,45,45,44,1,7907,8035,7820,215,7
Tuolumne,16,2022-04-09,16,16,16,0,1076,1094,1071,23,1
Ventura,16,2022-04-09,300,306,303,3,18062,18355,18163,192,22
Yolo,16,2022-04-09,94,94,93,1,18603,18906,18656,250,1
Yuba,16,2022-04-09,14,14,14,0,1075,1092,1074,18,5
Alameda,17,2022-04-16,1738,1771,1755,16,54507,55556,55057,499,70
Amador,17,2022-04-16,7,7,7,0,1135,1156,1138,18,2
Butte,17,2022-04-16,48,48,48,0,2047,2086,2070,16,5
Calaveras,17,2022-04-16,16,16,16,0,616,629,621,8,0
Colusa,17,2022-04-16,4,4,4,0,169,172,170,2,0
Contra Costa,17,2022-04-16,983,1002,988,14,24944,25425,25065,360,59
Del Norte,17,2022-04-16,12,12,12,0,1022,1043,1030,13,0
El Dorado,17,2022-04-16,58,58,57,1,2357,2401,2367,34,0
Fresno,17,2022-04-16,196,201,198,3,13919,14188,13971,217,55
Glenn,17,2022-04-16,3,3,3,0,237,241,238,3,0
Humboldt,17,2022-04-16,78,78,77,1,1974,2013,1987,26,7
Imperial,17,2022-04-16,41,41,40,1,3352,3415,3367,48,3
Inyo,17,2022-04-16,0,0,0,0,152,154,152,2,0
Kern,17,2022-04-16,130,130,128,2,13370,13628,13457,171,19
Kings,17,2022-04-16,38,38,37,1,3615,3684,3628,56,2
Lake,17,2022-04-16,19,19,19,0,815,829,815,14,2
Lassen,17,2022-04-16,2,2,2,0,1316,1341,1326,15,0
Los Angeles,17,2022-04-16,7541,7687,7661,26,367869,374937,373668,1269,259
Madera,17,2022-04-16,23,23,23,0,2603,2652,2612,40,9
Marin,17,2022-04-16,283,290,286,4,6108,6226,6142,84,5
Mariposa,17,2022-04-16,11,11,11,0,257,262,258,4,0
Mendocino,17,2022-04-16,42,42,41,1,1302,1328,1300,28,4
Merced,17,2022-04-16,73,73,72,1,3158,3218,3176,42,9
Modoc,17,2022-04-16,1,1,1,0,36,37,36,1,0
Mono,17,2022-04-16,13,13,13,0,170,172,169,3,0
Monterey,17,2022-04-16,131,133,130,3,6341,6463,6310,153,7
Napa,17,2022-04-16,141,141,139,2,2696,2747,2714,33,1
Nevada,17,2022-04-16,42,42,41,1,1240,1264,1243,21,2
Orange,17,2022-04-16,1334,1360,1344,16,82115,83693,82678,1015,79
Placer,17,2022-04-16,150,152,149,3,4701,4791,4709,82,49
Plumas,17,2022-04-16,7,7,7,0,209,213,209,4,0
Riverside,17,2022-04-16,843,859,846,13,37123,37837,37244,593,56
Sacramento,17,2022-04-16,647,660,652,8,27810,28344,27994,350,67
San Benito,17,2022-04-16,23,23,23,0,1181,1204,1192,12,0
San Bernardino,17,2022-04-16,1021,1041,1031,10,39249,40004,39636,368,50
San Diego,17,2022-04-16,1876,1913,1906,7,68397,69711,69440,271,107
San Francisco,17,2022-04-16,1327,1351,1326,25,30535,31125,30552,573,40
San Joaquin,17,2022-04-16,217,222,219,3,14845,15129,14921,208,18
San Luis Obispo,17,2022-04-16,138,140,139,1,4856,4950,4897,53,3
San Mateo,17,2022-04-16,1045,1066,1057,9,29918,30494,30247,247,22
Santa Barbara,17,2022-04-16,330,338,334,4,14850,15137,14950,187,8
Santa Clara,17,2022-04-16,2023,2062,2054,8,74182,75606,75304,302,94
Santa Cruz,17,2022-04-16,408,418,414,4,12637,12876,12748,128,4
Shasta,17,2022-04-16,27,27,27,0,2836,2890,2844,46,4
Siskiyou,17,2022-04-16,4,4,4,0,321,327,324,3,1
Solano,17,2022-04-16,222,227,224,3,9050,9224,9113,111,27
Sonoma,17,2022-04-16,474,483,477,6,11404,11623,11481,142,16
Stanislaus,17,2022-04-16,144,145,142,3,7857,8008,7854,154,42
Sutter,17,2022-04-16,20,20,20,0,1180,1202,1186,16,0
Tehama,17,2022-04-16,7,7,7,0,649,660,646,14,1
Trinity,17,2022-04-16,0,0,0,0,69,69,68,1,0
Tulare,17,2022-04-16,71,71,70,1,6822,6952,6812,140,18
Tuolumne,17,2022-04-16,26,26,26,0,1060,1080,1063,17,0
Ventura,17,2022-04-16,354,361,358,3,15789,16092,15966,126,11
Yolo,17,2022-04-16,111,111,110,1,18747,19109,18921,188,2
Yuba,17,2022-04-16,21,21,21,0,1005,1025,1012,13,1
Alameda,18,2022-04-23,2233,2288,2273,15,55656,57011,56631,380,93
Amador,18,2022-04-23,18,18,18,0,1320,1352,1336,16,0
Butte,18,2022-04-23,36,36,36,0,2187,2240,2227,13,10
Calaveras,18,2022-04-23,22,22,22,0,610,625,619,6,0
Colusa,18,2022-04-23,3,3,3,0,175,180,178,2,0
Contra Costa,18,2022-04-23,1350,1384,1369,15,25363,25980,25706,274,55
Del Norte,18,2022-04-23,18,18,18,0,1068,1093,1083,10,1
El Dorado,18,2022-04-23,97,97,96,1,2663,2727,2698,29,0
Fresno,18,2022-04-23,328,336,332,4,15699,16082,15898,184,52
Glenn,18,2022-04-23,4,4,4,0,254,261,258,3,0
Humboldt,18,2022-04-23,170,175,173,2,2754,2822,2796,26,5
Imperial,18,2022-04-23,54,54,53,1,3334,3414,3378,36,5
Inyo,18,2022-04-23,6,6,6,0,183,188,187,1,2
Kern,18,2022-04-23,219,225,223,2,16966,17378,17215,163,21
Kings,18,2022-04-23,54,54,53,1,4408,4515,4464,51,2
Lake,18,2022-04-23,15,15,15,0,794,814,804,10,2
Lassen,18,2022-04-23,0,0,0,0,1523,1559,1546,13,0
Los Angeles,18,2022-04-23,10567,10826,10799,27,847586,868183,866007,2176,269
Madera,18,2022-04-23,29,29,29,0,2828,2896,2863,33,11
Marin,18,2022-04-23,346,354,350,4,6081,6230,6167,63,15
Mariposa,18,2022-04-23,15,15,15,0,213,218,215,3,0
Mendocino,18,2022-04-23,64,64,63,1,1192,1223,1203,20,1
Merced,18,2022-04-23,85,85,84,1,2910,2980,2951,29,6
Modoc,18,2022-04-23,1,1,1,0,35,36,35,1,0
Mono,18,2022-04-23,4,4,4,0,88,88,87,1,0
Monterey,18,2022-04-23,250,257,253,4,7377,7556,7423,133,4
Napa,18,2022-04-23,203,209,207,2,3322,3402,3371,31,0
Nevada,18,2022-04-23,46,46,45,1,1345,1378,1361,17,3
Orange,18,2022-04-23,1817,1862,1845,17,83518,85551,84782,769,73
Placer,18,2022-04-23,200,206,203,3,5683,5821,5747,74,40
Plumas,18,2022-04-23,2,2,2,0,233,239,236,3,0
Riverside,18,2022-04-23,1187,1216,1202,14,38893,39839,39375,464,63
Sacramento,18,2022-04-23,920,943,934,9,30646,31391,31102,289,65
San Benito,18,2022-04-23,33,33,33,0,1134,1161,1152,9,0
San Bernardino,18,2022-04-23,1278,1308,1299,9,41817,42833,42540,293,43
San Diego,18,2022-04-23,2716,2783,2775,8,72260,74018,73805,213,108
San Francisco,18,2022-04-23,1821,1866,1840,26,31008,31762,31325,437,45
San Joaquin,18,2022-04-23,348,356,352,4,15211,15578,15418,160,21
San Luis Obispo,18,2022-04-23,190,196,194,2,4983,5104,5063,41,5
San Mateo,18,2022-04-23,1388,1421,1412,9,31627,32394,32198,196,23
Santa Barbara,18,2022-04-23,350,359,356,3,14658,15014,14875,139,7
Santa Clara,18,2022-04-23,2798,2866,2858,8,68841,70514,70306,208,95
Santa Cruz,18,2022-04-23,455,466,463,3,19434,19906,19763,143,2
Shasta,18,2022-04-23,50,50,49,1,3053,3125,3088,37,0
Siskiyou,18,2022-04-23,8,8,8,0,325,331,328,3,0
Solano,18,2022-04-23,400,410,406,4,10090,10336,10243,93,26
Sonoma,18,2022-04-23,623,638,632,6,11562,11843,11736,107,18
Stanislaus,18,2022-04-23,202,208,205,3,7440,7620,7510,110,30
Sutter,18,2022-04-23,33,33,33,0,1307,1338,1324,14,0
Tehama,18,2022-04-23,15,15,15,0,658,674,663,11,1
Trinity,18,2022-04-23,2,2,2,0,77,77,76,1,0
Tulare,18,2022-04-23,82,82,81,1,6943,7111,7004,107,16
Tuolumne,18,2022-04-23,35,35,35,0,1104,1131,1118,13,1
Ventura,18,2022-04-23,555,568,565,3,18563,19014,18904,110,17
Yolo,18,2022-04-23,182,188,187,1,18476,18928,18790,138,0
Yuba,18,2022-04-23,32,32,32,0,1084,1111,1101,10,1
Alameda,19,2022-04-30,3054,3157,3141,16,69122,71411,71054,357,87
Amador,19,2022-04-30,32,32,32,0,1344,1389,1377,12,0
Butte,19,2022-04-30,88,90,90,0,2282,2357,2347,10,4
Calaveras,19,2022-04-30,32,32,32,0,736,760,754,6,0
Colusa,19,2022-04-30,4,4,4,0,219,226,224,2,0
Contra Costa,19,2022-04-30,1678,1732,1718,14,28696,29647,29413,234,67
Del Norte,19,2022-04-30,37,37,37,0,1205,1245,1237,8,0
El Dorado,19,2022-04-30,113,117,116,1,2746,2838,2816,22,3
Fresno,19,2022-04-30,452,467,463,4,16929,17492,17343,149,63
Glenn,19,2022-04-30,4,4,4,0,244,253,251,2,0
Humboldt,19,2022-04-30,197,203,202,1,2905,3001,2980,21,8
Imperial,19,2022-04-30,113,117,116,1,3687,3808,3778,30,2
Inyo,19,2022-04-30,5,5,5,0,207,213,212,1,0
Kern,19,2022-04-30,280,289,287,2,17903,18494,18364,130,15
Kings,19,2022-04-30,45,45,45,0,4735,4891,4850,41,3
Lake,19,2022-04-30,28,28,28,0,1022,1056,1046,10,1
Lassen,19,2022-04-30,9,9,9,0,1606,1659,1649,10,0
Los Angeles,19,2022-04-30,13454,13903,13877,26,914370,944635,942867,1768,270
Madera,19,2022-04-30,67,67,66,1,3225,3332,3304,28,10
Marin,19,2022-04-30,378,392,389,3,6388,6600,6550,50,14
Mariposa,19,2022-04-30,7,7,7,0,239,246,244,2,0
Mendocino,19,2022-04-30,48,48,47,1,1255,1296,1280,16,0
Merced,19,2022-04-30,115,118,117,1,3248,3354,3330,24,7
Modoc,19,2022-04-30,0,0,0,0,44,45,44,1,0
Mono,19,2022-04-30,4,4,4,0,81,83,82,1,0
Monterey,19,2022-04-30,323,333,329,4,8329,8603,8489,114,9
Napa,19,2022-04-30,215,222,220,2,3487,3603,3579,24,5
Nevada,19,2022-04-30,69,70,69,1,1505,1555,1541,14,2
Orange,19,2022-04-30,2431,2511,2494,17,87461,90363,89755,608,90
Placer,19,2022-04-30,261,270,267,3,6277,6485,6423,62,43
Plumas,19,2022-04-30,7,7,7,0,253,260,257,3,0
Riverside,19,2022-04-30,1739,1797,1782,15,41841,43229,42852,377,56
Sacramento,19,2022-04-30,1227,1269,1260,9,32550,33631,33400,231,62
San Benito,19,2022-04-30,45,45,45,0,1203,1242,1235,7,0
San Bernardino,19,2022-04-30,1332,1376,1369,7,42526,43936,43712,224,46
San Diego,19,2022-04-30,3691,3814,3806,8,71297,73658,73499,159,111
San Francisco,19,2022-04-30,2275,2350,2326,24,35019,36186,35814,372,50
San Joaquin,19,2022-04-30,468,484,480,4,15164,15664,15544,120,19
San Luis Obispo,19,2022-04-30,254,262,260,2,5145,5316,5284,32,9
San Mateo,19,2022-04-30,1679,1735,1727,8,36018,37210,37042,168,24
Santa Barbara,19,2022-04-30,389,402,399,3,15584,16100,15989,111,9
Santa Clara,19,2022-04-30,3860,3989,3980,9,95246,98404,98187,217,102
Santa Cruz,19,2022-04-30,637,657,653,4,22263,23002,22879,123,4
Shasta,19,2022-04-30,60,60,59,1,3420,3532,3500,32,7
Siskiyou,19,2022-04-30,11,11,11,0,321,332,330,2,0
Solano,19,2022-04-30,557,575,571,4,11079,11445,11368,77,30
Sonoma,19,2022-04-30,761,786,781,5,12391,12801,12714,87,21
Stanislaus,19,2022-04-30,273,283,280,3,8272,8544,8452,92,30
Sutter,19,2022-04-30,48,48,48,0,1277,1319,1309,10,0
Tehama,19,2022-04-30,17,17,17,0,676,698,690,8,0
Trinity,19,2022-04-30,1,1,1,0,84,87,86,1,0
Tulare,19,2022-04-30,137,143,141,2,7122,7357,7275,82,12
Tuolumne,19,2022-04-30,80,82,81,1,1234,1275,1264,11,5
Ventura,19,2022-04-30,652,673,670,3,19347,19987,19900,87,18
Yolo,19,2022-04-30,239,246,245,1,19181,19819,19711,108,2
Yuba,19,2022-04-30,38,38,38,0,1041,1076,1069,7,3
Alameda,20,2022-05-07,3794,4015,4000,15,69992,74051,73777,274,93
Amador,20,2022-05-07,12,12,12,0,1400,1480,1470,10,0
Butte,20,2022-05-07,114,120,120,0,2381,2517,2509,8,4
Calaveras,20,2022-05-07,24,24,24,0,692,732,728,4,1
Colusa,20,2022-05-07,3,3,3,0,216,228,227,1,0
Contra Costa,20,2022-05-07,2250,2381,2367,14,30541,32309,32119,190,78
Del Norte,20,2022-05-07,42,44,44,0,1225,1295,1288,7,0
El Dorado,20,2022-05-07,157,166,165,1,2812,2975,2958,17,4
Fresno,20,2022-05-07,634,672,668,4,17437,18448,18331,117,51
Glenn,20,2022-05-07,5,5,5,0,228,239,238,1,0
Humboldt,20,2022-05-07,284,301,299,2,3266,3454,3436,18,6
Imperial,20,2022-05-07,105,112,111,1,3747,3960,3937,23,1
Inyo,20,2022-05-07,16,17,17,0,198,210,209,1,0
Kern,20,2022-05-07,397,420,418,2,18391,19446,19344,102,23
Kings,20,2022-05-07,89,95,94,1,4917,5198,5165,33,2
Lake,20,2022-05-07,30,30,30,0,1007,1065,1058,7,1
Lassen,20,2022-05-07,2,2,2,0,1681,1777,1769,8,0
Los Angeles,20,2022-05-07,16240,17187,17163,24,893568,944755,943440,1315,289
Madera,20,2022-05-07,120,127,126,1,3751,3967,3942,25,7
Marin,20,2022-05-07,611,648,644,4,7590,8035,7990,45,21
Mariposa,20,2022-05-07,25,25,25,0,270,286,284,2,0
Mendocino,20,2022-05-07,81,87,86,1,1230,1301,1289,12,1
Merced,20,2022-05-07,173,183,182,1,3417,3616,3596,20,5
Modoc,20,2022-05-07,2,2,2,0,38,41,40,1,0
Mono,20,2022-05-07,9,9,9,0,126,133,132,1,0
Monterey,20,2022-05-07,414,438,434,4,9200,9720,9624,96,8
Napa,20,2022-05-07,210,222,221,1,3237,3424,3407,17,2
Nevada,20,2022-05-07,97,104,103,1,1637,1730,1718,12,3
Orange,20,2022-05-07,3281,3474,3457,17,90501,95729,95250,479,113
Placer,20,2022-05-07,447,474,471,3,6686,7070,7020,50,42
Plumas,20,2022-05-07,9,9,9,0,275,291,289,2,0
Riverside,20,2022-05-07,2270,2401,2385,16,44654,47221,46914,307,52
Sacramento,20,2022-05-07,1918,2032,2022,10,36251,38348,38152,196,84
San Benito,20,2022-05-07,62,66,66,0,1433,1515,1509,6,0
San Bernardino,20,2022-05-07,1677,1775,1768,7,44783,47367,47187,180,39
San Diego,20,2022-05-07,4811,5093,5085,8,85650,90588,90443,145,105
San Francisco,20,2022-05-07,2762,2923,2901,22,37421,39593,39289,304,59
San Joaquin,20,2022-05-07,671,709,705,4,15761,16664,16570,94,17
San Luis Obispo,20,2022-05-07,287,304,303,1,5178,5472,5448,24,2
San Mateo,20,2022-05-07,2074,2195,2188,7,36723,38833,38703,130,33
Santa Barbara,20,2022-05-07,569,601,598,3,15271,16145,16062,83,14
Santa Clara,20,2022-05-07,5302,5612,5603,9,102264,108134,107957,177,129
Santa Cruz,20,2022-05-07,676,715,712,3,23023,24355,24258,97,5
Shasta,20,2022-05-07,90,95,94,1,3445,3637,3613,24,11
Siskiyou,20,2022-05-07,11,11,11,0,291,308,307,1,0
Solano,20,2022-05-07,771,816,812,4,11720,12398,12336,62,41
Sonoma,20,2022-05-07,1128,1194,1188,6,13910,14710,14636,74,23
Stanislaus,20,2022-05-07,376,399,396,3,8627,9117,9044,73,37
Sutter,20,2022-05-07,43,44,44,0,1523,1609,1600,9,0
Tehama,20,2022-05-07,24,24,24,0,668,707,701,6,1
Trinity,20,2022-05-07,2,2,2,0,68,73,72,1,0
Tulare,20,2022-05-07,161,169,168,1,7534,7964,7897,67,13
Tuolumne,20,2022-05-07,73,77,77,0,1329,1405,1396,9,1
Ventura,20,2022-05-07,1006,1065,1062,3,20799,21997,21926,71,20
Yolo,20,2022-05-07,316,335,334,1,19372,20510,20427,83,1
Yuba,20,2022-05-07,63,67,67,0,1210,1281,1274,7,2
Alameda,21,2022-05-14,3877,5657,5642,15,69495,97341,97075,266,104
Amador,21,2022-05-14,19,24,24,0,1562,2302,2291,11,1
Butte,21,2022-05-14,132,181,181,0,2378,3376,3368,8,6
Calaveras,21,2022-05-14,28,39,39,0,711,992,988,4,2
Colusa,21,2022-05-14,5,7,7,0,197,266,265,1,0
Contra Costa,21,2022-05-14,2604,3878,3861,17,30498,43830,43641,189,90
Del Norte,21,2022-05-14,86,112,112,0,1575,2153,2145,8,0
El Dorado,21,2022-05-14,176,258,257,1,2841,3922,3905,17,6
Fresno,21,2022-05-14,731,1124,1119,5,16833,24726,24611,115,64
Glenn,21,2022-05-14,10,12,12,0,236,311,310,1,0
Humboldt,21,2022-05-14,216,292,291,1,3053,4193,4177,16,11
Imperial,21,2022-05-14,144,187,186,1,3870,5396,5373,23,4
Inyo,21,2022-05-14,17,21,21,0,199,284,283,1,1
Kern,21,2022-05-14,413,580,578,2,17830,24557,24462,95,20
Kings,21,2022-05-14,130,198,197,1,5021,7013,6981,32,0
Lake,21,2022-05-14,37,52,52,0,1025,1453,1446,7,0
Lassen,21,2022-05-14,10,12,12,0,1555,2067,2060,7,0
Los Angeles,21,2022-05-14,15740,22028,22005,23,460165,539220,538636,584,356
Madera,21,2022-05-14,130,187,186,1,3386,4816,4794,22,9
Marin,21,2022-05-14,569,882,878,4,7478,10861,10816,45,18
Mariposa,21,2022-05-14,19,24,24,0,323,489,487,2,0
Mendocino,21,2022-05-14,58,84,83,1,1252,1868,1856,12,2
Merced,21,2022-05-14,186,272,271,1,3465,4905,4885,20,8
Modoc,21,2022-05-14,1,1,1,0,35,45,44,1,0
Mono,21,2022-05-14,8,15,15,0,112,164,163,1,0
Monterey,21,2022-05-14,343,501,497,4,8945,12403,12312,91,11
Napa,21,2022-05-14,209,329,328,1,3275,4869,4851,18,3
Nevada,21,2022-05-14,100,142,141,1,1674,2353,2341,12,3
Orange,21,2022-05-14,3384,4752,4734,18,85132,118365,117928,437,91
Placer,21,2022-05-14,491,725,721,4,6886,9761,9710,51,54
Plumas,21,2022-05-14,23,34,34,0,254,363,361,2,1
Riverside,21,2022-05-14,2148,3186,3171,15,42090,58725,58444,281,74
Sacramento,21,2022-05-14,2288,3328,3316,12,35771,50703,50513,190,87
San Benito,21,2022-05-14,95,134,134,0,1488,2133,2126,7,3
San Bernardino,21,2022-05-14,1667,2300,2294,6,42165,58331,58167,164,50
San Diego,21,2022-05-14,5182,7510,7501,9,81469,114430,114295,135,127
San Francisco,21,2022-05-14,2787,4127,4104,23,36663,52671,52374,297,65
San Joaquin,21,2022-05-14,836,1220,1215,5,16681,23244,23147,97,18
San Luis Obispo,21,2022-05-14,290,418,417,1,5506,7689,7664,25,2
San Mateo,21,2022-05-14,2129,3100,3092,8,36758,51914,51786,128,48
Santa Barbara,21,2022-05-14,623,937,933,4,15959,22704,22619,85,10
Santa Clara,21,2022-05-14,5392,8157,8147,10,104517,147604,147427,177,136
Santa Cruz,21,2022-05-14,731,1053,1050,3,24035,33237,33139,98,4
Shasta,21,2022-05-14,95,121,120,1,3112,4011,3991,20,6
Siskiyou,21,2022-05-14,14,23,23,0,358,501,499,2,1
Solano,21,2022-05-14,904,1412,1407,5,11703,16947,16885,62,42
Sonoma,21,2022-05-14,1148,1708,1702,6,14421,20618,20542,76,29
Stanislaus,21,2022-05-14,491,771,767,4,8963,12606,12532,74,46
Sutter,21,2022-05-14,91,140,139,1,1642,2310,2300,10,0
Tehama,21,2022-05-14,16,22,22,0,632,856,850,6,2
Trinity,21,2022-05-14,2,5,5,0,61,92,91,1,0
Tulare,21,2022-05-14,192,303,301,2,7049,9534,9475,59,11
Tuolumne,21,2022-05-14,63,100,100,0,1382,1942,1933,9,2
Ventura,21,2022-05-14,992,1437,1434,3,20943,29751,29680,71,29
Yolo,21,2022-05-14,367,550,548,2,20326,29971,29882,89,2
Yuba,21,2022-05-14,96,150,149,1,1183,1766,1759,7,2
