county,time,date,cases,est_cases,est_omicron_cases,est_other_cases,tests,est_tests,est_omicron_tests,est_other_tests,hospitalizations
Alameda,1,2021-12-24,5124,5140,2292,2848,87710,87984,39009,48975,107
Amador,1,2021-12-24,74,74,19,55,1542,1546,391,1155,3
Butte,1,2021-12-24,312,312,151,161,3995,4007,1919,2088,26
Calaveras,1,2021-12-24,70,70,25,45,1019,1022,361,661,2
Colusa,1,2021-12-24,13,13,4,9,243,243,77,166,2
Contra Costa,1,2021-12-24,3102,3113,1101,2012,44967,45108,15826,29282,61
Del Norte,1,2021-12-24,14,14,5,9,1325,1330,461,869,0
El Dorado,1,2021-12-24,360,360,122,238,4346,4360,1465,2895,11
Fresno,1,2021-12-24,1458,1463,427,1036,23795,23868,6900,16968,167
Glenn,1,2021-12-24,43,43,15,28,447,448,152,296,0
Humboldt,1,2021-12-24,298,298,104,194,3295,3305,1122,2183,11
Imperial,1,2021-12-24,636,636,200,436,5542,5561,1765,3796,54
Inyo,1,2021-12-24,66,66,27,39,436,436,178,258,0
Kern,1,2021-12-24,1169,1173,398,775,20695,20759,6986,13773,102
Kings,1,2021-12-24,304,304,85,219,5601,5619,1553,4066,20
Lake,1,2021-12-24,43,43,12,31,1219,1223,337,886,0
Lassen,1,2021-12-24,16,16,6,10,2304,2313,927,1386,1
Los Angeles,1,2021-12-24,65349,65555,47038,18517,693231,695404,496828,198576,947
Madera,1,2021-12-24,192,192,54,138,4346,4359,1213,3146,14
Marin,1,2021-12-24,1091,1095,437,658,15094,15142,6054,9088,8
Mariposa,1,2021-12-24,33,33,9,24,548,548,149,399,0
Mendocino,1,2021-12-24,80,80,16,64,2651,2660,535,2125,6
Merced,1,2021-12-24,405,405,129,276,4957,4972,1577,3395,18
Modoc,1,2021-12-24,5,5,2,3,55,55,21,34,2
Mono,1,2021-12-24,83,83,21,62,395,395,98,297,1
Monterey,1,2021-12-24,676,676,243,433,12962,13001,4629,8372,34
Napa,1,2021-12-24,521,521,184,337,5837,5855,2056,3799,5
Nevada,1,2021-12-24,188,188,54,134,2649,2656,755,1901,6
Orange,1,2021-12-24,10280,10312,4518,5794,110328,110673,48019,62654,237
Placer,1,2021-12-24,846,847,261,586,10661,10695,3257,7438,88
Plumas,1,2021-12-24,10,10,3,7,403,403,134,269,0
Riverside,1,2021-12-24,8942,8969,2931,6038,80999,81252,26296,54956,381
Sacramento,1,2021-12-24,3288,3299,1210,2089,50515,50673,18407,32266,187
San Benito,1,2021-12-24,197,197,84,113,2121,2126,901,1225,5
San Bernardino,1,2021-12-24,8285,8312,3827,4485,83556,83818,38345,45473,419
San Diego,1,2021-12-24,17292,17347,11522,5825,166708,167229,110335,56894,352
San Francisco,1,2021-12-24,5436,5453,1866,3587,65945,66152,22587,43565,41
San Joaquin,1,2021-12-24,1437,1442,554,888,21371,21439,8150,13289,70
San Luis Obispo,1,2021-12-24,684,685,273,412,10365,10397,4118,6279,21
San Mateo,1,2021-12-24,3301,3312,1705,1607,53213,53380,27310,26070,29
Santa Barbara,1,2021-12-24,1291,1296,456,840,14566,14611,5078,9533,42
Santa Clara,1,2021-12-24,5716,5734,3796,1938,104810,105138,69202,35936,124
Santa Cruz,1,2021-12-24,616,616,269,347,12239,12276,5303,6973,14
Shasta,1,2021-12-24,177,177,58,119,4672,4687,1532,3155,37
Siskiyou,1,2021-12-24,14,14,5,9,352,352,141,211,0
Solano,1,2021-12-24,847,848,306,542,15890,15940,5726,10214,41
Sonoma,1,2021-12-24,1256,1261,498,763,19958,20020,7865,12155,17
Stanislaus,1,2021-12-24,820,820,204,616,10493,10526,2583,7943,117
Sutter,1,2021-12-24,168,168,54,114,2058,2064,665,1399,0
Tehama,1,2021-12-24,62,62,14,48,1073,1076,238,838,11
Trinity,1,2021-12-24,0,0,0,0,96,96,24,72,0
Tulare,1,2021-12-24,536,536,127,409,10779,10813,2541,8272,44
Tuolumne,1,2021-12-24,120,120,35,85,1793,1798,518,1280,4
Ventura,1,2021-12-24,3378,3390,1625,1765,35323,35434,16846,18588,81
Yolo,1,2021-12-24,502,502,218,284,21487,21556,9295,12261,6
Yuba,1,2021-12-24,105,105,37,68,1600,1604,561,1043,12
Alameda,2,2021-12-31,13809,13857,7495,6362,101987,102342,55345,46997,178
Amador,2,2021-12-31,132,132,44,88,1830,1836,614,1222,6
Butte,2,2021-12-31,843,846,486,360,5634,5652,3258,2394,31
Calaveras,2,2021-12-31,145,145,64,81,1134,1138,508,630,3
Colusa,2,2021-12-31,45,45,18,27,300,300,122,178,4
Contra Costa,2,2021-12-31,10503,10540,4675,5865,58678,58883,26118,32765,96
Del Norte,2,2021-12-31,59,59,26,33,1972,1978,867,1111,1
El Dorado,2,2021-12-31,975,979,420,559,5242,5260,2258,3002,20
Fresno,2,2021-12-31,4881,4898,1846,3052,34263,34384,12943,21441,191
Glenn,2,2021-12-31,68,68,30,38,515,516,223,293,0
Humboldt,2,2021-12-31,690,690,296,394,4634,4650,2017,2633,11
Imperial,2,2021-12-31,1443,1448,585,863,8153,8182,3329,4853,65
Inyo,2,2021-12-31,201,201,100,101,592,593,299,294,2
Kern,2,2021-12-31,3888,3901,1677,2224,29448,29550,12651,16899,116
Kings,2,2021-12-31,824,826,296,530,7372,7398,2678,4720,19
Lake,2,2021-12-31,125,125,45,80,1433,1438,518,920,1
Lassen,2,2021-12-31,35,35,17,18,2685,2696,1329,1367,2
Los Angeles,2,2021-12-31,169161,169749,133523,36226,888060,891154,701210,189944,1760
Madera,2,2021-12-31,626,626,227,399,5662,5681,2064,3617,15
Marin,2,2021-12-31,2197,2203,1074,1129,17603,17664,8648,9016,17
Mariposa,2,2021-12-31,68,68,24,44,532,533,190,343,0
Mendocino,2,2021-12-31,309,309,83,226,2892,2902,788,2114,7
Merced,2,2021-12-31,1188,1192,483,709,7343,7368,3005,4363,19
Modoc,2,2021-12-31,7,7,3,4,51,51,24,27,0
Mono,2,2021-12-31,170,170,55,115,379,380,124,256,4
Monterey,2,2021-12-31,1930,1936,871,1065,17283,17344,7828,9516,30
Napa,2,2021-12-31,1472,1477,649,828,10062,10096,4463,5633,9
Nevada,2,2021-12-31,429,429,160,269,2151,2158,812,1346,5
Orange,2,2021-12-31,37931,38062,20180,17882,194170,194847,103231,91616,490
Placer,2,2021-12-31,2255,2263,891,1372,13912,13962,5490,8472,127
Plumas,2,2021-12-31,32,32,14,18,334,334,142,192,2
Riverside,2,2021-12-31,25930,26021,10801,15220,122877,123305,51145,72160,544
Sacramento,2,2021-12-31,10720,10758,4934,5824,70155,70399,32256,38143,255
San Benito,2,2021-12-31,611,613,318,295,3018,3029,1571,1458,5
San Bernardino,2,2021-12-31,26813,26906,14887,12019,120676,121097,67210,53887,663
San Diego,2,2021-12-31,51059,51237,38000,13237,223374,224152,166092,58060,610
San Francisco,2,2021-12-31,9275,9307,4000,5307,74223,74483,32248,42235,91
San Joaquin,2,2021-12-31,5070,5088,2422,2666,31592,31702,15073,16629,100
San Luis Obispo,2,2021-12-31,2071,2078,1015,1063,14655,14706,7211,7495,24
San Mateo,2,2021-12-31,8545,8574,5174,3400,66437,66668,40406,26262,43
Santa Barbara,2,2021-12-31,3989,4003,1761,2242,21974,22050,9754,12296,60
Santa Clara,2,2021-12-31,16520,16577,12267,4310,130527,130982,97007,33975,219
Santa Cruz,2,2021-12-31,1703,1709,903,806,14995,15049,7965,7084,18
Shasta,2,2021-12-31,405,405,169,236,5369,5388,2246,3142,43
Siskiyou,2,2021-12-31,55,55,27,28,449,449,222,227,0
Solano,2,2021-12-31,3378,3389,1535,1854,23689,23771,10731,13040,74
Sonoma,2,2021-12-31,3604,3617,1762,1855,27508,27603,13451,14152,33
Stanislaus,2,2021-12-31,2420,2429,792,1637,15780,15834,5144,10690,127
Sutter,2,2021-12-31,360,360,149,211,2555,2565,1055,1510,0
Tehama,2,2021-12-31,146,146,43,103,1177,1181,348,833,3
Trinity,2,2021-12-31,9,9,3,6,102,102,33,69,0
Tulare,2,2021-12-31,1471,1476,462,1014,14591,14642,4577,10065,54
Tuolumne,2,2021-12-31,265,265,99,166,1905,1912,716,1196,6
Ventura,2,2021-12-31,10846,10884,6225,4659,54767,54958,31446,23512,109
Yolo,2,2021-12-31,1474,1479,779,700,25245,25332,13359,11973,11
Yuba,2,2021-12-31,324,324,144,180,2005,2011,895,1116,20
Alameda,3,2022-01-07,29092,29208,18532,10676,179509,180222,114394,65828,327
Amador,3,2022-01-07,347,347,145,202,2629,2639,1106,1533,6
Butte,3,2022-01-07,1825,1831,1215,616,9290,9328,6204,3124,46
Calaveras,3,2022-01-07,447,447,243,204,2375,2384,1297,1087,2
Colusa,3,2022-01-07,77,77,39,38,628,630,314,316,7
Contra Costa,3,2022-01-07,17940,18011,9670,8341,96446,96827,52235,44592,176
Del Norte,3,2022-01-07,154,154,82,72,3354,3368,1813,1555,2
El Dorado,3,2022-01-07,2034,2042,1067,975,8555,8590,4500,4090,13
Fresno,3,2022-01-07,10950,10995,5170,5825,53756,53969,25335,28634,315
Glenn,3,2022-01-07,162,162,87,75,832,835,443,392,2
Humboldt,3,2022-01-07,1357,1363,718,645,7728,7758,4113,3645,17
Imperial,3,2022-01-07,3403,3417,1713,1704,13468,13521,6789,6732,71
Inyo,3,2022-01-07,399,399,236,163,1189,1193,712,481,3
Kern,3,2022-01-07,10491,10533,5511,5022,53161,53371,27952,25419,186
Kings,3,2022-01-07,1873,1879,851,1028,11196,11241,5097,6144,23
Lake,3,2022-01-07,431,431,193,238,2573,2582,1161,1421,3
Lassen,3,2022-01-07,117,117,69,48,3454,3469,2029,1440,2
Los Angeles,3,2022-01-07,313071,314311,265247,49064,1785684,1792765,1514170,278595,3361
Madera,3,2022-01-07,1587,1592,727,865,9587,9626,4388,5238,34
Marin,3,2022-01-07,2844,2855,1664,1191,20236,20317,11912,8405,29
Mariposa,3,2022-01-07,172,172,75,97,1023,1028,459,569,0
Mendocino,3,2022-01-07,747,749,263,486,5078,5098,1797,3301,6
Merced,3,2022-01-07,3076,3087,1556,1531,12955,13006,6552,6454,41
Modoc,3,2022-01-07,19,19,10,9,98,98,55,43,0
Mono,3,2022-01-07,236,236,97,139,751,753,314,439,1
Monterey,3,2022-01-07,4150,4165,2270,1895,30058,30179,16437,13742,60
Napa,3,2022-01-07,2576,2586,1376,1210,14210,14266,7623,6643,16
Nevada,3,2022-01-07,1042,1047,486,561,4654,4672,2174,2498,12
Orange,3,2022-01-07,59156,59390,36879,22511,300762,301952,188034,113918,905
Placer,3,2022-01-07,4538,4556,2218,2338,20238,20317,9920,10397,177
Plumas,3,2022-01-07,109,109,56,53,715,719,368,351,4
Riverside,3,2022-01-07,45403,45582,23175,22407,176933,177632,90443,87189,861
Sacramento,3,2022-01-07,25129,25229,13969,11260,114596,115049,63677,51372,394
San Benito,3,2022-01-07,933,937,572,365,4218,4234,2590,1644,6
San Bernardino,3,2022-01-07,45626,45806,29558,16248,179280,179990,116453,63537,952
San Diego,3,2022-01-07,82011,82335,66415,15920,325467,326752,263625,63127,929
San Francisco,3,2022-01-07,15808,15868,8314,7554,114281,114734,60546,54188,165
San Joaquin,3,2022-01-07,12568,12618,7201,5417,57705,57934,33103,24831,156
San Luis Obispo,3,2022-01-07,4163,4179,2454,1725,21192,21276,12485,8791,34
San Mateo,3,2022-01-07,14526,14584,10053,4531,107563,107987,74626,33361,93
Santa Barbara,3,2022-01-07,8020,8052,4295,3757,43301,43473,23323,20150,105
Santa Clara,3,2022-01-07,33759,33891,27284,6607,249092,250078,201780,48298,411
Santa Cruz,3,2022-01-07,4108,4124,2557,1567,39274,39430,24567,14863,20
Shasta,3,2022-01-07,961,966,493,473,8168,8201,4204,3997,44
Siskiyou,3,2022-01-07,103,103,60,43,854,858,503,355,4
Solano,3,2022-01-07,6006,6030,3296,2734,33490,33623,18373,15250,85
Sonoma,3,2022-01-07,8023,8055,4698,3357,44918,45095,26265,18830,64
Stanislaus,3,2022-01-07,5759,5782,2402,3380,26051,26154,10861,15293,176
Sutter,3,2022-01-07,997,1002,508,494,4467,4485,2272,2213,0
Tehama,3,2022-01-07,455,455,174,281,2276,2285,872,1413,13
Trinity,3,2022-01-07,27,27,11,16,234,234,97,137,0
Tulare,3,2022-01-07,4096,4113,1650,2463,21543,21627,8685,12942,65
Tuolumne,3,2022-01-07,658,659,305,354,3822,3837,1788,2049,15
Ventura,3,2022-01-07,16969,17036,11269,5767,83049,83378,55337,28041,222
Yolo,3,2022-01-07,3805,3821,2363,1458,47446,47635,29602,18033,11
Yuba,3,2022-01-07,878,882,475,407,3620,3634,1965,1669,32
Alameda,4,2022-01-14,27650,27769,19781,7988,186799,187609,133845,53764,442
Amador,4,2022-01-14,465,465,236,229,3794,3810,1949,1861,7
Butte,4,2022-01-14,2135,2144,1587,557,9864,9906,7327,2579,54
Calaveras,4,2022-01-14,613,615,387,228,2717,2728,1725,1003,5
Colusa,4,2022-01-14,166,166,98,68,810,813,478,335,2
Contra Costa,4,2022-01-14,16996,17070,10667,6403,96658,97077,60868,36209,242
Del Norte,4,2022-01-14,191,191,118,73,4311,4330,2661,1669,2
El Dorado,4,2022-01-14,2184,2193,1335,858,8857,8895,5430,3465,13
Fresno,4,2022-01-14,16442,16514,9251,7263,67972,68267,38226,30041,435
Glenn,4,2022-01-14,304,304,189,115,1044,1049,649,400,0
Humboldt,4,2022-01-14,1297,1304,800,504,9023,9063,5603,3460,37
Imperial,4,2022-01-14,3755,3773,2233,1540,14267,14328,8501,5827,93
Inyo,4,2022-01-14,390,390,264,126,1257,1262,854,408,3
Kern,4,2022-01-14,13153,13209,8080,5129,59880,60139,36860,23279,255
Kings,4,2022-01-14,3436,3452,1880,1572,16602,16674,9103,7571,47
Lake,4,2022-01-14,580,581,314,267,3105,3120,1696,1424,5
Lassen,4,2022-01-14,263,263,176,87,3718,3735,2502,1233,1
Los Angeles,4,2022-01-14,261780,262910,232591,30319,1857062,1865115,1652883,212232,4549
Madera,4,2022-01-14,2378,2389,1308,1081,10961,11009,6025,4984,36
Marin,4,2022-01-14,2796,2809,1876,933,19812,19897,13341,6556,35
Mariposa,4,2022-01-14,190,190,100,90,1225,1230,657,573,0
Mendocino,4,2022-01-14,965,969,424,545,5537,5560,2437,3123,24
Merced,4,2022-01-14,4126,4144,2464,1680,15044,15109,8978,6131,55
Modoc,4,2022-01-14,10,10,7,3,107,107,69,38,0
Mono,4,2022-01-14,252,252,126,126,864,868,438,430,0
Monterey,4,2022-01-14,5770,5794,3664,2130,30013,30144,19012,11132,64
Napa,4,2022-01-14,2250,2260,1399,861,13584,13641,8487,5154,25
Nevada,4,2022-01-14,1324,1330,736,594,5725,5750,3196,2554,24
Orange,4,2022-01-14,48219,48427,33921,14506,286001,287240,201901,85339,1220
Placer,4,2022-01-14,4808,4829,2770,2059,21478,21571,12435,9136,235
Plumas,4,2022-01-14,179,179,107,72,778,782,467,315,4
Riverside,4,2022-01-14,45748,45945,27452,18493,182664,183456,109875,73581,1049
Sacramento,4,2022-01-14,23826,23928,15269,8659,112381,112866,72201,40665,531
San Benito,4,2022-01-14,938,943,651,292,4389,4407,3054,1353,8
San Bernardino,4,2022-01-14,42933,43119,31149,11970,183194,183988,133296,50692,1141
San Diego,4,2022-01-14,68944,69241,59308,9933,292876,294141,252100,42041,1250
San Francisco,4,2022-01-14,12109,12162,7457,4705,102070,102513,63085,39428,241
San Joaquin,4,2022-01-14,14374,14436,9459,4977,65447,65729,43134,22595,242
San Luis Obispo,4,2022-01-14,4150,4167,2800,1367,22730,22829,15354,7475,46
San Mateo,4,2022-01-14,14120,14181,10793,3388,110845,111324,84908,26416,148
Santa Barbara,4,2022-01-14,7782,7816,4856,2960,45633,45830,28587,17243,113
Santa Clara,4,2022-01-14,32561,32701,27983,4718,255931,257036,220267,36769,518
Santa Cruz,4,2022-01-14,4456,4476,3139,1337,45471,45666,32182,13484,31
Shasta,4,2022-01-14,1292,1297,783,514,9645,9686,5860,3826,72
Siskiyou,4,2022-01-14,157,157,105,52,1042,1046,700,346,5
Solano,4,2022-01-14,6872,6902,4368,2534,37635,37799,23959,13840,146
Sonoma,4,2022-01-14,8208,8244,5495,2749,46998,47201,31505,15696,92
Stanislaus,4,2022-01-14,7570,7603,3837,3766,30804,30936,15620,15316,239
Sutter,4,2022-01-14,1395,1401,831,570,5184,5207,3099,2108,0
Tehama,4,2022-01-14,618,620,292,328,2660,2671,1257,1414,19
Trinity,4,2022-01-14,44,44,22,22,279,279,140,139,0
Tulare,4,2022-01-14,7497,7530,3704,3826,28125,28248,13903,14345,104
Tuolumne,4,2022-01-14,906,911,505,406,4367,4385,2438,1947,10
Ventura,4,2022-01-14,14380,14442,10626,3816,78257,78596,58020,20576,341
Yolo,4,2022-01-14,3175,3189,2229,960,44842,45036,31634,13402,17
Yuba,4,2022-01-14,1105,1110,693,417,3990,4008,2505,1503,47
Alameda,5,2022-01-21,20929,21031,16461,4570,163998,164797,129289,35508,486
Amador,5,2022-01-21,579,581,349,232,4348,4371,2663,1708,12
Butte,5,2022-01-21,2011,2022,1630,392,8821,8864,7151,1713,76
Calaveras,5,2022-01-21,586,588,419,169,2403,2414,1724,690,7
Colusa,5,2022-01-21,162,162,109,53,807,811,548,263,5
Contra Costa,5,2022-01-21,13608,13674,9688,3986,82572,82973,58986,23987,340
Del Norte,5,2022-01-21,284,284,199,85,3761,3779,2648,1131,1
El Dorado,5,2022-01-21,1621,1628,1131,497,7545,7581,5279,2302,29
Fresno,5,2022-01-21,17933,18020,11687,6333,68586,68920,44761,24159,567
Glenn,5,2022-01-21,256,256,180,76,935,940,658,282,0
Humboldt,5,2022-01-21,1017,1022,715,307,7417,7453,5235,2218,18
Imperial,5,2022-01-21,3516,3534,2404,1130,12482,12543,8538,4005,86
Inyo,5,2022-01-21,170,170,127,43,636,640,481,159,1
Kern,5,2022-01-21,10970,11024,7689,3335,50846,51093,35754,15339,325
Kings,5,2022-01-21,4136,4155,2644,1511,17030,17112,10916,6196,46
Lake,5,2022-01-21,682,686,433,253,3286,3303,2078,1225,7
Lassen,5,2022-01-21,408,408,304,104,3533,3549,2644,905,1
Los Angeles,5,2022-01-21,179839,180713,165971,14742,1557707,1565296,1440003,125293,4852
Madera,5,2022-01-21,2706,2720,1731,989,11459,11515,7335,4180,62
Marin,5,2022-01-21,2042,2050,1529,521,17269,17353,12999,4354,50
Mariposa,5,2022-01-21,152,152,95,57,965,970,606,364,0
Mendocino,5,2022-01-21,992,997,530,467,4989,5013,2673,2340,24
Merced,5,2022-01-21,3198,3214,2184,1030,12358,12419,8462,3957,65
Modoc,5,2022-01-21,16,16,12,4,105,105,76,29,0
Mono,5,2022-01-21,104,104,62,42,517,518,306,212,2
Monterey,5,2022-01-21,5534,5560,3956,1604,31296,31448,22466,8982,112
Napa,5,2022-01-21,1753,1762,1241,521,11844,11901,8426,3475,24
Nevada,5,2022-01-21,1070,1076,691,385,4762,4785,3083,1702,25
Orange,5,2022-01-21,31490,31643,24448,7195,229516,230633,179087,51546,1187
Placer,5,2022-01-21,3870,3888,2575,1313,18247,18335,12199,6136,277
Plumas,5,2022-01-21,209,209,142,67,859,864,588,276,5
Riverside,5,2022-01-21,34549,34717,23726,10991,157883,158649,108732,49917,1112
Sacramento,5,2022-01-21,18430,18519,13328,5191,95786,96253,69512,26741,657
San Benito,5,2022-01-21,867,872,668,204,3984,4005,3075,930,9
San Bernardino,5,2022-01-21,29443,29586,23423,6163,149631,150359,119331,31028,1290
San Diego,5,2022-01-21,55332,55601,49894,5707,249226,250437,224853,25584,1326
San Francisco,5,2022-01-21,9358,9404,6544,2860,88341,88769,62144,26625,288
San Joaquin,5,2022-01-21,11492,11548,8493,3055,56592,56868,41883,14985,324
San Luis Obispo,5,2022-01-21,3633,3651,2734,917,20865,20968,15731,5237,51
San Mateo,5,2022-01-21,9844,9892,8134,1758,91938,92384,76277,16107,156
Santa Barbara,5,2022-01-21,6585,6616,4674,1942,41105,41305,29281,12024,151
Santa Clara,5,2022-01-21,24471,24590,22048,2542,222250,223331,200560,22771,563
Santa Cruz,5,2022-01-21,4865,4889,3801,1088,43602,43815,34150,9665,48
Shasta,5,2022-01-21,1476,1482,1020,462,9471,9518,6571,2947,83
Siskiyou,5,2022-01-21,159,159,118,41,833,837,624,213,7
Solano,5,2022-01-21,5472,5498,3923,1575,32621,32778,23456,9322,176
Sonoma,5,2022-01-21,7219,7254,5403,1851,41426,41627,31054,10573,119
Stanislaus,5,2022-01-21,6787,6820,4066,2754,27741,27875,16659,11216,305
Sutter,5,2022-01-21,1149,1155,786,369,5016,5040,3443,1597,0
Tehama,5,2022-01-21,592,594,334,260,2466,2478,1404,1074,21
Trinity,5,2022-01-21,63,63,38,25,288,288,171,117,0
Tulare,5,2022-01-21,7906,7943,4637,3306,28263,28400,16633,11767,143
Tuolumne,5,2022-01-21,930,936,603,333,3671,3689,2384,1305,14
Ventura,5,2022-01-21,10180,10229,8220,2009,64194,64506,52017,12489,385
Yolo,5,2022-01-21,2380,2392,1849,543,38486,38672,30021,8651,27
Yuba,5,2022-01-21,968,973,688,285,3776,3794,2689,1105,59
Alameda,6,2022-01-28,13133,13203,11061,2142,145795,146560,123123,23437,475
Amador,6,2022-01-28,395,395,271,124,3304,3321,2295,1026,18
Butte,6,2022-01-28,1325,1333,1142,191,7968,8011,6870,1141,91
Calaveras,6,2022-01-28,309,309,240,69,1975,1985,1552,433,5
Colusa,6,2022-01-28,119,119,89,30,680,683,512,171,3
Contra Costa,6,2022-01-28,8790,8836,6864,1972,73803,74190,57894,16296,311
Del Norte,6,2022-01-28,374,374,287,87,4193,4215,3252,963,10
El Dorado,6,2022-01-28,878,883,677,206,6199,6232,4795,1437,22
Fresno,6,2022-01-28,12432,12497,9082,3415,59420,59733,43481,16252,628
Glenn,6,2022-01-28,215,215,166,49,773,777,599,178,5
Humboldt,6,2022-01-28,647,650,501,149,6486,6521,5042,1479,28
Imperial,6,2022-01-28,2582,2595,1948,647,12249,12313,9282,3031,102
Inyo,6,2022-01-28,75,75,61,14,523,525,427,98,4
Kern,6,2022-01-28,6718,6753,5182,1571,44574,44808,34527,10281,319
Kings,6,2022-01-28,2839,2854,2039,815,15314,15394,11025,4369,49
Lake,6,2022-01-28,583,585,414,171,3365,3383,2411,972,9
Lassen,6,2022-01-28,329,329,265,64,3574,3593,2901,692,5
Los Angeles,6,2022-01-28,93818,94308,88808,5500,1357010,1364143,1286519,77624,4137
Madera,6,2022-01-28,1984,1994,1423,571,10111,10164,7279,2885,57
Marin,6,2022-01-28,1309,1316,1065,251,14583,14659,11897,2762,55
Mariposa,6,2022-01-28,108,108,76,32,859,864,611,253,0
Mendocino,6,2022-01-28,578,581,359,222,3697,3717,2315,1402,14
Merced,6,2022-01-28,2353,2366,1782,584,11129,11187,8447,2740,61
Modoc,6,2022-01-28,12,12,10,2,99,99,78,21,2
Mono,6,2022-01-28,51,51,34,17,348,348,237,111,0
Monterey,6,2022-01-28,4125,4145,3243,902,28073,28221,22117,6104,126
Napa,6,2022-01-28,1168,1174,909,265,9997,10050,7810,2240,29
Nevada,6,2022-01-28,737,740,533,207,4264,4287,3101,1186,33
Orange,6,2022-01-28,15513,15593,12943,2650,189557,190551,158896,31655,1025
Placer,6,2022-01-28,2761,2776,2048,728,16284,16370,12144,4226,261
Plumas,6,2022-01-28,157,157,117,40,713,718,541,177,5
Riverside,6,2022-01-28,20471,20577,15540,5037,130532,131218,99554,31664,1061
Sacramento,6,2022-01-28,12373,12437,9785,2652,83285,83721,66111,17610,605
San Benito,6,2022-01-28,539,542,448,94,3451,3468,2870,598,8
San Bernardino,6,2022-01-28,16395,16481,13926,2555,124893,125550,106411,19139,1109
San Diego,6,2022-01-28,31640,31805,29451,2354,200897,201949,187151,14798,1281
San Francisco,6,2022-01-28,5375,5403,4141,1262,77049,77454,59779,17675,292
San Joaquin,6,2022-01-28,6715,6750,5398,1352,46062,46305,37086,9219,328
San Luis Obispo,6,2022-01-28,2346,2359,1911,448,17406,17497,14208,3289,65
San Mateo,6,2022-01-28,5426,5454,4744,710,81215,81640,71232,10408,167
Santa Barbara,6,2022-01-28,4537,4562,3533,1029,37122,37316,29028,8288,127
Santa Clara,6,2022-01-28,16747,16833,15587,1246,212478,213594,198109,15485,579
Santa Cruz,6,2022-01-28,3950,3972,3304,668,52902,53180,44445,8735,45
Shasta,6,2022-01-28,1111,1117,848,269,8771,8818,6723,2095,94
Siskiyou,6,2022-01-28,123,123,99,24,701,704,570,134,12
Solano,6,2022-01-28,4014,4035,3165,870,29028,29180,22923,6257,182
Sonoma,6,2022-01-28,4548,4573,3685,888,34621,34803,28141,6662,102
Stanislaus,6,2022-01-28,4322,4345,2950,1395,23438,23561,16061,7500,346
Sutter,6,2022-01-28,749,754,569,185,4057,4078,3085,993,0
Tehama,6,2022-01-28,410,411,266,145,2152,2163,1411,752,24
Trinity,6,2022-01-28,35,35,24,11,242,242,162,80,0
Tulare,6,2022-01-28,5563,5593,3738,1855,24849,24979,16754,8225,161
Tuolumne,6,2022-01-28,876,880,637,243,3510,3528,2561,967,16
Ventura,6,2022-01-28,5925,5957,5086,871,56795,57092,48911,8181,333
Yolo,6,2022-01-28,1626,1635,1357,278,37538,37736,31467,6269,12
Yuba,6,2022-01-28,643,645,500,145,3172,3187,2481,706,88
Alameda,7,2022-02-04,7281,7325,6461,864,123434,124178,109863,14315,375
Amador,7,2022-02-04,248,248,188,60,3139,3157,2412,745,18
Butte,7,2022-02-04,879,884,793,91,6673,6713,6025,688,95
Calaveras,7,2022-02-04,219,219,183,36,1591,1599,1340,259,3
Colusa,7,2022-02-04,90,90,73,17,594,597,484,113,4
Contra Costa,7,2022-02-04,4778,4808,4018,790,58744,59097,49536,9561,271
Del Norte,7,2022-02-04,244,244,202,42,3905,3929,3263,666,4
El Dorado,7,2022-02-04,510,512,423,89,5247,5279,4374,905,27
Fresno,7,2022-02-04,7494,7539,5985,1554,46793,47074,37452,9622,596
Glenn,7,2022-02-04,142,142,118,24,644,648,537,111,4
Humboldt,7,2022-02-04,503,505,420,85,5049,5081,4234,847,22
Imperial,7,2022-02-04,1315,1323,1076,247,8952,9006,7350,1656,78
Inyo,7,2022-02-04,53,53,46,7,447,450,389,61,3
Kern,7,2022-02-04,4089,4114,3407,707,36765,36984,30705,6279,269
Kings,7,2022-02-04,1565,1575,1234,341,10940,11006,8651,2355,64
Lake,7,2022-02-04,393,393,307,86,2788,2804,2194,610,11
Lassen,7,2022-02-04,202,202,172,30,3244,3263,2800,463,5
Los Angeles,7,2022-02-04,46798,47076,45154,1922,1198769,1206012,1158196,47816,3118
Madera,7,2022-02-04,1277,1285,1008,277,8508,8559,6736,1823,60
Marin,7,2022-02-04,743,749,645,104,12218,12291,10599,1692,36
Mariposa,7,2022-02-04,64,64,50,14,655,660,512,148,0
Mendocino,7,2022-02-04,366,366,258,108,3039,3057,2160,897,15
Merced,7,2022-02-04,1352,1361,1109,252,8472,8523,6967,1556,71
Modoc,7,2022-02-04,23,23,20,3,156,156,133,23,3
Mono,7,2022-02-04,49,49,37,12,281,281,212,69,0
Monterey,7,2022-02-04,2494,2509,2107,402,23111,23249,19547,3702,90
Napa,7,2022-02-04,819,824,687,137,8151,8200,6850,1350,22
Nevada,7,2022-02-04,397,398,315,83,3308,3329,2638,691,36
Orange,7,2022-02-04,7858,7905,6934,971,158338,159293,140204,19089,696
Placer,7,2022-02-04,1620,1628,1309,319,13068,13145,10607,2538,207
Plumas,7,2022-02-04,98,98,80,18,566,570,464,106,1
Riverside,7,2022-02-04,10056,10116,8276,1840,102355,102968,84523,18445,817
Sacramento,7,2022-02-04,7184,7226,6098,1128,67489,67894,57421,10473,571
San Benito,7,2022-02-04,335,335,292,43,2813,2829,2474,355,8
San Bernardino,7,2022-02-04,8428,8479,7530,949,96540,97121,86434,10687,807
San Diego,7,2022-02-04,16459,16556,15699,857,160899,161865,153594,8271,1013
San Francisco,7,2022-02-04,2765,2781,2304,477,58712,59067,49144,9923,250
San Joaquin,7,2022-02-04,3853,3876,3307,569,38329,38559,32954,5605,257
San Luis Obispo,7,2022-02-04,1452,1458,1257,201,13591,13672,11798,1874,42
San Mateo,7,2022-02-04,2968,2985,2707,278,65129,65520,59561,5959,146
Santa Barbara,7,2022-02-04,2802,2818,2352,466,34033,34238,28658,5580,115
Santa Clara,7,2022-02-04,9730,9787,9276,511,182504,183604,174245,9359,491
Santa Cruz,7,2022-02-04,2031,2044,1797,247,39435,39674,34963,4711,30
Shasta,7,2022-02-04,738,743,611,132,7213,7256,5973,1283,81
Siskiyou,7,2022-02-04,105,105,90,15,698,702,603,99,6
Solano,7,2022-02-04,2881,2898,2427,471,26201,26360,22161,4199,134
Sonoma,7,2022-02-04,2357,2371,2037,334,28313,28483,24518,3965,96
Stanislaus,7,2022-02-04,2888,2905,2196,709,20039,20159,15269,4890,309
Sutter,7,2022-02-04,450,451,368,83,3500,3521,2885,636,0
Tehama,7,2022-02-04,344,344,250,94,1750,1760,1285,475,24
Trinity,7,2022-02-04,32,32,24,8,170,170,127,43,0
Tulare,7,2022-02-04,3234,3253,2424,829,18920,19034,14229,4805,168
Tuolumne,7,2022-02-04,424,426,337,89,2720,2736,2173,563,15
Ventura,7,2022-02-04,3187,3205,2869,336,44307,44573,39991,4582,273
Yolo,7,2022-02-04,928,935,820,115,33514,33718,29637,4081,15
Yuba,7,2022-02-04,410,411,343,68,2551,2566,2147,419,69
Alameda,8,2022-02-11,4200,4230,3876,354,104678,105419,96784,8635,311
Amador,8,2022-02-11,115,115,94,21,2422,2440,2014,426,17
Butte,8,2022-02-11,555,559,518,41,5637,5677,5265,412,81
Calaveras,8,2022-02-11,121,121,107,14,1300,1309,1156,153,9
Colusa,8,2022-02-11,49,49,42,7,507,510,440,70,4
Contra Costa,8,2022-02-11,2845,2865,2524,341,47090,47423,41890,5533,216
Del Norte,8,2022-02-11,258,258,225,33,3712,3739,3275,464,10
El Dorado,8,2022-02-11,317,317,277,40,4712,4745,4156,589,21
Fresno,8,2022-02-11,4450,4480,3804,676,37737,38003,32309,5694,524
Glenn,8,2022-02-11,63,63,55,8,497,500,438,62,4
Humboldt,8,2022-02-11,390,392,344,48,4523,4555,4004,551,19
Imperial,8,2022-02-11,732,737,637,100,6775,6823,5908,915,71
Inyo,8,2022-02-11,28,28,25,3,411,414,373,41,3
Kern,8,2022-02-11,2461,2477,2169,308,30306,30521,26762,3759,212
Kings,8,2022-02-11,937,945,794,151,8475,8536,7187,1349,51
Lake,8,2022-02-11,256,256,214,42,2434,2451,2057,394,12
Lassen,8,2022-02-11,123,123,110,13,2952,2974,2670,304,3
Los Angeles,8,2022-02-11,25854,26037,25303,734,1090800,1098554,1068361,30193,2337
Madera,8,2022-02-11,752,758,638,120,7126,7177,6050,1127,55
Marin,8,2022-02-11,459,461,415,46,10617,10692,9642,1050,30
Mariposa,8,2022-02-11,25,25,21,4,436,439,366,73,0
Mendocino,8,2022-02-11,246,246,190,56,2544,2562,1994,568,16
Merced,8,2022-02-11,883,891,771,120,7319,7370,6390,980,53
Modoc,8,2022-02-11,19,19,17,2,194,195,173,22,5
Mono,8,2022-02-11,15,15,12,3,194,194,158,36,0
Monterey,8,2022-02-11,1514,1524,1345,179,19250,19384,17142,2242,82
Napa,8,2022-02-11,493,497,436,61,6948,6997,6163,834,17
Nevada,8,2022-02-11,226,226,191,35,2753,2773,2348,425,21
Orange,8,2022-02-11,4667,4701,4291,410,137787,138762,126866,11896,499
Placer,8,2022-02-11,813,820,702,118,10673,10749,9235,1514,172
Plumas,8,2022-02-11,50,50,43,7,429,432,373,59,1
Riverside,8,2022-02-11,5666,5706,4953,753,80838,81409,70820,10589,565
Sacramento,8,2022-02-11,4160,4190,3716,474,56429,56827,50509,6318,470
San Benito,8,2022-02-11,226,226,205,21,2345,2361,2149,212,7
San Bernardino,8,2022-02-11,4684,4717,4341,376,78660,79219,73035,6184,562
San Diego,8,2022-02-11,9952,10022,9660,362,133860,134806,129998,4808,804
San Francisco,8,2022-02-11,1947,1961,1717,244,49710,50062,43971,6091,205
San Joaquin,8,2022-02-11,2349,2366,2115,251,32769,33001,29543,3458,206
San Luis Obispo,8,2022-02-11,900,906,816,90,10792,10869,9802,1067,27
San Mateo,8,2022-02-11,1675,1687,1576,111,57255,57661,53964,3697,83
Santa Barbara,8,2022-02-11,1346,1354,1191,163,23697,23865,21057,2808,80
Santa Clara,8,2022-02-11,5716,5755,5545,210,161065,162208,156460,5748,387
Santa Cruz,8,2022-02-11,1287,1295,1181,114,34485,34730,31778,2952,32
Shasta,8,2022-02-11,525,529,460,69,6224,6268,5460,808,82
Siskiyou,8,2022-02-11,76,76,68,8,586,590,530,60,5
Solano,8,2022-02-11,1435,1445,1277,168,20533,20678,18311,2367,106
Sonoma,8,2022-02-11,1437,1447,1299,148,23632,23800,21415,2385,67
Stanislaus,8,2022-02-11,1722,1734,1417,317,16511,16628,13630,2998,276
Sutter,8,2022-02-11,249,249,216,33,3001,3021,2624,397,0
Tehama,8,2022-02-11,193,193,154,39,1441,1452,1160,292,17
Trinity,8,2022-02-11,21,21,17,4,152,152,124,28,0
Tulare,8,2022-02-11,1856,1870,1512,358,16280,16396,13322,3074,167
Tuolumne,8,2022-02-11,218,218,185,33,2353,2369,2011,358,14
Ventura,8,2022-02-11,1936,1951,1806,145,38792,39066,36224,2842,217
Yolo,8,2022-02-11,643,650,592,58,29034,29239,26732,2507,11
Yuba,8,2022-02-11,246,246,217,29,2209,2224,1961,263,42
Alameda,9,2022-02-18,2368,2388,2247,141,91148,91900,86601,5299,249
Amador,9,2022-02-18,96,96,83,13,2111,2128,1857,271,9
Butte,9,2022-02-18,336,337,320,17,4696,4734,4494,240,66
Calaveras,9,2022-02-18,50,50,46,4,983,991,908,83,6
Colusa,9,2022-02-18,29,29,26,3,387,390,352,38,5
Contra Costa,9,2022-02-18,1753,1767,1617,150,40401,40733,37339,3394,158
Del Norte,9,2022-02-18,158,158,144,14,3077,3102,2828,274,7
El Dorado,9,2022-02-18,179,179,163,16,3993,4027,3671,356,13
Fresno,9,2022-02-18,2575,2596,2312,284,30783,31037,27691,3346,416
Glenn,9,2022-02-18,36,36,33,3,399,401,365,36,2
Humboldt,9,2022-02-18,249,249,227,22,3811,3842,3511,331,20
Imperial,9,2022-02-18,433,438,396,42,5181,5224,4726,498,49
Inyo,9,2022-02-18,15,15,14,1,374,376,350,26,1
Kern,9,2022-02-18,1453,1465,1335,130,25794,26005,23730,2275,134
Kings,9,2022-02-18,522,526,465,61,7043,7101,6293,808,33
Lake,9,2022-02-18,233,233,205,28,2211,2229,1971,258,9
Lassen,9,2022-02-18,163,163,151,12,2508,2528,2343,185,4
Los Angeles,9,2022-02-18,14701,14821,14531,290,995260,1003505,984459,19046,1610
Madera,9,2022-02-18,436,440,390,50,6065,6115,5422,693,42
Marin,9,2022-02-18,277,278,258,20,9811,9891,9205,686,26
Mariposa,9,2022-02-18,23,23,20,3,411,414,364,50,0
Mendocino,9,2022-02-18,146,146,122,24,2258,2277,1907,370,8
Merced,9,2022-02-18,562,567,512,55,6016,6066,5488,578,39
Modoc,9,2022-02-18,12,12,11,1,71,71,65,6,1
Mono,9,2022-02-18,9,9,8,1,172,172,149,23,0
Monterey,9,2022-02-18,948,955,876,79,15203,15327,14074,1253,62
Napa,9,2022-02-18,314,315,288,27,5679,5726,5239,487,9
Nevada,9,2022-02-18,136,136,121,15,2390,2410,2144,266,21
Orange,9,2022-02-18,2973,2997,2812,185,126929,127976,120257,7719,390
Placer,9,2022-02-18,403,406,364,42,9374,9451,8498,953,151
Plumas,9,2022-02-18,27,27,24,3,382,384,346,38,1
Riverside,9,2022-02-18,3196,3222,2917,305,67715,68272,61940,6332,399
Sacramento,9,2022-02-18,2458,2479,2280,199,49183,49589,45673,3916,362
San Benito,9,2022-02-18,131,131,123,8,2038,2056,1927,129,4
San Bernardino,9,2022-02-18,2427,2446,2309,137,66219,66765,63116,3649,410
San Diego,9,2022-02-18,5798,5845,5698,147,112987,113915,111091,2824,664
San Francisco,9,2022-02-18,1165,1174,1070,104,45535,45911,41934,3977,152
San Joaquin,9,2022-02-18,1398,1408,1301,107,27946,28177,26087,2090,140
San Luis Obispo,9,2022-02-18,606,611,568,43,9163,9239,8597,642,27
San Mateo,9,2022-02-18,948,956,912,44,50186,50599,48325,2274,64
Santa Barbara,9,2022-02-18,798,805,736,69,21961,22143,20284,1859,65
Santa Clara,9,2022-02-18,3221,3246,3164,82,141243,142408,138906,3502,332
Santa Cruz,9,2022-02-18,723,729,684,45,28615,28852,27133,1719,24
Shasta,9,2022-02-18,342,344,312,32,5461,5506,4999,507,79
Siskiyou,9,2022-02-18,61,61,57,4,546,551,511,40,11
Solano,9,2022-02-18,827,833,764,69,16574,16710,15346,1364,84
Sonoma,9,2022-02-18,818,825,765,60,19174,19333,17963,1370,49
Stanislaus,9,2022-02-18,968,976,846,130,13698,13811,12004,1807,213
Sutter,9,2022-02-18,167,167,151,16,2457,2476,2242,234,0
Tehama,9,2022-02-18,123,123,104,19,1268,1278,1089,189,14
Trinity,9,2022-02-18,16,16,14,2,223,223,193,30,0
Tulare,9,2022-02-18,1038,1047,901,146,12744,12848,11080,1768,116
Tuolumne,9,2022-02-18,132,132,117,15,1991,2006,1787,219,11
Ventura,9,2022-02-18,1067,1075,1019,56,31314,31572,29960,1612,144
Yolo,9,2022-02-18,339,340,319,21,24368,24570,23086,1484,10
Yuba,9,2022-02-18,162,162,148,14,1796,1810,1657,153,29
Alameda,10,2022-02-25,1520,1534,1471,63,69257,69934,67152,2782,170
Amador,10,2022-02-25,61,61,55,6,1837,1854,1685,169,10
Butte,10,2022-02-25,200,200,193,7,3989,4027,3885,142,48
Calaveras,10,2022-02-25,38,38,36,2,1077,1088,1025,63,1
Colusa,10,2022-02-25,13,13,12,1,365,368,343,25,3
Contra Costa,10,2022-02-25,997,1006,946,60,31523,31829,29982,1847,109
Del Norte,10,2022-02-25,89,89,83,6,2692,2718,2550,168,8
El Dorado,10,2022-02-25,115,115,108,7,3384,3418,3206,212,11
Fresno,10,2022-02-25,1437,1451,1339,112,25357,25603,23656,1947,320
Glenn,10,2022-02-25,19,19,18,1,387,389,364,25,1
Humboldt,10,2022-02-25,143,143,134,9,2799,2827,2656,171,11
Imperial,10,2022-02-25,265,267,249,18,4593,4637,4323,314,33
Inyo,10,2022-02-25,10,10,10,0,335,337,321,16,0
Kern,10,2022-02-25,932,940,881,59,23014,23238,21808,1430,105
Kings,10,2022-02-25,331,334,306,28,6310,6372,5855,517,22
Lake,10,2022-02-25,129,129,118,11,1819,1838,1687,151,5
Lassen,10,2022-02-25,76,76,72,4,2066,2086,1980,106,1
Los Angeles,10,2022-02-25,8846,8931,8811,120,922883,931935,919940,11995,1142
Madera,10,2022-02-25,208,208,191,17,4165,4205,3870,335,35
Marin,10,2022-02-25,151,151,144,7,7360,7430,7067,363,23
Mariposa,10,2022-02-25,33,33,30,3,333,337,308,29,0
Mendocino,10,2022-02-25,86,86,76,10,1723,1741,1537,204,12
Merced,10,2022-02-25,293,295,275,20,4757,4803,4481,322,32
Modoc,10,2022-02-25,6,6,6,0,50,50,47,3,1
Mono,10,2022-02-25,4,4,4,0,168,168,152,16,0
Monterey,10,2022-02-25,461,467,439,28,12623,12745,12015,730,37
Napa,10,2022-02-25,182,182,171,11,5057,5107,4804,303,9
Nevada,10,2022-02-25,75,75,69,6,1988,2007,1851,156,12
Orange,10,2022-02-25,1956,1975,1890,85,114708,115827,111026,4801,287
Placer,10,2022-02-25,285,286,265,21,8028,8104,7525,579,109
Plumas,10,2022-02-25,27,27,25,2,327,331,308,23,0
Riverside,10,2022-02-25,1806,1826,1705,121,59650,60228,56297,3931,304
Sacramento,10,2022-02-25,1302,1315,1240,75,41698,42102,39784,2318,274
San Benito,10,2022-02-25,66,66,63,3,1593,1608,1538,70,1
San Bernardino,10,2022-02-25,1331,1344,1291,53,56966,57518,55334,2184,247
San Diego,10,2022-02-25,3514,3547,3485,62,94144,95055,93438,1617,503
San Francisco,10,2022-02-25,874,882,827,55,36806,37164,34907,2257,111
San Joaquin,10,2022-02-25,752,759,719,40,23441,23669,22446,1223,98
San Luis Obispo,10,2022-02-25,330,332,316,16,7644,7719,7347,372,17
San Mateo,10,2022-02-25,546,552,535,17,35394,35739,34632,1107,58
Santa Barbara,10,2022-02-25,416,421,396,25,19160,19346,18211,1135,51
Santa Clara,10,2022-02-25,1838,1857,1825,32,83135,83943,82525,1418,260
Santa Cruz,10,2022-02-25,479,484,464,20,23868,24101,23112,989,19
Shasta,10,2022-02-25,175,175,164,11,4562,4606,4307,299,58
Siskiyou,10,2022-02-25,32,32,30,2,401,406,386,20,6
Solano,10,2022-02-25,524,530,499,31,14748,14890,14040,850,82
Sonoma,10,2022-02-25,466,472,448,24,15059,15204,14454,750,28
Stanislaus,10,2022-02-25,529,535,485,50,12059,12175,11045,1130,168
Sutter,10,2022-02-25,106,106,99,7,2208,2229,2082,147,0
Tehama,10,2022-02-25,67,67,60,7,1119,1129,1009,120,12
Trinity,10,2022-02-25,7,7,6,1,123,123,111,12,0
Tulare,10,2022-02-25,515,520,468,52,11093,11202,10110,1092,87
Tuolumne,10,2022-02-25,86,86,79,7,1449,1464,1351,113,9
Ventura,10,2022-02-25,652,659,635,24,27322,27588,26615,973,108
Yolo,10,2022-02-25,227,227,217,10,22480,22699,21755,944,8
Yuba,10,2022-02-25,84,84,79,5,1728,1745,1642,103,22
Alameda,11,2022-03-04,1198,1210,1175,35,74642,75471,73361,2110,149
Amador,11,2022-03-04,85,86,80,6,1614,1632,1523,109,6
Butte,11,2022-03-04,140,140,137,3,3652,3692,3601,91,33
Calaveras,11,2022-03-04,31,31,30,1,1117,1129,1083,46,1
Colusa,11,2022-03-04,8,8,8,0,347,350,333,17,6
Contra Costa,11,2022-03-04,671,678,650,28,32197,32555,31222,1333,99
Del Norte,11,2022-03-04,54,54,52,2,1853,1874,1792,82,4
El Dorado,11,2022-03-04,96,96,92,4,3261,3297,3152,145,6
Fresno,11,2022-03-04,992,1003,948,55,23046,23302,22047,1255,204
Glenn,11,2022-03-04,13,13,12,1,374,379,362,17,1
Humboldt,11,2022-03-04,118,118,113,5,3042,3076,2946,130,9
Imperial,11,2022-03-04,180,181,172,9,4454,4504,4290,214,23
Inyo,11,2022-03-04,10,10,10,0,367,370,358,12,1
Kern,11,2022-03-04,541,548,524,24,21354,21591,20655,936,80
Kings,11,2022-03-04,166,166,156,10,5063,5119,4827,292,14
Lake,11,2022-03-04,84,84,79,5,1829,1850,1743,107,3
Lassen,11,2022-03-04,83,84,81,3,1834,1854,1788,66,0
Los Angeles,11,2022-03-04,6166,6234,6176,58,889531,899448,891336,8112,881
Madera,11,2022-03-04,142,142,134,8,4095,4141,3906,235,22
Marin,11,2022-03-04,161,161,155,6,7739,7826,7560,266,10
Mariposa,11,2022-03-04,12,12,11,1,307,311,292,19,0
Mendocino,11,2022-03-04,72,72,66,6,1780,1800,1648,152,8
Merced,11,2022-03-04,220,221,210,11,4697,4750,4526,224,27
Modoc,11,2022-03-04,1,1,1,0,51,51,49,2,0
Mono,11,2022-03-04,4,4,4,0,123,123,115,8,1
Monterey,11,2022-03-04,274,276,265,11,11672,11802,11323,479,21
Napa,11,2022-03-04,194,195,187,8,5019,5074,4861,213,11
Nevada,11,2022-03-04,53,53,50,3,1774,1794,1695,99,6
Orange,11,2022-03-04,1348,1362,1321,41,109905,111128,107886,3242,201
Placer,11,2022-03-04,180,180,171,9,7831,7918,7520,398,106
Plumas,11,2022-03-04,6,6,6,0,279,281,267,14,0
Riverside,11,2022-03-04,1163,1177,1122,55,55693,56311,53718,2593,194
Sacramento,11,2022-03-04,878,887,852,35,40429,40879,39296,1583,186
San Benito,11,2022-03-04,35,35,34,1,1543,1561,1513,48,2
San Bernardino,11,2022-03-04,908,918,893,25,54261,54864,53407,1457,156
San Diego,11,2022-03-04,2575,2602,2571,31,97128,98205,97047,1158,360
San Francisco,11,2022-03-04,701,709,678,31,38428,38856,37192,1664,80
San Joaquin,11,2022-03-04,468,473,456,17,21390,21627,20838,789,68
San Luis Obispo,11,2022-03-04,298,301,291,10,7519,7602,7343,259,11
San Mateo,11,2022-03-04,571,578,565,13,42010,42477,41555,922,46
Santa Barbara,11,2022-03-04,233,233,223,10,18484,18689,17912,777,31
Santa Clara,11,2022-03-04,1559,1577,1558,19,117887,119197,117797,1400,235
Santa Cruz,11,2022-03-04,355,360,349,11,25116,25396,24660,736,18
Shasta,11,2022-03-04,144,144,137,7,4926,4981,4754,227,42
Siskiyou,11,2022-03-04,17,17,16,1,421,425,410,15,1
Solano,11,2022-03-04,382,387,371,16,14177,14334,13760,574,80
Sonoma,11,2022-03-04,396,402,388,14,15552,15724,15179,545,31
Stanislaus,11,2022-03-04,323,326,304,22,11133,11256,10508,748,122
Sutter,11,2022-03-04,93,93,89,4,2054,2076,1979,97,0
Tehama,11,2022-03-04,49,49,45,4,1189,1202,1111,91,7
Trinity,11,2022-03-04,6,6,6,0,102,102,95,7,0
Tulare,11,2022-03-04,368,372,346,26,10357,10471,9744,727,55
Tuolumne,11,2022-03-04,51,51,48,3,1298,1312,1240,72,4
Ventura,11,2022-03-04,419,425,414,11,27249,27553,26873,680,65
Yolo,11,2022-03-04,167,167,162,5,22891,23145,22463,682,7
Yuba,11,2022-03-04,71,71,68,3,1625,1644,1576,68,16
Alameda,12,2022-03-11,979,991,971,20,68377,69236,67898,1338,108
Amador,12,2022-03-11,31,31,30,1,1451,1470,1403,67,5
Butte,12,2022-03-11,74,74,73,1,3464,3508,3448,60,23
Calaveras,12,2022-03-11,17,17,17,0,1050,1063,1033,30,1
Colusa,12,2022-03-11,8,8,8,0,254,258,249,9,2
Contra Costa,12,2022-03-11,607,614,596,18,29056,29421,28585,836,83
Del Norte,12,2022-03-11,50,50,48,2,1508,1526,1479,47,5
El Dorado,12,2022-03-11,54,54,52,2,3016,3054,2961,93,7
Fresno,12,2022-03-11,622,630,606,24,21719,21990,21165,825,177
Glenn,12,2022-03-11,18,18,17,1,321,325,315,10,1
Humboldt,12,2022-03-11,61,61,59,2,2826,2862,2777,85,7
Imperial,12,2022-03-11,88,88,85,3,4652,4710,4554,156,13
Inyo,12,2022-03-11,10,10,10,0,167,167,163,4,1
Kern,12,2022-03-11,335,339,329,10,20214,20468,19852,616,67
Kings,12,2022-03-11,210,212,203,9,4798,4859,4666,193,19
Lake,12,2022-03-11,60,60,58,2,1618,1638,1571,67,0
Lassen,12,2022-03-11,26,26,25,1,1513,1531,1493,38,0
Los Angeles,12,2022-03-11,4475,4530,4501,29,848391,859067,853745,5322,615
Madera,12,2022-03-11,88,88,84,4,3748,3795,3644,151,15
Marin,12,2022-03-11,168,168,164,4,6546,6629,6472,157,20
Mariposa,12,2022-03-11,12,12,11,1,232,235,225,10,0
Mendocino,12,2022-03-11,41,41,38,3,1498,1516,1426,90,2
Merced,12,2022-03-11,146,146,141,5,4204,4257,4117,140,24
Modoc,12,2022-03-11,3,3,3,0,56,56,54,2,1
Mono,12,2022-03-11,1,1,1,0,110,110,105,5,0
Monterey,12,2022-03-11,188,189,184,5,10489,10621,10322,299,16
Napa,12,2022-03-11,153,153,148,5,4325,4379,4251,128,8
Nevada,12,2022-03-11,53,53,51,2,1607,1627,1565,62,6
Orange,12,2022-03-11,984,996,975,21,101952,103232,101151,2081,159
Placer,12,2022-03-11,157,157,151,6,7468,7562,7297,265,85
Plumas,12,2022-03-11,8,8,8,0,303,308,297,11,0
Riverside,12,2022-03-11,793,802,776,26,51766,52413,50738,1675,144
Sacramento,12,2022-03-11,626,634,617,17,36878,37340,36333,1007,145
San Benito,12,2022-03-11,30,30,29,1,1460,1478,1446,32,2
San Bernardino,12,2022-03-11,619,627,615,12,51411,52055,51099,956,131
San Diego,12,2022-03-11,2081,2107,2090,17,97143,98357,97558,799,253
San Francisco,12,2022-03-11,594,602,584,18,34988,35426,34372,1054,55
San Joaquin,12,2022-03-11,311,314,306,8,20433,20688,20164,524,45
San Luis Obispo,12,2022-03-11,162,163,159,4,6955,7043,6876,167,5
San Mateo,12,2022-03-11,477,484,477,7,37358,37826,37260,566,32
Santa Barbara,12,2022-03-11,197,197,191,6,17504,17724,17214,510,18
Santa Clara,12,2022-03-11,1181,1196,1186,10,101139,102407,101581,826,147
Santa Cruz,12,2022-03-11,255,258,253,5,23092,23382,22912,470,15
Shasta,12,2022-03-11,103,103,100,3,4985,5047,4886,161,21
Siskiyou,12,2022-03-11,17,17,17,0,390,395,385,10,0
Solano,12,2022-03-11,262,264,257,7,12898,13058,12694,364,63
Sonoma,12,2022-03-11,242,244,238,6,13981,14155,13814,341,23
Stanislaus,12,2022-03-11,252,255,243,12,10309,10437,9951,486,116
Sutter,12,2022-03-11,62,62,60,2,1802,1825,1766,59,0
Tehama,12,2022-03-11,28,28,26,2,1006,1019,965,54,1
Trinity,12,2022-03-11,2,2,2,0,103,103,98,5,0
Tulare,12,2022-03-11,219,221,210,11,9841,9964,9478,486,41
Tuolumne,12,2022-03-11,32,32,31,1,1244,1260,1212,48,3
Ventura,12,2022-03-11,360,367,361,6,25428,25746,25306,440,43
Yolo,12,2022-03-11,137,137,134,3,21492,21763,21320,443,5
Yuba,12,2022-03-11,46,46,45,1,1443,1461,1419,42,12
Alameda,13,2022-03-18,678,688,679,9,65960,66901,66007,894,72
Amador,13,2022-03-18,31,31,30,1,1403,1423,1378,45,2
Butte,13,2022-03-18,84,84,83,1,2962,3005,2970,35,12
Calaveras,13,2022-03-18,15,15,15,0,654,663,650,13,0
Colusa,13,2022-03-18,1,1,1,0,237,240,234,6,2
Contra Costa,13,2022-03-18,481,488,478,10,27599,27991,27438,553,67
Del Norte,13,2022-03-18,21,21,21,0,1281,1299,1271,28,2
El Dorado,13,2022-03-18,40,40,39,1,2853,2894,2833,61,1
Fresno,13,2022-03-18,371,377,367,10,20090,20376,19843,533,130
Glenn,13,2022-03-18,8,8,8,0,340,346,339,7,1
Humboldt,13,2022-03-18,37,37,36,1,2375,2410,2361,49,8
Imperial,13,2022-03-18,67,67,65,2,3958,4015,3923,92,8
Inyo,13,2022-03-18,1,1,1,0,155,155,152,3,0
Kern,13,2022-03-18,227,229,224,5,19016,19286,18883,403,43
Kings,13,2022-03-18,89,89,86,3,4483,4547,4421,126,8
Lake,13,2022-03-18,22,22,21,1,1452,1473,1431,42,1
Lassen,13,2022-03-18,10,10,10,0,1521,1542,1515,27,0
Los Angeles,13,2022-03-18,3913,3969,3952,17,822274,834043,830489,3554,514
Madera,13,2022-03-18,45,45,44,1,3417,3466,3371,95,13
Marin,13,2022-03-18,151,151,148,3,6327,6416,6311,105,17
Mariposa,13,2022-03-18,7,7,7,0,243,247,240,7,0
Mendocino,13,2022-03-18,33,33,32,1,1474,1494,1433,61,4
Merced,13,2022-03-18,96,96,94,2,3947,4004,3913,91,22
Modoc,13,2022-03-18,2,2,2,0,49,49,48,1,0
Mono,13,2022-03-18,2,2,2,0,130,130,126,4,1
Monterey,13,2022-03-18,145,145,142,3,10244,10391,10189,202,20
Napa,13,2022-03-18,72,72,70,2,3561,3611,3537,74,10
Nevada,13,2022-03-18,26,26,25,1,1482,1503,1463,40,1
Orange,13,2022-03-18,755,766,755,11,97180,98569,97196,1373,142
Placer,13,2022-03-18,113,113,110,3,6671,6766,6601,165,58
Plumas,13,2022-03-18,3,3,3,0,222,225,219,6,0
Riverside,13,2022-03-18,686,695,679,16,54123,54895,53678,1217,108
Sacramento,13,2022-03-18,504,511,501,10,32747,33213,32594,619,127
San Benito,13,2022-03-18,25,25,25,0,1405,1424,1403,21,2
San Bernardino,13,2022-03-18,490,497,491,6,50582,51304,50655,649,96
San Diego,13,2022-03-18,1590,1613,1604,9,88664,89924,89421,503,209
San Francisco,13,2022-03-18,626,635,622,13,33233,33707,33012,695,46
San Joaquin,13,2022-03-18,248,252,248,4,15684,15907,15628,279,41
San Luis Obispo,13,2022-03-18,116,116,114,2,6684,6778,6667,111,4
San Mateo,13,2022-03-18,397,404,400,4,34075,34560,34204,356,32
Santa Barbara,13,2022-03-18,191,193,189,4,16294,16526,16197,329,22
Santa Clara,13,2022-03-18,1020,1034,1028,6,95183,96544,96010,534,145
Santa Cruz,13,2022-03-18,216,219,216,3,20765,21063,20771,292,10
Shasta,13,2022-03-18,61,61,60,1,4223,4284,4189,95,17
Siskiyou,13,2022-03-18,11,11,11,0,366,370,364,6,1
Solano,13,2022-03-18,197,199,195,4,11643,11809,11581,228,49
Sonoma,13,2022-03-18,231,233,229,4,13323,13512,13288,224,14
Stanislaus,13,2022-03-18,154,155,150,5,8610,8733,8451,282,100
Sutter,13,2022-03-18,29,29,28,1,1467,1487,1453,34,0
Tehama,13,2022-03-18,10,10,10,0,908,921,887,34,1
Trinity,13,2022-03-18,1,1,1,0,92,92,89,3,0
Tulare,13,2022-03-18,136,137,132,5,8201,8318,8035,283,33
Tuolumne,13,2022-03-18,18,18,18,0,1184,1201,1169,32,2
Ventura,13,2022-03-18,301,306,302,4,23811,24150,23866,284,34
Yolo,13,2022-03-18,99,99,98,1,22349,22668,22350,318,3
Yuba,13,2022-03-18,35,35,34,1,1299,1318,1292,26,7
Alameda,14,2022-03-25,840,854,846,8,58307,59267,58721,546,76
Amador,14,2022-03-25,9,9,9,0,1305,1325,1296,29,2
Butte,14,2022-03-25,67,67,66,1,2770,2815,2792,23,18
Calaveras,14,2022-03-25,13,13,13,0,596,606,598,8,0
Colusa,14,2022-03-25,4,4,4,0,200,203,200,3,0
Contra Costa,14,2022-03-25,504,513,506,7,24879,25289,24945,344,67
Del Norte,14,2022-03-25,18,18,18,0,1036,1052,1036,16,0
El Dorado,14,2022-03-25,51,51,50,1,2746,2790,2749,41,0
Fresno,14,2022-03-25,309,315,309,6,18517,18820,18480,340,118
Glenn,14,2022-03-25,8,8,8,0,314,319,314,5,0
Humboldt,14,2022-03-25,30,30,30,0,2628,2673,2635,38,6
Imperial,14,2022-03-25,50,50,49,1,3638,3697,3638,59,7
Inyo,14,2022-03-25,2,2,2,0,167,169,167,2,0
Kern,14,2022-03-25,155,157,155,2,18320,18621,18351,270,24
Kings,14,2022-03-25,70,70,69,1,4388,4461,4376,85,4
Lake,14,2022-03-25,15,15,15,0,1150,1168,1145,23,0
Lassen,14,2022-03-25,6,6,6,0,1368,1389,1372,17,0
Los Angeles,14,2022-03-25,4247,4317,4304,13,783585,796540,794209,2331,446
Madera,14,2022-03-25,27,27,26,1,3352,3406,3341,65,8
Marin,14,2022-03-25,168,169,167,2,5884,5980,5912,68,7
Mariposa,14,2022-03-25,7,7,7,0,175,177,173,4,0
Mendocino,14,2022-03-25,34,34,33,1,1310,1331,1293,38,2
Merced,14,2022-03-25,67,67,66,1,3331,3388,3335,53,14
Modoc,14,2022-03-25,2,2,2,0,52,52,51,1,0
Mono,14,2022-03-25,3,3,3,0,127,128,125,3,0
Monterey,14,2022-03-25,171,173,171,2,9400,9555,9427,128,21
Napa,14,2022-03-25,58,58,57,1,3317,3372,3325,47,3
Nevada,14,2022-03-25,27,27,26,1,1479,1502,1474,28,1
Orange,14,2022-03-25,791,804,796,8,89551,91029,90157,872,121
Placer,14,2022-03-25,118,118,116,2,6126,6226,6121,105,51
Plumas,14,2022-03-25,1,1,1,0,274,279,274,5,0
Riverside,14,2022-03-25,510,518,510,8,44510,45241,44548,693,93
Sacramento,14,2022-03-25,468,476,470,6,31477,31994,31582,412,113
San Benito,14,2022-03-25,12,12,12,0,1309,1330,1317,13,0
San Bernardino,14,2022-03-25,487,494,490,4,41026,41701,41336,365,91
San Diego,14,2022-03-25,1316,1338,1333,5,74170,75385,75095,290,174
San Francisco,14,2022-03-25,767,779,768,11,32502,33039,32569,470,42
San Joaquin,14,2022-03-25,190,192,190,2,16543,16815,16612,203,34
San Luis Obispo,14,2022-03-25,101,101,100,1,5856,5953,5886,67,5
San Mateo,14,2022-03-25,494,503,499,4,34293,34856,34609,247,34
Santa Barbara,14,2022-03-25,115,115,113,2,8866,9013,8889,124,20
Santa Clara,14,2022-03-25,1199,1219,1214,5,90679,92176,91826,350,134
Santa Cruz,14,2022-03-25,142,143,142,1,18612,18921,18741,180,8
Shasta,14,2022-03-25,39,39,38,1,3847,3910,3850,60,11
Siskiyou,14,2022-03-25,6,6,6,0,305,311,307,4,0
Solano,14,2022-03-25,163,166,164,2,10828,11005,10858,147,41
Sonoma,14,2022-03-25,219,223,220,3,8219,8354,8258,96,17
Stanislaus,14,2022-03-25,128,129,126,3,7999,8130,7948,182,56
Sutter,14,2022-03-25,25,25,25,0,1496,1522,1498,24,0
Tehama,14,2022-03-25,13,13,13,0,787,802,781,21,3
Trinity,14,2022-03-25,0,0,0,0,99,99,97,2,0
Tulare,14,2022-03-25,98,98,96,2,7838,7967,7779,188,30
Tuolumne,14,2022-03-25,9,9,9,0,1089,1108,1088,20,2
Ventura,14,2022-03-25,313,318,315,3,21589,21943,21765,178,23
Yolo,14,2022-03-25,96,96,95,1,15173,15420,15267,153,2
Yuba,14,2022-03-25,31,31,31,0,1271,1291,1273,18,4
Alameda,15,2022-04-01,834,849,844,5,56170,57270,56907,363,63
Amador,15,2022-04-01,5,5,5,0,1186,1209,1190,19,1
Butte,15,2022-04-01,53,53,53,0,2486,2534,2520,14,9
Calaveras,15,2022-04-01,10,10,10,0,576,588,582,6,0
Colusa,15,2022-04-01,3,3,3,0,199,203,201,2,0
Contra Costa,15,2022-04-01,527,538,533,5,24456,24934,24700,234,54
Del Norte,15,2022-04-01,9,9,9,0,1124,1144,1132,12,0
El Dorado,15,2022-04-01,50,50,49,1,2768,2821,2793,28,1
Fresno,15,2022-04-01,200,204,201,3,17134,17468,17250,218,97
Glenn,15,2022-04-01,4,4,4,0,261,266,263,3,0
Humboldt,15,2022-04-01,18,18,18,0,2499,2548,2523,25,7
Imperial,15,2022-04-01,58,58,57,1,3471,3539,3500,39,6
Inyo,15,2022-04-01,7,7,7,0,183,187,186,1,0
Kern,15,2022-04-01,160,163,161,2,16889,17218,17046,172,24
Kings,15,2022-04-01,47,47,46,1,4114,4194,4139,55,4
Lake,15,2022-04-01,9,9,9,0,984,1003,989,14,0
Lassen,15,2022-04-01,4,4,4,0,1226,1249,1239,10,0
Los Angeles,15,2022-04-01,4910,5005,4995,10,730966,745445,743962,1483,334
Madera,15,2022-04-01,29,29,29,0,3263,3326,3282,44,6
Marin,15,2022-04-01,151,153,152,1,6398,6523,6472,51,15
Mariposa,15,2022-04-01,2,2,2,0,209,213,210,3,0
Mendocino,15,2022-04-01,21,21,21,0,1254,1279,1253,26,0
Merced,15,2022-04-01,57,57,56,1,3287,3351,3314,37,4
Modoc,15,2022-04-01,4,4,4,0,42,43,42,1,0
Mono,15,2022-04-01,2,2,2,0,157,159,156,3,0
Monterey,15,2022-04-01,120,121,120,1,7572,7720,7649,71,10
Napa,15,2022-04-01,59,59,58,1,3248,3311,3279,32,2
Nevada,15,2022-04-01,29,29,29,0,1376,1402,1384,18,3
Orange,15,2022-04-01,866,883,877,6,88215,89950,89356,594,88
Placer,15,2022-04-01,115,116,115,1,6527,6653,6576,77,44
Plumas,15,2022-04-01,5,5,5,0,223,228,225,3,0
Riverside,15,2022-04-01,591,603,597,6,39866,40644,40213,431,71
Sacramento,15,2022-04-01,431,440,436,4,32732,33371,33075,296,87
San Benito,15,2022-04-01,12,12,12,0,1227,1250,1241,9,0
San Bernardino,15,2022-04-01,556,568,565,3,41383,42194,41940,254,45
San Diego,15,2022-04-01,1480,1509,1505,4,66040,67325,67147,178,145
San Francisco,15,2022-04-01,914,931,922,9,28296,28847,28562,285,30
San Joaquin,15,2022-04-01,198,203,201,2,16095,16408,16270,138,22
San Luis Obispo,15,2022-04-01,98,98,97,1,5634,5744,5699,45,6
San Mateo,15,2022-04-01,627,639,636,3,29513,30090,29942,148,18
Santa Barbara,15,2022-04-01,168,171,169,2,15226,15526,15380,146,16
Santa Clara,15,2022-04-01,1396,1425,1421,4,90906,92686,92443,243,130
Santa Cruz,15,2022-04-01,182,185,184,1,20091,20486,20350,136,5
Shasta,15,2022-04-01,26,26,26,0,3515,3583,3545,38,7
Siskiyou,15,2022-04-01,6,6,6,0,307,313,310,3,1
Solano,15,2022-04-01,144,146,145,1,10347,10548,10450,98,38
Sonoma,15,2022-04-01,274,281,279,2,10649,10858,10773,85,13
Stanislaus,15,2022-04-01,103,103,101,2,7847,8000,7875,125,37
Sutter,15,2022-04-01,28,28,28,0,1310,1335,1321,14,0
Tehama,15,2022-04-01,6,6,6,0,761,776,762,14,0
Trinity,15,2022-04-01,1,1,1,0,86,86,85,1,0
Tulare,15,2022-04-01,55,55,54,1,7629,7778,7651,127,17
Tuolumne,15,2022-04-01,11,11,11,0,965,984,971,13,0
Ventura,15,2022-04-01,299,306,304,2,21019,21430,21311,119,21
Yolo,15,2022-04-01,66,66,66,0,30195,30783,30575,208,2
Yuba,15,2022-04-01,16,16,16,0,1035,1054,1044,10,6
Alameda,16,2022-04-08,1181,1210,1205,5,46818,47982,47773,209,82
Amador,16,2022-04-08,5,5,5,0,1097,1125,1113,12,1
Butte,16,2022-04-08,34,34,34,0,2081,2132,2124,8,7
Calaveras,16,2022-04-08,9,9,9,0,658,674,670,4,0
Colusa,16,2022-04-08,5,5,5,0,199,204,202,2,0
Contra Costa,16,2022-04-08,578,591,587,4,19291,19770,19642,128,50
Del Norte,16,2022-04-08,7,7,7,0,980,1003,996,7,1
El Dorado,16,2022-04-08,51,51,51,0,2547,2610,2592,18,1
Fresno,16,2022-04-08,199,205,203,2,16674,17085,16938,147,80
Glenn,16,2022-04-08,3,3,3,0,233,239,237,2,0
Humboldt,16,2022-04-08,36,36,36,0,2315,2372,2356,16,9
Imperial,16,2022-04-08,24,24,24,0,3472,3558,3531,27,4
Inyo,16,2022-04-08,6,6,6,0,193,198,197,1,0
Kern,16,2022-04-08,140,145,144,1,17381,17811,17689,122,22
Kings,16,2022-04-08,31,31,31,0,4224,4329,4290,39,3
Lake,16,2022-04-08,18,18,18,0,862,883,875,8,0
Lassen,16,2022-04-08,2,2,2,0,1304,1337,1329,8,1
Los Angeles,16,2022-04-08,6150,6302,6293,9,748154,766919,765863,1056,319
Madera,16,2022-04-08,26,26,26,0,3202,3281,3251,30,6
Marin,16,2022-04-08,186,190,189,1,5479,5614,5584,30,12
Mariposa,16,2022-04-08,10,10,10,0,256,262,259,3,0
Mendocino,16,2022-04-08,31,31,31,0,1138,1166,1150,16,0
Merced,16,2022-04-08,64,64,64,0,3303,3385,3360,25,9
Modoc,16,2022-04-08,1,1,1,0,47,48,47,1,0
Mono,16,2022-04-08,2,2,2,0,130,134,133,1,0
Monterey,16,2022-04-08,117,119,118,1,7212,7390,7343,47,11
Napa,16,2022-04-08,101,101,100,1,3057,3132,3111,21,3
Nevada,16,2022-04-08,33,33,33,0,1508,1545,1531,14,2
Orange,16,2022-04-08,1081,1107,1102,5,54197,55541,55287,254,92
Placer,16,2022-04-08,104,106,105,1,6192,6344,6293,51,45
Plumas,16,2022-04-08,2,2,2,0,257,263,261,2,0
Riverside,16,2022-04-08,703,721,716,5,37814,38749,38467,282,49
Sacramento,16,2022-04-08,460,472,469,3,31127,31896,31701,195,66
San Benito,16,2022-04-08,18,18,18,0,1184,1213,1207,6,0
San Bernardino,16,2022-04-08,806,825,822,3,41824,42864,42688,176,41
San Diego,16,2022-04-08,1796,1841,1838,3,72970,74777,74642,135,130
San Francisco,16,2022-04-08,1125,1152,1144,8,29698,30437,30231,206,39
San Joaquin,16,2022-04-08,227,232,231,1,15607,15992,15900,92,21
San Luis Obispo,16,2022-04-08,110,112,111,1,5056,5180,5152,28,2
San Mateo,16,2022-04-08,757,775,772,3,30378,31130,31025,105,11
Santa Barbara,16,2022-04-08,246,251,249,2,15181,15559,15458,101,7
Santa Clara,16,2022-04-08,1541,1578,1575,3,79262,81236,81090,146,109
Santa Cruz,16,2022-04-08,269,275,274,1,8360,8568,8529,39,9
Shasta,16,2022-04-08,16,16,16,0,3311,3393,3369,24,3
Siskiyou,16,2022-04-08,1,1,1,0,309,317,315,2,0
Solano,16,2022-04-08,212,217,216,1,9534,9770,9708,62,36
Sonoma,16,2022-04-08,387,397,395,2,10528,10788,10729,59,6
Stanislaus,16,2022-04-08,123,126,125,1,7795,7987,7901,86,31
Sutter,16,2022-04-08,23,23,23,0,1339,1371,1361,10,0
Tehama,16,2022-04-08,11,11,11,0,748,767,758,9,0
Trinity,16,2022-04-08,0,0,0,0,74,74,73,1,0
Tulare,16,2022-04-08,46,46,45,1,7948,8145,8053,92,11
Tuolumne,16,2022-04-08,16,16,16,0,1093,1119,1109,10,0
Ventura,16,2022-04-08,296,303,302,1,18058,18505,18434,71,23
Yolo,16,2022-04-08,92,93,93,0,18745,19211,19122,89,1
Yuba,16,2022-04-08,13,13,13,0,1074,1100,1093,7,6
Alameda,17,2022-04-15,1585,1639,1634,5,52034,53820,53659,161,75
Amador,17,2022-04-15,8,8,8,0,1149,1188,1179,9,2
Butte,17,2022-04-15,51,51,51,0,2031,2101,2095,6,4
Calaveras,17,2022-04-15,16,16,16,0,610,631,628,3,0
Colusa,17,2022-04-15,4,4,4,0,161,166,165,1,0
Contra Costa,17,2022-04-15,928,960,956,4,24695,25541,25428,113,47
Del Norte,17,2022-04-15,14,14,14,0,1034,1070,1065,5,0
El Dorado,17,2022-04-15,46,46,46,0,2378,2460,2448,12,0
Fresno,17,2022-04-15,187,194,193,1,13425,13880,13798,82,58
Glenn,17,2022-04-15,3,3,3,0,237,245,244,1,0
Humboldt,17,2022-04-15,70,71,71,0,1984,2051,2041,10,9
Imperial,17,2022-04-15,43,43,43,0,3309,3422,3404,18,2
Inyo,17,2022-04-15,1,1,1,0,155,160,159,1,0
Kern,17,2022-04-15,127,132,131,1,13340,13796,13731,65,21
Kings,17,2022-04-15,39,39,39,0,3591,3713,3690,23,2
Lake,17,2022-04-15,16,16,16,0,814,840,835,5,2
Lassen,17,2022-04-15,2,2,2,0,1312,1356,1351,5,0
Los Angeles,17,2022-04-15,7165,7409,7402,7,363488,375909,375548,361,306
Madera,17,2022-04-15,22,22,22,0,2599,2689,2672,17,7
Marin,17,2022-04-15,265,274,273,1,6110,6319,6296,23,7
Mariposa,17,2022-04-15,10,10,10,0,254,262,260,2,0
Mendocino,17,2022-04-15,37,37,37,0,1282,1327,1315,12,2
Merced,17,2022-04-15,74,75,75,0,3177,3285,3268,17,9
Modoc,17,2022-04-15,1,1,1,0,38,39,38,1,0
Mono,17,2022-04-15,10,10,10,0,178,184,183,1,0
Monterey,17,2022-04-15,111,114,114,0,6351,6567,6538,29,5
Napa,17,2022-04-15,133,139,138,1,2716,2810,2797,13,1
Nevada,17,2022-04-15,42,43,43,0,1243,1286,1278,8,2
Orange,17,2022-04-15,1326,1371,1367,4,81872,84688,84423,265,79
Placer,17,2022-04-15,151,156,155,1,4812,4976,4949,27,54
Plumas,17,2022-04-15,9,9,9,0,212,218,217,1,0
Riverside,17,2022-04-15,817,845,841,4,37107,38373,38181,192,60
Sacramento,17,2022-04-15,597,617,614,3,27916,28869,28748,121,68
San Benito,17,2022-04-15,21,21,21,0,1174,1215,1211,4,0
San Bernardino,17,2022-04-15,982,1016,1013,3,39077,40413,40298,115,48
San Diego,17,2022-04-15,1838,1900,1898,2,68824,71155,71066,89,108
San Francisco,17,2022-04-15,1248,1289,1283,6,29891,30922,30779,143,37
San Joaquin,17,2022-04-15,206,211,210,1,14753,15251,15191,60,20
San Luis Obispo,17,2022-04-15,135,140,139,1,4800,4963,4945,18,2
San Mateo,17,2022-04-15,1012,1046,1044,2,29484,30494,30424,70,22
Santa Barbara,17,2022-04-15,317,329,328,1,14792,15301,15233,68,7
Santa Clara,17,2022-04-15,1885,1949,1947,2,74018,76544,76449,95,91
Santa Cruz,17,2022-04-15,396,409,408,1,12632,13052,13010,42,4
Shasta,17,2022-04-15,21,21,21,0,2833,2930,2916,14,4
Siskiyou,17,2022-04-15,2,2,2,0,324,336,335,1,1
Solano,17,2022-04-15,216,223,222,1,9078,9387,9346,41,26
Sonoma,17,2022-04-15,472,486,484,2,11426,11815,11771,44,14
Stanislaus,17,2022-04-15,140,145,144,1,7864,8129,8069,60,36
Sutter,17,2022-04-15,17,17,17,0,1171,1211,1205,6,0
Tehama,17,2022-04-15,6,6,6,0,669,692,686,6,1
Trinity,17,2022-04-15,0,0,0,0,77,78,77,1,0
Tulare,17,2022-04-15,69,71,70,1,6817,7049,6994,55,14
Tuolumne,17,2022-04-15,25,25,25,0,1058,1093,1086,7,0
Ventura,17,2022-04-15,351,363,362,1,15899,16440,16397,43,14
Yolo,17,2022-04-15,111,114,114,0,18900,19551,19489,62,2
Yuba,17,2022-04-15,19,19,19,0,989,1022,1017,5,1
Alameda,18,2022-04-22,1883,1999,1995,4,52688,55979,55865,114,88
Amador,18,2022-04-22,15,15,15,0,1311,1392,1385,7,0
Butte,18,2022-04-22,27,27,27,0,2170,2302,2298,4,8
Calaveras,18,2022-04-22,17,17,17,0,607,645,643,2,0
Colusa,18,2022-04-22,4,4,4,0,172,182,181,1,0
Contra Costa,18,2022-04-22,1226,1301,1297,4,24871,26415,26335,80,55
Del Norte,18,2022-04-22,17,17,17,0,1059,1124,1120,4,1
El Dorado,18,2022-04-22,83,89,89,0,2556,2714,2705,9,1
Fresno,18,2022-04-22,315,334,333,1,15200,16123,16057,66,55
Glenn,18,2022-04-22,3,3,3,0,250,264,263,1,0
Humboldt,18,2022-04-22,148,156,156,0,2538,2696,2688,8,7
Imperial,18,2022-04-22,49,51,51,0,3287,3486,3474,12,5
Inyo,18,2022-04-22,6,6,6,0,182,194,193,1,1
Kern,18,2022-04-22,193,204,203,1,16747,17780,17723,57,20
Kings,18,2022-04-22,52,56,56,0,4388,4658,4638,20,2
Lake,18,2022-04-22,18,18,18,0,777,825,821,4,2
Lassen,18,2022-04-22,0,0,0,0,1475,1564,1560,4,0
Los Angeles,18,2022-04-22,9624,10217,10210,7,818539,870312,869748,564,261
Madera,18,2022-04-22,21,21,21,0,2777,2946,2933,13,7
Marin,18,2022-04-22,320,338,337,1,5948,6317,6301,16,15
Mariposa,18,2022-04-22,14,14,14,0,216,228,227,1,0
Mendocino,18,2022-04-22,53,55,55,0,1211,1286,1278,8,2
Merced,18,2022-04-22,76,81,81,0,2820,2993,2982,11,7
Modoc,18,2022-04-22,1,1,1,0,34,37,36,1,0
Mono,18,2022-04-22,8,8,8,0,98,104,103,1,0
Monterey,18,2022-04-22,215,227,226,1,7325,7775,7752,23,5
Napa,18,2022-04-22,184,195,194,1,3277,3482,3471,11,0
Nevada,18,2022-04-22,41,44,44,0,1289,1367,1361,6,4
Orange,18,2022-04-22,1698,1803,1799,4,82480,87680,87493,187,66
Placer,18,2022-04-22,177,189,188,1,5587,5932,5910,22,41
Plumas,18,2022-04-22,2,2,2,0,231,244,243,1,0
Riverside,18,2022-04-22,1056,1119,1115,4,38377,40743,40604,139,68
Sacramento,18,2022-04-22,858,911,908,3,29942,31784,31693,91,58
San Benito,18,2022-04-22,29,29,29,0,1134,1203,1200,3,0
San Bernardino,18,2022-04-22,1135,1204,1202,2,41106,43652,43567,85,44
San Diego,18,2022-04-22,2538,2695,2693,2,71759,76171,76106,65,117
San Francisco,18,2022-04-22,1656,1756,1750,6,30422,32308,32205,103,48
San Joaquin,18,2022-04-22,302,319,318,1,15154,16066,16023,43,16
San Luis Obispo,18,2022-04-22,190,201,200,1,5014,5320,5307,13,4
San Mateo,18,2022-04-22,1282,1359,1357,2,31234,33150,33098,52,23
Santa Barbara,18,2022-04-22,307,324,323,1,14700,15617,15569,48,7
Santa Clara,18,2022-04-22,2583,2739,2737,2,68177,72412,72351,61,101
Santa Cruz,18,2022-04-22,433,458,457,1,19207,20432,20389,43,4
Shasta,18,2022-04-22,50,53,53,0,2566,2721,2712,9,7
Siskiyou,18,2022-04-22,8,8,8,0,301,319,318,1,0
Solano,18,2022-04-22,370,393,392,1,9885,10492,10461,31,25
Sonoma,18,2022-04-22,559,593,591,2,11467,12174,12143,31,20
Stanislaus,18,2022-04-22,179,190,189,1,7156,7587,7549,38,30
Sutter,18,2022-04-22,30,32,32,0,1284,1364,1359,5,0
Tehama,18,2022-04-22,9,9,9,0,586,622,618,4,1
Trinity,18,2022-04-22,2,2,2,0,72,77,76,1,0
Tulare,18,2022-04-22,74,79,79,0,6852,7272,7233,39,11
Tuolumne,18,2022-04-22,25,25,25,0,1076,1142,1137,5,0
Ventura,18,2022-04-22,470,499,498,1,18120,19242,19207,35,16
Yolo,18,2022-04-22,165,174,174,0,18437,19606,19564,42,0
Yuba,18,2022-04-22,30,30,30,0,1089,1155,1151,4,0
Alameda,19,2022-04-27,1154,1358,1356,2,28534,33806,33755,51,87
Amador,19,2022-04-27,15,16,16,0,534,626,624,2,0
Butte,19,2022-04-27,47,56,56,0,1109,1313,1311,2,4
Calaveras,19,2022-04-27,20,24,24,0,326,390,389,1,1
Colusa,19,2022-04-27,0,0,0,0,83,100,99,1,0
Contra Costa,19,2022-04-27,657,771,769,2,12811,15114,15080,34,63
Del Norte,19,2022-04-27,9,10,10,0,531,621,619,2,1
El Dorado,19,2022-04-27,44,51,51,0,1142,1348,1345,3,1
Fresno,19,2022-04-27,153,183,182,1,7296,8604,8578,26,59
Glenn,19,2022-04-27,2,2,2,0,159,187,186,1,0
Humboldt,19,2022-04-27,58,69,69,0,1139,1352,1349,3,6
Imperial,19,2022-04-27,35,41,41,0,2065,2464,2458,6,4
Inyo,19,2022-04-27,3,3,3,0,115,140,139,1,0
Kern,19,2022-04-27,79,92,92,0,7903,9313,9291,22,16
Kings,19,2022-04-27,27,32,32,0,1999,2377,2369,8,4
Lake,19,2022-04-27,11,13,13,0,512,617,615,2,0
Lassen,19,2022-04-27,1,1,1,0,715,836,834,2,0
Los Angeles,19,2022-04-27,4307,4988,4986,2,131005,150580,150505,75,314
Madera,19,2022-04-27,31,35,35,0,1417,1674,1669,5,10
Marin,19,2022-04-27,164,195,195,0,3053,3609,3602,7,9
Mariposa,19,2022-04-27,2,2,2,0,87,105,104,1,0
Mendocino,19,2022-04-27,27,32,32,0,609,732,728,4,0
Merced,19,2022-04-27,43,49,49,0,1392,1646,1642,4,4
Modoc,19,2022-04-27,0,0,0,0,20,24,23,1,0
Mono,19,2022-04-27,1,1,1,0,46,56,55,1,0
Monterey,19,2022-04-27,154,179,179,0,3930,4641,4631,10,8
Napa,19,2022-04-27,88,105,105,0,1449,1721,1717,4,5
Nevada,19,2022-04-27,17,20,20,0,628,737,735,2,2
Orange,19,2022-04-27,1020,1195,1193,2,40261,48267,48191,76,75
Placer,19,2022-04-27,113,132,132,0,2979,3506,3496,10,44
Plumas,19,2022-04-27,4,4,4,0,143,181,180,1,1
Riverside,19,2022-04-27,524,616,614,2,18191,21508,21454,54,56
Sacramento,19,2022-04-27,449,529,528,1,14020,16483,16448,35,64
San Benito,19,2022-04-27,15,16,16,0,635,769,768,1,0
San Bernardino,19,2022-04-27,459,538,537,1,18145,21379,21348,31,48
San Diego,19,2022-04-27,1530,1793,1792,1,35806,42228,42201,27,117
San Francisco,19,2022-04-27,894,1057,1054,3,15330,18119,18076,43,40
San Joaquin,19,2022-04-27,171,204,204,0,6774,8003,7987,16,21
San Luis Obispo,19,2022-04-27,126,150,150,0,2594,3069,3063,6,4
San Mateo,19,2022-04-27,663,775,774,1,16044,18993,18971,22,21
Santa Barbara,19,2022-04-27,185,219,218,1,7472,8917,8897,20,13
Santa Clara,19,2022-04-27,1599,1877,1876,1,37815,44608,44580,28,92
Santa Cruz,19,2022-04-27,175,203,203,0,6959,8109,8096,13,7
Shasta,19,2022-04-27,16,18,18,0,1233,1439,1435,4,5
Siskiyou,19,2022-04-27,3,3,3,0,142,171,170,1,0
Solano,19,2022-04-27,239,281,280,1,4642,5464,5452,12,36
Sonoma,19,2022-04-27,292,344,343,1,4939,5830,5819,11,17
Stanislaus,19,2022-04-27,110,129,129,0,3931,4658,4641,17,36
Sutter,19,2022-04-27,29,35,35,0,712,852,850,2,0
Tehama,19,2022-04-27,6,6,6,0,238,276,275,1,1
Trinity,19,2022-04-27,0,0,0,0,30,39,38,1,0
Tulare,19,2022-04-27,38,45,45,0,3007,3551,3537,14,11
Tuolumne,19,2022-04-27,32,40,40,0,588,703,701,2,2
Ventura,19,2022-04-27,264,309,309,0,9135,10834,10820,14,19
Yolo,19,2022-04-27,72,83,83,0,7728,9111,9096,15,2
Yuba,19,2022-04-27,17,20,20,0,512,610,609,1,2
