county,time,date,cases,est_cases,est_omicron_cases,est_other_cases,tests,est_tests,est_omicron_tests,est_other_tests,hospitalizations
Alameda,1,2021-12-25,5410,5423,2693,2730,83117,83325,41001,42324,86
Amador,1,2021-12-25,76,76,28,48,1474,1478,530,948,4
Butte,1,2021-12-25,347,347,188,159,3808,3818,2034,1784,31
Calaveras,1,2021-12-25,72,72,29,43,965,967,381,586,2
Colusa,1,2021-12-25,15,15,6,9,239,239,97,142,2
Contra Costa,1,2021-12-25,3266,3275,1257,2018,43046,43154,16372,26782,49
Del Norte,1,2021-12-25,20,20,9,11,1225,1229,525,704,0
El Dorado,1,2021-12-25,386,386,151,235,4121,4131,1584,2547,11
Fresno,1,2021-12-25,1526,1531,560,971,22566,22623,8171,14452,152
Glenn,1,2021-12-25,37,37,15,22,412,412,170,242,0
Humboldt,1,2021-12-25,334,334,140,194,3141,3149,1278,1871,10
Imperial,1,2021-12-25,658,658,254,404,5430,5444,2093,3351,51
Inyo,1,2021-12-25,81,81,39,42,419,419,197,222,0
Kern,1,2021-12-25,1205,1207,499,708,19629,19679,8044,11635,98
Kings,1,2021-12-25,352,352,131,221,5355,5367,1959,3408,20
Lake,1,2021-12-25,43,43,15,28,1144,1148,400,748,0
Lassen,1,2021-12-25,19,19,9,10,2322,2329,1062,1267,0
Los Angeles,1,2021-12-25,66389,66558,48264,18294,659905,661565,477558,184007,904
Madera,1,2021-12-25,209,209,78,131,4152,4163,1509,2654,12
Marin,1,2021-12-25,1161,1163,461,702,14380,14416,5689,8727,4
Mariposa,1,2021-12-25,31,31,11,20,504,504,184,320,0
Mendocino,1,2021-12-25,86,86,25,61,2497,2502,715,1787,6
Merced,1,2021-12-25,428,428,172,256,4860,4872,1939,2933,2
Modoc,1,2021-12-25,5,5,2,3,57,57,24,33,2
Mono,1,2021-12-25,93,93,30,63,356,356,112,244,1
Monterey,1,2021-12-25,722,722,197,525,12220,12251,3277,8974,35
Napa,1,2021-12-25,559,559,237,322,5566,5580,2340,3240,5
Nevada,1,2021-12-25,204,204,72,132,2513,2518,872,1646,6
Orange,1,2021-12-25,10816,10843,4592,6251,106596,106865,44776,62089,256
Placer,1,2021-12-25,920,920,314,606,10314,10340,3466,6874,82
Plumas,1,2021-12-25,11,11,4,7,395,395,140,255,0
Riverside,1,2021-12-25,9320,9345,3371,5974,76506,76698,27296,49402,357
Sacramento,1,2021-12-25,3401,3410,1423,1987,47935,48054,19834,28220,158
San Benito,1,2021-12-25,204,204,96,108,2097,2101,978,1123,5
San Bernardino,1,2021-12-25,8885,8908,4383,4525,79722,79922,38901,41021,421
San Diego,1,2021-12-25,17471,17514,12213,5301,156996,157390,109250,48140,355
San Francisco,1,2021-12-25,5595,5609,1806,3803,62128,62286,19926,42360,34
San Joaquin,1,2021-12-25,1556,1562,616,946,20818,20872,8112,12760,74
San Luis Obispo,1,2021-12-25,718,718,326,392,10144,10170,4573,5597,22
San Mateo,1,2021-12-25,3547,3556,1867,1689,50459,50585,26297,24288,18
Santa Barbara,1,2021-12-25,1417,1423,596,827,13837,13872,5714,8158,37
Santa Clara,1,2021-12-25,6176,6191,4288,1903,97868,98113,67450,30663,114
Santa Cruz,1,2021-12-25,655,655,316,339,11583,11611,5509,6102,14
Shasta,1,2021-12-25,198,198,71,127,4589,4601,1620,2981,37
Siskiyou,1,2021-12-25,15,15,7,8,344,344,161,183,0
Solano,1,2021-12-25,847,848,359,489,15109,15148,6363,8785,29
Sonoma,1,2021-12-25,1330,1332,563,769,18923,18970,7898,11072,16
Stanislaus,1,2021-12-25,882,882,278,604,10381,10406,3227,7179,104
Sutter,1,2021-12-25,177,177,70,107,2013,2017,788,1229,0
Tehama,1,2021-12-25,64,64,19,45,1047,1050,302,748,11
Trinity,1,2021-12-25,3,3,1,2,96,96,32,64,0
Tulare,1,2021-12-25,561,561,172,389,10434,10460,3135,7325,47
Tuolumne,1,2021-12-25,133,133,49,84,1743,1748,630,1118,5
Ventura,1,2021-12-25,3580,3589,1914,1675,34020,34104,17994,16110,74
Yolo,1,2021-12-25,544,544,258,286,20050,20100,9401,10699,7
Yuba,1,2021-12-25,116,116,49,67,1501,1505,623,882,11
Alameda,2,2022-01-01,13875,13912,7902,6010,102092,102366,57959,44407,150
Amador,2,2022-01-01,148,148,64,84,1850,1854,799,1055,7
Butte,2,2022-01-01,895,895,545,350,5681,5697,3452,2245,30
Calaveras,2,2022-01-01,170,170,80,90,1148,1152,538,614,3
Colusa,2,2022-01-01,53,53,25,28,299,299,143,156,4
Contra Costa,2,2022-01-01,11112,11142,5053,6089,59679,59840,27037,32803,85
Del Norte,2,2022-01-01,61,61,31,30,1963,1968,982,986,0
El Dorado,2,2022-01-01,1002,1004,462,542,5333,5346,2446,2900,17
Fresno,2,2022-01-01,5028,5042,2192,2850,34833,34927,15132,19795,188
Glenn,2,2022-01-01,68,68,33,35,517,517,251,266,0
Humboldt,2,2022-01-01,721,721,349,372,4664,4676,2250,2426,10
Imperial,2,2022-01-01,1501,1505,689,816,8206,8228,3762,4466,57
Inyo,2,2022-01-01,207,207,113,94,598,598,325,273,3
Kern,2,2022-01-01,4272,4283,2083,2200,30062,30143,14532,15611,121
Kings,2,2022-01-01,872,872,384,488,7435,7455,3264,4191,17
Lake,2,2022-01-01,144,144,61,83,1470,1474,618,856,1
Lassen,2,2022-01-01,45,45,24,21,2511,2517,1326,1191,2
Los Angeles,2,2022-01-01,175191,175663,136713,38950,911866,914313,711168,203145,1792
Madera,2,2022-01-01,661,661,289,372,5686,5701,2475,3226,13
Marin,2,2022-01-01,2211,2216,1027,1189,17588,17636,8154,9482,19
Mariposa,2,2022-01-01,73,73,32,41,533,534,233,301,0
Mendocino,2,2022-01-01,325,325,115,210,2901,2908,1020,1888,6
Merced,2,2022-01-01,1223,1227,580,647,7403,7423,3509,3914,22
Modoc,2,2022-01-01,11,11,6,5,52,52,26,26,0
Mono,2,2022-01-01,170,170,64,106,386,387,147,240,2
Monterey,2,2022-01-01,1975,1980,658,1322,17496,17543,5804,11739,29
Napa,2,2022-01-01,1518,1522,749,773,10129,10156,4991,5165,10
Nevada,2,2022-01-01,471,471,200,271,2183,2189,926,1263,6
Orange,2,2022-01-01,39440,39546,19512,20034,199486,200022,98473,101549,522
Placer,2,2022-01-01,2381,2387,977,1410,14038,14075,5707,8368,124
Plumas,2,2022-01-01,36,36,16,20,352,352,150,202,2
Riverside,2,2022-01-01,26662,26734,11473,15261,125616,125952,53824,72128,545
Sacramento,2,2022-01-01,11302,11331,5545,5786,71518,71711,34945,36766,243
San Benito,2,2022-01-01,617,617,333,284,3032,3041,1640,1401,5
San Bernardino,2,2022-01-01,28019,28094,15799,12295,122892,123222,69185,54037,624
San Diego,2,2022-01-01,53218,53361,40251,13110,229966,230584,173748,56836,628
San Francisco,2,2022-01-01,9653,9680,3761,5919,74985,75186,29127,46059,84
San Joaquin,2,2022-01-01,5515,5530,2578,2952,32321,32409,14993,17416,94
San Luis Obispo,2,2022-01-01,2118,2122,1111,1011,14800,14840,7771,7069,19
San Mateo,2,2022-01-01,8993,9017,5352,3665,67504,67685,40094,27591,34
Santa Barbara,2,2022-01-01,4182,4193,2049,2144,22303,22362,10893,11469,57
Santa Clara,2,2022-01-01,17642,17689,13274,4415,134009,134369,100541,33828,198
Santa Cruz,2,2022-01-01,1857,1863,1032,831,15281,15322,8419,6903,21
Shasta,2,2022-01-01,439,439,189,250,5442,5457,2313,3144,13
Siskiyou,2,2022-01-01,57,57,31,26,456,456,246,210,0
Solano,2,2022-01-01,3491,3499,1731,1768,24086,24150,11903,12247,62
Sonoma,2,2022-01-01,3696,3706,1824,1882,27936,28011,13707,14304,29
Stanislaus,2,2022-01-01,2636,2643,1010,1633,15970,16013,6056,9957,120
Sutter,2,2022-01-01,402,402,188,214,2617,2623,1217,1406,0
Tehama,2,2022-01-01,169,169,60,109,1173,1177,414,763,4
Trinity,2,2022-01-01,9,9,4,5,101,101,40,61,0
Tulare,2,2022-01-01,1605,1610,598,1012,14668,14707,5394,9313,53
Tuolumne,2,2022-01-01,284,284,124,160,1902,1907,825,1082,6
Ventura,2,2022-01-01,11375,11406,6872,4534,55652,55801,33517,22284,124
Yolo,2,2022-01-01,1627,1632,892,740,25313,25381,13732,11649,10
Yuba,2,2022-01-01,358,358,177,181,2056,2061,1009,1052,22
Alameda,3,2022-01-08,31039,31129,19952,11177,191101,191657,122725,68932,307
Amador,3,2022-01-08,374,374,189,185,2778,2787,1402,1385,6
Butte,3,2022-01-08,1928,1935,1309,626,9996,10026,6775,3251,47
Calaveras,3,2022-01-08,454,454,249,205,2435,2441,1329,1112,2
Colusa,3,2022-01-08,77,77,43,34,658,658,364,294,5
Contra Costa,3,2022-01-08,18926,18982,10026,8956,102128,102425,54132,48293,172
Del Norte,3,2022-01-08,161,161,93,68,3855,3866,2244,1622,2
El Dorado,3,2022-01-08,2116,2121,1131,990,8873,8898,4743,4155,18
Fresno,3,2022-01-08,12025,12060,6163,5897,57985,58154,29650,28504,284
Glenn,3,2022-01-08,181,181,103,78,872,873,491,382,2
Humboldt,3,2022-01-08,1413,1418,792,626,8252,8277,4625,3652,16
Imperial,3,2022-01-08,3416,3426,1825,1601,13740,13781,7336,6445,74
Inyo,3,2022-01-08,392,392,240,152,1243,1246,767,479,4
Kern,3,2022-01-08,10964,10996,6149,4847,55468,55630,31040,24590,191
Kings,3,2022-01-08,1949,1955,1006,949,11902,11936,6130,5806,22
Lake,3,2022-01-08,455,455,225,230,2672,2680,1321,1359,2
Lassen,3,2022-01-08,119,119,72,47,3627,3638,2175,1463,2
Los Angeles,3,2022-01-08,333559,334530,276500,58030,1908991,1914545,1582686,331859,3364
Madera,3,2022-01-08,1702,1708,877,831,10067,10097,5151,4946,26
Marin,3,2022-01-08,3076,3085,1666,1419,21673,21735,11754,9981,23
Mariposa,3,2022-01-08,181,181,92,89,1104,1108,567,541,0
Mendocino,3,2022-01-08,807,807,342,465,5478,5494,2325,3169,7
Merced,3,2022-01-08,3162,3172,1744,1428,13340,13378,7343,6035,39
Modoc,3,2022-01-08,16,16,9,7,95,95,54,41,0
Mono,3,2022-01-08,261,261,118,143,841,842,383,459,1
Monterey,3,2022-01-08,4464,4476,1798,2678,32076,32169,12885,19284,56
Napa,3,2022-01-08,2692,2699,1526,1173,14849,14891,8415,6476,15
Nevada,3,2022-01-08,1101,1104,549,555,4899,4913,2431,2482,15
Orange,3,2022-01-08,61467,61645,34968,26677,312995,313905,178272,135633,907
Placer,3,2022-01-08,4819,4833,2334,2499,21304,21365,10288,11077,165
Plumas,3,2022-01-08,120,120,60,60,784,784,390,394,4
Riverside,3,2022-01-08,47597,47735,24017,23718,185244,185782,93455,92327,851
Sacramento,3,2022-01-08,26605,26683,15056,11627,119998,120346,67773,52573,399
San Benito,3,2022-01-08,964,967,592,375,4320,4333,2654,1679,6
San Bernardino,3,2022-01-08,47415,47553,30197,17356,188407,188955,120033,68922,923
San Diego,3,2022-01-08,85951,86201,69433,16768,343335,344333,277378,66955,943
San Francisco,3,2022-01-08,16271,16318,7522,8796,121372,121725,56223,65502,156
San Joaquin,3,2022-01-08,12931,12968,7000,5968,59815,59988,32322,27666,150
San Luis Obispo,3,2022-01-08,4269,4281,2569,1712,21779,21842,13092,8750,40
San Mateo,3,2022-01-08,15105,15148,10042,5106,114146,114478,75831,38647,97
Santa Barbara,3,2022-01-08,8332,8355,4692,3663,45770,45902,25805,20097,77
Santa Clara,3,2022-01-08,34983,35085,28099,6986,262212,262974,210643,52331,391
Santa Cruz,3,2022-01-08,4357,4369,2729,1640,41800,41921,26158,15763,18
Shasta,3,2022-01-08,991,993,497,496,8244,8269,4125,4144,54
Siskiyou,3,2022-01-08,106,106,65,41,874,875,534,341,5
Solano,3,2022-01-08,6545,6565,3744,2821,35746,35850,20410,15440,88
Sonoma,3,2022-01-08,8376,8401,4766,3635,46914,47050,26611,20439,71
Stanislaus,3,2022-01-08,5965,5982,2718,3264,27067,27145,12284,14861,168
Sutter,3,2022-01-08,1088,1090,592,498,4671,4684,2527,2157,0
Tehama,3,2022-01-08,460,460,196,264,2393,2398,1018,1380,12
Trinity,3,2022-01-08,32,32,15,17,263,263,125,138,0
Tulare,3,2022-01-08,4323,4335,1923,2412,22497,22562,9952,12610,62
Tuolumne,3,2022-01-08,702,702,357,345,4033,4045,2050,1995,14
Ventura,3,2022-01-08,17627,17678,11880,5798,87042,87295,58669,28626,228
Yolo,3,2022-01-08,3966,3978,2455,1523,50696,50843,31355,19488,8
Yuba,3,2022-01-08,925,927,525,402,3807,3819,2160,1659,35
Alameda,4,2022-01-15,27000,27086,19083,8003,185874,186454,131353,55101,402
Amador,4,2022-01-15,491,491,284,207,3823,3835,2210,1625,9
Butte,4,2022-01-15,2114,2121,1563,558,9637,9667,7112,2555,55
Calaveras,4,2022-01-15,612,612,376,236,2724,2732,1681,1051,5
Colusa,4,2022-01-15,165,165,103,62,799,801,498,303,2
Contra Costa,4,2022-01-15,16561,16613,9967,6646,95669,95968,57603,38365,238
Del Norte,4,2022-01-15,201,201,129,72,3970,3982,2552,1430,3
El Dorado,4,2022-01-15,2178,2186,1318,868,9015,9044,5455,3589,16
Fresno,4,2022-01-15,16754,16806,9798,7008,68091,68303,39772,28531,430
Glenn,4,2022-01-15,307,307,195,112,1061,1065,674,391,2
Humboldt,4,2022-01-15,1259,1263,792,471,8891,8920,5606,3314,24
Imperial,4,2022-01-15,3741,3754,2264,1490,14312,14357,8670,5687,94
Inyo,4,2022-01-15,397,397,270,127,1238,1242,843,399,3
Kern,4,2022-01-15,13183,13224,8306,4918,59455,59640,37442,22198,256
Kings,4,2022-01-15,3497,3509,2055,1454,16569,16620,9743,6877,46
Lake,4,2022-01-15,589,589,334,255,3189,3199,1817,1382,4
Lassen,4,2022-01-15,279,279,186,93,3783,3795,2529,1266,1
Los Angeles,4,2022-01-15,249922,250701,216567,34134,1800650,1806273,1561279,244994,4507
Madera,4,2022-01-15,2429,2436,1425,1011,11172,11208,6539,4669,32
Marin,4,2022-01-15,2675,2684,1642,1042,19354,19414,11888,7526,34
Mariposa,4,2022-01-15,189,189,109,80,1227,1232,718,514,0
Mendocino,4,2022-01-15,983,987,490,497,5575,5594,2775,2819,22
Merced,4,2022-01-15,4150,4163,2580,1583,14975,15022,9302,5720,53
Modoc,4,2022-01-15,10,10,6,4,110,110,70,40,0
Mono,4,2022-01-15,235,235,124,111,856,858,453,405,1
Monterey,4,2022-01-15,6067,6085,2886,3199,30168,30262,14288,15974,74
Napa,4,2022-01-15,2193,2200,1396,804,13379,13421,8517,4904,24
Nevada,4,2022-01-15,1318,1323,752,571,5720,5738,3253,2485,23
Orange,4,2022-01-15,47134,47281,30082,17199,282156,283037,180289,102748,1200
Placer,4,2022-01-15,4750,4764,2633,2131,21336,21402,11830,9572,207
Plumas,4,2022-01-15,186,186,105,81,806,808,458,350,4
Riverside,4,2022-01-15,45498,45639,26252,19387,182746,183317,105544,77773,1006
Sacramento,4,2022-01-15,23577,23650,14967,8683,111621,111970,70836,41134,533
San Benito,4,2022-01-15,944,946,640,306,4434,4448,3016,1432,8
San Bernardino,4,2022-01-15,42255,42387,29610,12777,181700,182266,127515,54751,1100
San Diego,4,2022-01-15,67463,67673,57332,10341,286883,287778,243893,43885,1206
San Francisco,4,2022-01-15,11798,11837,6334,5503,100548,100862,53979,46883,230
San Joaquin,4,2022-01-15,14288,14332,8721,5611,65097,65299,39732,25567,239
San Luis Obispo,4,2022-01-15,4101,4114,2745,1369,22530,22600,15077,7523,42
San Mateo,4,2022-01-15,13883,13926,10086,3840,109049,109390,79233,30157,111
Santa Barbara,4,2022-01-15,7602,7626,4810,2816,44892,45032,28433,16599,122
Santa Clara,4,2022-01-15,31571,31669,26698,4971,252855,253643,213874,39769,494
Santa Cruz,4,2022-01-15,4370,4384,3025,1359,45081,45220,31218,14002,34
Shasta,4,2022-01-15,1315,1320,759,561,9714,9743,5577,4166,74
Siskiyou,4,2022-01-15,160,160,108,52,1051,1054,710,344,5
Solano,4,2022-01-15,7021,7043,4512,2531,38497,38617,24714,13903,129
Sonoma,4,2022-01-15,8150,8176,5197,2979,46853,46998,29866,17132,91
Stanislaus,4,2022-01-15,7650,7674,4031,3643,30904,31000,16255,14745,219
Sutter,4,2022-01-15,1370,1375,839,536,5158,5173,3152,2021,0
Tehama,4,2022-01-15,635,635,316,319,2607,2614,1297,1317,15
Trinity,4,2022-01-15,43,43,23,20,272,272,148,124,0
Tulare,4,2022-01-15,7579,7603,3914,3689,28154,28243,14510,13733,96
Tuolumne,4,2022-01-15,941,941,547,394,4438,4452,2579,1873,9
Ventura,4,2022-01-15,13863,13907,10173,3734,76330,76568,56034,20534,338
Yolo,4,2022-01-15,3112,3122,2131,991,43889,44026,30099,13927,18
Yuba,4,2022-01-15,1105,1109,702,407,4012,4025,2547,1478,37
Alameda,5,2022-01-22,20480,20550,15658,4892,161678,162234,123737,38497,446
Amador,5,2022-01-22,561,561,364,197,4340,4354,2830,1524,11
Butte,5,2022-01-22,1952,1957,1545,412,8698,8728,6891,1837,88
Calaveras,5,2022-01-22,594,594,406,188,2441,2448,1671,777,7
Colusa,5,2022-01-22,160,160,110,50,810,812,560,252,5
Contra Costa,5,2022-01-22,13207,13252,8856,4396,81279,81560,54590,26970,302
Del Norte,5,2022-01-22,298,298,211,87,3830,3844,2712,1132,2
El Dorado,5,2022-01-22,1545,1550,1041,509,7237,7262,4883,2379,28
Fresno,5,2022-01-22,17606,17666,11502,6164,67816,68049,44338,23711,554
Glenn,5,2022-01-22,253,253,177,76,927,929,648,281,0
Humboldt,5,2022-01-22,981,984,683,301,7465,7491,5207,2284,22
Imperial,5,2022-01-22,3538,3550,2389,1161,12803,12847,8647,4200,85
Inyo,5,2022-01-22,158,158,117,41,609,610,451,159,1
Kern,5,2022-01-22,10702,10740,7467,3273,50520,50694,35267,15427,319
Kings,5,2022-01-22,4083,4097,2685,1412,16943,17001,11159,5842,43
Lake,5,2022-01-22,683,683,435,248,3178,3189,2023,1166,9
Lassen,5,2022-01-22,432,432,315,117,3492,3505,2549,956,1
Los Angeles,5,2022-01-22,171899,172490,154420,18070,1532583,1537869,1377890,159979,4569
Madera,5,2022-01-22,2758,2766,1809,957,11431,11471,7488,3983,54
Marin,5,2022-01-22,1958,1965,1335,630,17029,17087,11627,5460,51
Mariposa,5,2022-01-22,149,149,97,52,940,944,616,328,0
Mendocino,5,2022-01-22,963,966,550,416,4821,4837,2759,2078,22
Merced,5,2022-01-22,3176,3188,2187,1001,12392,12435,8541,3894,61
Modoc,5,2022-01-22,16,16,11,5,104,104,73,31,0
Mono,5,2022-01-22,97,97,58,39,462,462,276,186,1
Monterey,5,2022-01-22,5326,5346,2918,2428,31409,31518,17235,14283,102
Napa,5,2022-01-22,1704,1709,1198,511,11814,11854,8318,3536,24
Nevada,5,2022-01-22,1045,1050,670,380,4756,4773,3041,1732,26
Orange,5,2022-01-22,29985,30087,21108,8979,225855,226633,159446,67187,1162
Placer,5,2022-01-22,3829,3841,2401,1440,18217,18279,11427,6852,257
Plumas,5,2022-01-22,218,218,138,80,883,887,563,324,6
Riverside,5,2022-01-22,33749,33866,21867,11999,156236,156773,101361,55412,1048
Sacramento,5,2022-01-22,17939,18001,12575,5426,94898,95224,66589,28635,614
San Benito,5,2022-01-22,853,856,633,223,3958,3972,2941,1031,8
San Bernardino,5,2022-01-22,28514,28611,21678,6933,147873,148382,112577,35805,1207
San Diego,5,2022-01-22,53877,54062,47680,6382,247071,247922,218753,29169,1309
San Francisco,5,2022-01-22,8879,8909,5394,3515,86771,87070,52887,34183,278
San Joaquin,5,2022-01-22,11253,11292,7645,3647,56092,56284,38106,18178,296
San Luis Obispo,5,2022-01-22,3595,3607,2628,979,20758,20829,15195,5634,51
San Mateo,5,2022-01-22,9291,9322,7261,2061,90616,90927,70984,19943,154
Santa Barbara,5,2022-01-22,6568,6590,4597,1993,41114,41256,28807,12449,141
Santa Clara,5,2022-01-22,23346,23426,20584,2842,220205,220963,194261,26702,515
Santa Cruz,5,2022-01-22,5317,5336,4017,1319,48508,48677,36708,11969,43
Shasta,5,2022-01-22,1452,1457,938,519,9453,9485,6098,3387,81
Siskiyou,5,2022-01-22,156,156,115,41,821,824,606,218,6
Solano,5,2022-01-22,5041,5058,3566,1492,30893,30999,21855,9144,155
Sonoma,5,2022-01-22,7218,7244,5082,2162,41261,41403,29056,12347,106
Stanislaus,5,2022-01-22,6686,6708,4009,2699,27829,27925,16689,11236,303
Sutter,5,2022-01-22,1109,1114,755,359,4983,5001,3390,1611,0
Tehama,5,2022-01-22,577,577,329,248,2446,2454,1401,1053,20
Trinity,5,2022-01-22,66,66,41,25,311,311,192,119,0
Tulare,5,2022-01-22,7850,7877,4622,3255,28381,28479,16719,11760,130
Tuolumne,5,2022-01-22,889,892,580,312,3587,3599,2341,1258,17
Ventura,5,2022-01-22,9889,9923,7805,2118,64460,64682,50938,13744,355
Yolo,5,2022-01-22,2316,2324,1727,597,38319,38450,28645,9805,24
Yuba,5,2022-01-22,939,943,659,284,3727,3740,2615,1125,65
Alameda,6,2022-01-29,12514,12561,10172,2389,143344,143905,116628,27277,417
Amador,6,2022-01-29,364,364,259,105,3262,3274,2331,943,18
Butte,6,2022-01-29,1279,1284,1070,214,7917,7948,6622,1326,101
Calaveras,6,2022-01-29,282,282,208,74,1919,1926,1428,498,4
Colusa,6,2022-01-29,118,118,88,30,685,688,514,174,2
Contra Costa,6,2022-01-29,8232,8263,6010,2253,72226,72508,52876,19632,285
Del Norte,6,2022-01-29,357,357,272,85,4128,4146,3157,989,9
El Dorado,6,2022-01-29,841,844,617,227,6180,6205,4547,1658,20
Fresno,6,2022-01-29,12085,12132,8655,3477,58430,58658,41865,16793,586
Glenn,6,2022-01-29,208,208,157,51,762,764,577,187,4
Humboldt,6,2022-01-29,614,614,462,152,6164,6188,4654,1534,26
Imperial,6,2022-01-29,2544,2554,1866,688,12264,12311,9019,3292,103
Inyo,6,2022-01-29,66,66,52,14,507,508,401,107,4
Kern,6,2022-01-29,6424,6449,4848,1601,43960,44133,33215,10918,304
Kings,6,2022-01-29,2775,2786,1995,791,15067,15125,10838,4287,52
Lake,6,2022-01-29,558,559,390,169,3391,3405,2382,1023,10
Lassen,6,2022-01-29,347,347,272,75,3643,3658,2853,805,5
Los Angeles,6,2022-01-29,88329,88674,81495,7179,1338909,1344148,1236159,107989,3852
Madera,6,2022-01-29,1818,1825,1304,521,9844,9882,7057,2825,52
Marin,6,2022-01-29,1223,1228,907,321,14262,14318,10585,3733,48
Mariposa,6,2022-01-29,106,106,76,30,867,871,624,247,0
Mendocino,6,2022-01-29,541,541,345,196,3602,3617,2311,1306,14
Merced,6,2022-01-29,2293,2301,1712,589,10959,11003,8198,2805,64
Modoc,6,2022-01-29,12,12,9,3,98,98,74,24,2
Mono,6,2022-01-29,42,42,28,14,344,344,230,114,0
Monterey,6,2022-01-29,3862,3877,2389,1488,26896,27001,16659,10342,113
Napa,6,2022-01-29,1126,1131,857,274,9855,9895,7499,2396,22
Nevada,6,2022-01-29,677,678,474,204,4139,4156,2911,1245,30
Orange,6,2022-01-29,14350,14406,10923,3483,185329,186053,141343,44710,967
Placer,6,2022-01-29,2579,2589,1784,805,15848,15910,10974,4936,215
Plumas,6,2022-01-29,154,154,107,47,750,753,526,227,2
Riverside,6,2022-01-29,19212,19286,13642,5644,127209,127706,90564,37142,952
Sacramento,6,2022-01-29,11762,11808,8913,2895,81558,81877,61901,19976,588
San Benito,6,2022-01-29,528,528,418,110,3369,3381,2678,703,7
San Bernardino,6,2022-01-29,15557,15618,12588,3030,122426,122904,99253,23651,1004
San Diego,6,2022-01-29,29259,29373,26682,2691,193233,193989,176308,17681,1210
San Francisco,6,2022-01-29,4944,4963,3328,1635,75167,75460,50831,24629,259
San Joaquin,6,2022-01-29,6492,6517,4795,1722,45316,45493,33483,12010,306
San Luis Obispo,6,2022-01-29,2305,2313,1806,507,17372,17441,13640,3801,67
San Mateo,6,2022-01-29,5102,5121,4222,899,79527,79839,65926,13913,155
Santa Barbara,6,2022-01-29,4285,4302,3240,1062,36540,36683,27684,8999,112
Santa Clara,6,2022-01-29,15812,15873,14383,1490,209913,210734,191091,19643,518
Santa Cruz,6,2022-01-29,3565,3580,2867,713,46905,47090,37836,9254,45
Shasta,6,2022-01-29,1081,1086,765,321,8675,8709,6143,2566,82
Siskiyou,6,2022-01-29,125,125,99,26,699,701,552,149,13
Solano,6,2022-01-29,4154,4171,3181,990,29982,30099,22932,7167,165
Sonoma,6,2022-01-29,4219,4237,3205,1032,33734,33865,25658,8207,101
Stanislaus,6,2022-01-29,4095,4111,2729,1382,22824,22913,15228,7685,321
Sutter,6,2022-01-29,702,703,518,185,3940,3955,2914,1041,0
Tehama,6,2022-01-29,406,406,259,147,2160,2168,1384,784,22
Trinity,6,2022-01-29,39,39,27,12,221,221,150,71,0
Tulare,6,2022-01-29,5362,5382,3520,1862,24537,24633,16125,8508,149
Tuolumne,6,2022-01-29,828,831,590,241,3418,3432,2444,988,19
Ventura,6,2022-01-29,5571,5593,4643,950,55429,55645,46250,9395,312
Yolo,6,2022-01-29,1571,1577,1251,326,37789,37938,30204,7734,21
Yuba,6,2022-01-29,611,611,461,150,3072,3084,2331,753,75
Alameda,7,2022-02-05,6823,6852,5828,1024,121429,121949,103872,18077,347
Amador,7,2022-02-05,239,239,183,56,3060,3073,2357,716,16
Butte,7,2022-02-05,865,868,755,113,6586,6614,5756,858,85
Calaveras,7,2022-02-05,212,212,168,44,1565,1571,1244,327,2
Colusa,7,2022-02-05,89,89,71,18,569,571,455,116,4
Contra Costa,7,2022-02-05,4511,4531,3544,987,57648,57894,45351,12543,239
Del Norte,7,2022-02-05,240,240,195,45,3891,3908,3166,742,7
El Dorado,7,2022-02-05,501,502,394,108,5151,5173,4065,1108,29
Fresno,7,2022-02-05,7107,7137,5490,1647,45944,46141,35525,10616,561
Glenn,7,2022-02-05,138,138,111,27,641,643,517,126,4
Humboldt,7,2022-02-05,492,492,395,97,5034,5055,4058,997,21
Imperial,7,2022-02-05,1282,1287,1010,277,8887,8926,7015,1911,81
Inyo,7,2022-02-05,52,52,43,9,448,449,375,74,3
Kern,7,2022-02-05,3916,3933,3157,776,36332,36488,29308,7180,233
Kings,7,2022-02-05,1511,1517,1170,347,10783,10828,8363,2465,57
Lake,7,2022-02-05,385,385,291,94,2746,2758,2089,669,9
Lassen,7,2022-02-05,156,156,129,27,3202,3216,2656,560,5
Los Angeles,7,2022-02-05,43765,43952,41244,2708,1182084,1187138,1114651,72487,2841
Madera,7,2022-02-05,1235,1240,955,285,8417,8453,6514,1939,51
Marin,7,2022-02-05,719,722,572,150,12077,12130,9602,2528,33
Mariposa,7,2022-02-05,56,56,43,13,624,626,482,144,0
Mendocino,7,2022-02-05,353,353,249,104,2985,2999,2110,889,18
Merced,7,2022-02-05,1337,1343,1068,275,8425,8461,6741,1720,64
Modoc,7,2022-02-05,22,22,18,4,159,159,129,30,3
Mono,7,2022-02-05,46,46,33,13,270,270,197,73,0
Monterey,7,2022-02-05,2483,2494,1703,791,23043,23143,15809,7334,96
Napa,7,2022-02-05,791,795,642,153,8029,8063,6511,1552,23
Nevada,7,2022-02-05,396,396,300,96,3288,3303,2506,797,27
Orange,7,2022-02-05,7348,7381,5967,1414,156193,156861,126978,29883,627
Placer,7,2022-02-05,1519,1525,1140,385,12794,12848,9614,3234,184
Plumas,7,2022-02-05,99,99,75,24,575,576,434,142,1
Riverside,7,2022-02-05,9469,9510,7274,2236,100180,100608,77051,23557,720
Sacramento,7,2022-02-05,6911,6939,5593,1346,66341,66626,53724,12902,502
San Benito,7,2022-02-05,332,332,277,55,2818,2831,2367,464,8
San Bernardino,7,2022-02-05,7957,7990,6776,1214,94381,94785,80481,14304,720
San Diego,7,2022-02-05,15754,15821,14719,1102,158228,158906,147894,11012,991
San Francisco,7,2022-02-05,2646,2657,1951,706,57579,57826,42533,15293,225
San Joaquin,7,2022-02-05,3811,3826,3020,806,38104,38266,30211,8055,250
San Luis Obispo,7,2022-02-05,1430,1436,1189,247,13454,13512,11194,2318,40
San Mateo,7,2022-02-05,2842,2854,2465,389,64202,64477,55725,8752,125
Santa Barbara,7,2022-02-05,2702,2714,2184,530,33543,33686,27134,6552,102
Santa Clara,7,2022-02-05,9071,9110,8457,653,179007,179771,166958,12813,452
Santa Cruz,7,2022-02-05,2105,2114,1783,331,39282,39451,33278,6173,38
Shasta,7,2022-02-05,731,734,561,173,7223,7254,5530,1724,75
Siskiyou,7,2022-02-05,103,103,86,17,704,707,588,119,8
Solano,7,2022-02-05,2521,2532,2049,483,24719,24825,20114,4711,121
Sonoma,7,2022-02-05,2310,2320,1874,446,28056,28175,22762,5413,79
Stanislaus,7,2022-02-05,2800,2813,2043,770,19664,19748,14342,5406,285
Sutter,7,2022-02-05,429,429,338,91,3483,3497,2762,735,0
Tehama,7,2022-02-05,328,328,230,98,1720,1727,1213,514,24
Trinity,7,2022-02-05,24,24,18,6,151,151,111,40,0
Tulare,7,2022-02-05,3140,3154,2262,892,18707,18787,13484,5303,164
Tuolumne,7,2022-02-05,404,404,310,94,2680,2692,2068,624,13
Ventura,7,2022-02-05,3006,3018,2621,397,43481,43667,37930,5737,244
Yolo,7,2022-02-05,916,920,771,149,32576,32715,27454,5261,14
Yuba,7,2022-02-05,388,388,312,76,2519,2530,2039,491,58
Alameda,8,2022-02-12,3995,4014,3551,463,103060,103558,91681,11877,256
Amador,8,2022-02-12,112,112,91,21,2427,2439,1989,450,15
Butte,8,2022-02-12,542,543,489,54,5551,5577,5020,557,76
Calaveras,8,2022-02-12,114,114,95,19,1319,1325,1108,217,6
Colusa,8,2022-02-12,46,46,39,7,518,520,437,83,3
Contra Costa,8,2022-02-12,2699,2712,2247,465,46549,46775,38799,7976,172
Del Norte,8,2022-02-12,253,253,215,38,3671,3689,3136,553,9
El Dorado,8,2022-02-12,303,303,252,51,4674,4696,3903,793,25
Fresno,8,2022-02-12,4266,4287,3505,782,37084,37264,30483,6781,459
Glenn,8,2022-02-12,60,60,51,9,480,481,407,74,4
Humboldt,8,2022-02-12,396,396,334,62,4504,4526,3826,700,19
Imperial,8,2022-02-12,697,701,582,119,6681,6714,5581,1133,68
Inyo,8,2022-02-12,28,28,24,4,409,410,357,53,2
Kern,8,2022-02-12,2408,2421,2047,374,30140,30284,25612,4672,205
Kings,8,2022-02-12,908,913,748,165,8410,8452,6927,1525,52
Lake,8,2022-02-12,260,260,210,50,2426,2437,1967,470,10
Lassen,8,2022-02-12,140,140,122,18,3018,3034,2623,411,3
Los Angeles,8,2022-02-12,24930,25050,23886,1164,1084225,1089465,1039156,50309,2086
Madera,8,2022-02-12,708,711,582,129,7087,7121,5828,1293,44
Marin,8,2022-02-12,427,427,357,70,10399,10450,8742,1708,28
Mariposa,8,2022-02-12,28,28,23,5,436,437,358,79,0
Mendocino,8,2022-02-12,234,234,178,56,2482,2494,1898,596,18
Merced,8,2022-02-12,854,859,721,138,7279,7315,6147,1168,47
Modoc,8,2022-02-12,21,21,18,3,189,189,160,29,0
Mono,8,2022-02-12,14,14,11,3,180,180,140,40,0
Monterey,8,2022-02-12,1441,1449,1076,373,18800,18891,14024,4867,88
Napa,8,2022-02-12,474,475,403,72,6888,6921,5877,1044,17
Nevada,8,2022-02-12,207,207,167,40,2702,2716,2193,523,20
Orange,8,2022-02-12,4476,4498,3825,673,136319,136975,116470,20505,456
Placer,8,2022-02-12,763,767,612,155,10568,10618,8492,2126,141
Plumas,8,2022-02-12,49,49,39,10,441,442,355,87,2
Riverside,8,2022-02-12,5409,5436,4426,1010,79676,80060,65227,14833,503
Sacramento,8,2022-02-12,3938,3956,3353,603,55928,56198,47674,8524,427
San Benito,8,2022-02-12,212,212,184,28,2309,2320,2024,296,7
San Bernardino,8,2022-02-12,4419,4441,3918,523,77414,77788,68697,9091,511
San Diego,8,2022-02-12,9539,9586,9080,506,132343,132983,125994,6989,751
San Francisco,8,2022-02-12,1823,1833,1442,391,49105,49342,38913,10429,183
San Joaquin,8,2022-02-12,2295,2307,1925,382,32462,32619,27208,5411,189
San Luis Obispo,8,2022-02-12,877,881,763,118,10687,10739,9307,1432,30
San Mateo,8,2022-02-12,1563,1571,1405,166,56678,56952,50990,5962,75
Santa Barbara,8,2022-02-12,1279,1286,1089,197,23530,23644,20052,3592,78
Santa Clara,8,2022-02-12,5401,5427,5132,295,159885,160658,151979,8679,366
Santa Cruz,8,2022-02-12,1174,1179,1035,144,34161,34328,30148,4180,33
Shasta,8,2022-02-12,508,509,413,96,6178,6207,5036,1171,78
Siskiyou,8,2022-02-12,79,79,69,10,589,590,512,78,5
Solano,8,2022-02-12,1369,1375,1171,204,20374,20472,17430,3042,96
Sonoma,8,2022-02-12,1370,1377,1168,209,23427,23541,19992,3549,60
Stanislaus,8,2022-02-12,1641,1649,1286,363,16393,16471,12859,3612,242
Sutter,8,2022-02-12,248,248,207,41,2995,3009,2512,497,0
Tehama,8,2022-02-12,197,197,150,47,1453,1459,1110,349,19
Trinity,8,2022-02-12,21,21,17,4,162,162,128,34,0
Tulare,8,2022-02-12,1784,1793,1385,408,16305,16384,12685,3699,146
Tuolumne,8,2022-02-12,222,222,181,41,2349,2360,1927,433,12
Ventura,8,2022-02-12,1807,1816,1632,184,38387,38572,34668,3904,190
Yolo,8,2022-02-12,599,601,525,76,28979,29118,25494,3624,15
Yuba,8,2022-02-12,246,246,208,38,2191,2202,1867,335,41
Alameda,9,2022-02-19,2250,2262,2062,200,90478,90950,82943,8007,191
Amador,9,2022-02-19,91,91,78,13,2160,2173,1860,313,9
Butte,9,2022-02-19,307,307,284,23,4632,4657,4303,354,71
Calaveras,9,2022-02-19,52,52,45,7,957,962,840,122,6
Colusa,9,2022-02-19,29,29,25,4,381,382,335,47,6
Contra Costa,9,2022-02-19,1639,1647,1426,221,39867,40076,34744,5332,117
Del Norte,9,2022-02-19,154,154,136,18,3067,3082,2725,357,9
El Dorado,9,2022-02-19,169,169,147,22,4003,4023,3495,528,10
Fresno,9,2022-02-19,2466,2480,2126,354,30253,30411,26091,4320,360
Glenn,9,2022-02-19,33,33,29,4,405,406,357,49,2
Humboldt,9,2022-02-19,237,237,209,28,3796,3816,3360,456,20
Imperial,9,2022-02-19,456,457,397,60,5347,5375,4674,701,47
Inyo,9,2022-02-19,13,13,12,1,379,381,343,38,1
Kern,9,2022-02-19,1403,1411,1243,168,25883,26019,22927,3092,124
Kings,9,2022-02-19,571,573,493,80,7347,7385,6354,1031,33
Lake,9,2022-02-19,225,225,191,34,2194,2207,1875,332,9
Lassen,9,2022-02-19,143,143,128,15,2379,2391,2140,251,4
Los Angeles,9,2022-02-19,14097,14170,13674,496,986094,991238,956783,34455,1391
Madera,9,2022-02-19,415,416,357,59,5895,5926,5085,841,35
Marin,9,2022-02-19,262,262,228,34,9939,9991,8723,1268,20
Mariposa,9,2022-02-19,20,20,17,3,408,408,350,58,0
Mendocino,9,2022-02-19,142,142,115,27,2244,2258,1831,427,10
Merced,9,2022-02-19,555,556,487,69,5981,6011,5266,745,8
Modoc,9,2022-02-19,10,10,9,1,72,72,64,8,1
Mono,9,2022-02-19,8,8,7,1,172,172,142,30,0
Monterey,9,2022-02-19,901,906,721,185,14923,15001,11932,3069,61
Napa,9,2022-02-19,303,303,267,36,5768,5798,5122,676,10
Nevada,9,2022-02-19,130,130,110,20,2374,2387,2028,359,21
Orange,9,2022-02-19,2864,2878,2544,334,126999,127660,112877,14783,352
Placer,9,2022-02-19,381,381,321,60,9382,9431,7953,1478,114
Plumas,9,2022-02-19,25,25,21,4,384,385,325,60,1
Riverside,9,2022-02-19,2968,2984,2549,435,67142,67492,57747,9745,351
Sacramento,9,2022-02-19,2386,2399,2116,283,48772,49025,43271,5754,319
San Benito,9,2022-02-19,134,134,121,13,2050,2060,1859,201,4
San Bernardino,9,2022-02-19,2308,2320,2111,209,65986,66332,60405,5927,366
San Diego,9,2022-02-19,5509,5537,5316,221,111120,111699,107263,4436,589
San Francisco,9,2022-02-19,1133,1139,948,191,45319,45556,37984,7572,140
San Joaquin,9,2022-02-19,1294,1301,1133,168,27652,27795,24214,3581,129
San Luis Obispo,9,2022-02-19,585,589,528,61,9114,9163,8221,942,26
San Mateo,9,2022-02-19,894,899,826,73,49778,50037,46025,4012,60
Santa Barbara,9,2022-02-19,755,759,669,90,21656,21769,19201,2568,56
Santa Clara,9,2022-02-19,3002,3018,2894,124,139668,140396,134667,5729,296
Santa Cruz,9,2022-02-19,665,668,605,63,28324,28471,25817,2654,24
Shasta,9,2022-02-19,323,323,275,48,5418,5445,4642,803,65
Siskiyou,9,2022-02-19,53,53,48,5,534,536,482,54,11
Solano,9,2022-02-19,775,779,689,90,16727,16813,14885,1928,70
Sonoma,9,2022-02-19,786,791,698,93,18961,19060,16838,2222,40
Stanislaus,9,2022-02-19,914,920,760,160,13532,13604,11257,2347,187
Sutter,9,2022-02-19,156,156,136,20,2410,2424,2112,312,0
Tehama,9,2022-02-19,119,119,96,23,1255,1261,1022,239,14
Trinity,9,2022-02-19,16,16,13,3,224,224,187,37,0
Tulare,9,2022-02-19,964,969,794,175,12434,12500,10262,2238,99
Tuolumne,9,2022-02-19,123,123,105,18,1956,1966,1684,282,7
Ventura,9,2022-02-19,1020,1026,947,79,30885,31045,28645,2400,131
Yolo,9,2022-02-19,334,334,302,32,24099,24226,21913,2313,10
Yuba,9,2022-02-19,159,159,140,19,1791,1800,1588,212,29
Alameda,10,2022-02-26,1497,1505,1404,101,68945,69356,64764,4592,144
Amador,10,2022-02-26,65,65,58,7,1993,2004,1784,220,10
Butte,10,2022-02-26,191,191,180,11,3990,4013,3782,231,48
Calaveras,10,2022-02-26,35,35,32,3,1064,1070,967,103,0
Colusa,10,2022-02-26,11,11,10,1,362,364,330,34,3
Contra Costa,10,2022-02-26,968,975,875,100,31615,31803,28578,3225,85
Del Norte,10,2022-02-26,88,88,80,8,2691,2708,2469,239,6
El Dorado,10,2022-02-26,116,116,104,12,3361,3382,3043,339,9
Fresno,10,2022-02-26,1345,1353,1205,148,25161,25310,22548,2762,268
Glenn,10,2022-02-26,21,21,19,2,376,377,342,35,0
Humboldt,10,2022-02-26,137,137,124,13,2765,2782,2528,254,8
Imperial,10,2022-02-26,268,268,241,27,4542,4569,4110,459,24
Inyo,10,2022-02-26,10,10,9,1,326,327,302,25,0
Kern,10,2022-02-26,883,889,808,81,22362,22495,20447,2048,101
Kings,10,2022-02-26,257,257,229,28,5894,5928,5289,639,21
Lake,10,2022-02-26,126,126,111,15,1808,1819,1608,211,3
Lassen,10,2022-02-26,59,59,54,5,1995,2008,1847,161,1
Los Angeles,10,2022-02-26,8510,8559,8335,224,924919,930441,906470,23971,975
Madera,10,2022-02-26,206,206,184,22,4162,4186,3731,455,26
Marin,10,2022-02-26,146,146,132,14,7105,7147,6452,695,14
Mariposa,10,2022-02-26,34,34,30,4,324,324,289,35,0
Mendocino,10,2022-02-26,78,78,66,12,1713,1725,1471,254,10
Merced,10,2022-02-26,281,281,254,27,4724,4753,4303,450,31
Modoc,10,2022-02-26,6,6,5,1,50,50,45,5,1
Mono,10,2022-02-26,5,5,4,1,166,166,144,22,0
Monterey,10,2022-02-26,415,416,348,68,12742,12817,10767,2050,32
Napa,10,2022-02-26,173,173,158,15,4942,4971,4531,440,8
Nevada,10,2022-02-26,78,78,69,9,1985,1998,1767,231,12
Orange,10,2022-02-26,1856,1868,1702,166,114640,115324,105223,10101,252
Placer,10,2022-02-26,272,272,239,33,7933,7980,7012,968,99
Plumas,10,2022-02-26,26,26,23,3,342,342,301,41,0
Riverside,10,2022-02-26,1789,1801,1600,201,59325,59679,53045,6634,258
Sacramento,10,2022-02-26,1207,1215,1105,110,41221,41467,37760,3707,224
San Benito,10,2022-02-26,60,60,56,4,1583,1594,1476,118,1
San Bernardino,10,2022-02-26,1278,1285,1197,88,56427,56765,52920,3845,221
San Diego,10,2022-02-26,3389,3409,3307,102,93893,94450,91649,2801,450
San Francisco,10,2022-02-26,866,872,759,113,36440,36657,31951,4706,99
San Joaquin,10,2022-02-26,733,738,665,73,23399,23537,21219,2318,90
San Luis Obispo,10,2022-02-26,318,320,295,25,7644,7690,7092,598,16
San Mateo,10,2022-02-26,546,550,517,33,35220,35429,33294,2135,46
Santa Barbara,10,2022-02-26,412,412,375,37,19323,19436,17689,1747,44
Santa Clara,10,2022-02-26,1778,1790,1735,55,83546,84043,81492,2551,241
Santa Cruz,10,2022-02-26,480,482,448,34,23772,23914,22234,1680,19
Shasta,10,2022-02-26,173,173,153,20,4571,4598,4074,524,49
Siskiyou,10,2022-02-26,29,29,27,2,396,397,366,31,6
Solano,10,2022-02-26,491,493,450,43,14219,14304,13055,1249,65
Sonoma,10,2022-02-26,464,465,424,41,15054,15143,13800,1343,25
Stanislaus,10,2022-02-26,511,512,443,69,11907,11978,10377,1601,154
Sutter,10,2022-02-26,103,103,93,10,2209,2223,2005,218,0
Tehama,10,2022-02-26,58,58,49,9,1108,1113,948,165,10
Trinity,10,2022-02-26,6,6,5,1,111,111,97,14,0
Tulare,10,2022-02-26,506,509,438,71,11089,11154,9608,1546,82
Tuolumne,10,2022-02-26,82,82,73,9,1430,1439,1280,159,7
Ventura,10,2022-02-26,615,619,583,36,27318,27480,25879,1601,92
Yolo,10,2022-02-26,215,215,199,16,22504,22638,21009,1629,9
Yuba,10,2022-02-26,79,79,72,7,1703,1714,1559,155,20
Alameda,11,2022-03-05,1160,1168,1108,60,73797,74313,70543,3770,108
Amador,11,2022-03-05,75,75,69,6,1381,1391,1272,119,6
Butte,11,2022-03-05,134,134,128,6,3670,3696,3535,161,31
Calaveras,11,2022-03-05,29,29,27,2,1122,1129,1045,84,1
Colusa,11,2022-03-05,10,10,9,1,344,346,321,25,6
Contra Costa,11,2022-03-05,649,655,604,51,31779,32002,29501,2501,66
Del Norte,11,2022-03-05,54,54,50,4,1859,1873,1747,126,6
El Dorado,11,2022-03-05,91,91,84,7,3260,3281,3027,254,6
Fresno,11,2022-03-05,955,961,880,81,22832,22991,21059,1932,175
Glenn,11,2022-03-05,12,12,11,1,366,367,341,26,1
Humboldt,11,2022-03-05,110,110,102,8,3067,3088,2873,215,8
Imperial,11,2022-03-05,170,170,157,13,4489,4520,4172,348,21
Inyo,11,2022-03-05,9,9,8,1,371,373,351,22,1
Kern,11,2022-03-05,515,518,482,36,21594,21745,20224,1521,78
Kings,11,2022-03-05,165,165,151,14,5082,5119,4695,424,13
Lake,11,2022-03-05,69,69,63,6,1822,1835,1671,164,5
Lassen,11,2022-03-05,83,83,78,5,1824,1837,1724,113,0
Los Angeles,11,2022-03-05,6098,6141,6020,121,886866,893077,875616,17461,755
Madera,11,2022-03-05,131,131,120,11,4124,4154,3806,348,14
Marin,11,2022-03-05,169,169,156,13,7696,7750,7170,580,11
Mariposa,11,2022-03-05,14,14,13,1,304,305,279,26,0
Mendocino,11,2022-03-05,75,75,66,9,1772,1785,1580,205,10
Merced,11,2022-03-05,200,200,185,15,4671,4703,4362,341,25
Modoc,11,2022-03-05,1,1,1,0,52,52,48,4,0
Mono,11,2022-03-05,3,3,3,0,130,130,117,13,1
Monterey,11,2022-03-05,268,268,234,34,11525,11605,10151,1454,21
Napa,11,2022-03-05,200,200,186,14,5017,5052,4707,345,9
Nevada,11,2022-03-05,47,47,43,4,1755,1769,1611,158,5
Orange,11,2022-03-05,1337,1347,1256,91,109559,110325,102893,7432,189
Placer,11,2022-03-05,175,175,159,16,7852,7906,7167,739,77
Plumas,11,2022-03-05,4,4,4,0,274,275,249,26,0
Riverside,11,2022-03-05,1096,1104,1009,95,55149,55535,50777,4758,169
Sacramento,11,2022-03-05,846,853,794,59,40175,40456,37679,2777,161
San Benito,11,2022-03-05,37,37,35,2,1537,1548,1460,88,2
San Bernardino,11,2022-03-05,904,911,864,47,54012,54390,51580,2810,145
San Diego,11,2022-03-05,2515,2534,2477,57,96782,97461,95282,2179,314
San Francisco,11,2022-03-05,679,684,615,69,38171,38437,34604,3833,69
San Joaquin,11,2022-03-05,458,461,426,35,21405,21555,19920,1635,60
San Luis Obispo,11,2022-03-05,302,303,285,18,7482,7533,7083,450,9
San Mateo,11,2022-03-05,566,571,545,26,41693,41984,40047,1937,37
Santa Barbara,11,2022-03-05,220,220,205,15,18204,18331,17063,1268,26
Santa Clara,11,2022-03-05,1511,1522,1487,35,116399,117212,114510,2702,197
Santa Cruz,11,2022-03-05,343,343,324,19,25048,25223,23860,1363,17
Shasta,11,2022-03-05,145,145,132,13,4962,4997,4560,437,41
Siskiyou,11,2022-03-05,19,19,18,1,417,420,395,25,1
Solano,11,2022-03-05,386,387,361,26,13954,14052,13107,945,60
Sonoma,11,2022-03-05,375,376,350,26,15513,15620,14556,1064,29
Stanislaus,11,2022-03-05,315,315,282,33,11171,11250,10079,1171,115
Sutter,11,2022-03-05,87,87,80,7,2020,2034,1880,154,0
Tehama,11,2022-03-05,50,50,44,6,1201,1209,1070,139,8
Trinity,11,2022-03-05,6,6,5,1,111,111,100,11,0
Tulare,11,2022-03-05,343,344,307,37,10310,10382,9266,1116,46
Tuolumne,11,2022-03-05,54,54,49,5,1285,1293,1183,110,3
Ventura,11,2022-03-05,414,416,398,18,27235,27425,26210,1215,55
Yolo,11,2022-03-05,169,169,160,9,22592,22750,21489,1261,6
Yuba,11,2022-03-05,68,68,63,5,1618,1631,1518,113,18
Alameda,12,2022-03-12,962,970,933,37,68637,69197,66552,2645,78
Amador,12,2022-03-12,32,32,30,2,1460,1473,1377,96,5
Butte,12,2022-03-12,72,72,70,2,3445,3472,3358,114,19
Calaveras,12,2022-03-12,16,16,15,1,1052,1060,1000,60,1
Colusa,12,2022-03-12,6,6,6,0,253,254,240,14,2
Contra Costa,12,2022-03-12,586,591,556,35,29183,29421,27678,1743,31
Del Norte,12,2022-03-12,44,44,42,2,1466,1480,1404,76,5
El Dorado,12,2022-03-12,54,54,51,3,3049,3074,2894,180,7
Fresno,12,2022-03-12,613,618,578,40,21805,21982,20578,1404,145
Glenn,12,2022-03-12,17,17,16,1,320,321,304,17,1
Humboldt,12,2022-03-12,63,63,60,3,2777,2799,2650,149,4
Imperial,12,2022-03-12,88,88,83,5,4631,4668,4394,274,13
Inyo,12,2022-03-12,10,10,10,0,165,165,158,7,0
Kern,12,2022-03-12,316,317,300,17,20080,20244,19175,1069,60
Kings,12,2022-03-12,218,219,205,14,4835,4875,4569,306,16
Lake,12,2022-03-12,63,63,59,4,1599,1613,1503,110,0
Lassen,12,2022-03-12,25,25,24,1,1502,1513,1442,71,0
Los Angeles,12,2022-03-12,4323,4359,4295,64,847767,854681,842191,12490,520
Madera,12,2022-03-12,83,83,78,5,3713,3744,3506,238,15
Marin,12,2022-03-12,163,163,154,9,6639,6693,6313,380,6
Mariposa,12,2022-03-12,7,7,7,0,223,223,209,14,0
Mendocino,12,2022-03-12,41,41,37,4,1481,1494,1363,131,5
Merced,12,2022-03-12,144,144,136,8,4221,4256,4022,234,25
Modoc,12,2022-03-12,3,3,3,0,56,56,53,3,1
Mono,12,2022-03-12,2,2,2,0,106,106,97,9,0
Monterey,12,2022-03-12,181,181,163,18,10340,10424,9419,1005,17
Napa,12,2022-03-12,148,148,140,8,4290,4324,4100,224,7
Nevada,12,2022-03-12,51,51,48,3,1588,1601,1492,109,3
Orange,12,2022-03-12,935,942,894,48,102401,103237,97978,5259,150
Placer,12,2022-03-12,158,158,147,11,7552,7614,7073,541,68
Plumas,12,2022-03-12,10,10,9,1,313,315,293,22,0
Riverside,12,2022-03-12,782,789,737,52,51383,51800,48428,3372,116
Sacramento,12,2022-03-12,624,630,597,33,37174,37477,35527,1950,134
San Benito,12,2022-03-12,27,27,26,1,1449,1462,1400,62,2
San Bernardino,12,2022-03-12,604,609,585,24,51098,51516,49508,2008,119
San Diego,12,2022-03-12,2005,2021,1987,34,96788,97576,95941,1635,225
San Francisco,12,2022-03-12,585,590,545,45,35040,35325,32637,2688,41
San Joaquin,12,2022-03-12,316,317,299,18,20441,20607,19421,1186,41
San Luis Obispo,12,2022-03-12,163,163,156,7,6985,7042,6724,318,6
San Mateo,12,2022-03-12,467,471,455,16,37439,37743,36435,1308,29
Santa Barbara,12,2022-03-12,193,193,183,10,17575,17717,16790,927,20
Santa Clara,12,2022-03-12,1127,1136,1116,20,101371,102198,100438,1760,131
Santa Cruz,12,2022-03-12,248,248,238,10,23057,23244,22296,948,11
Shasta,12,2022-03-12,105,105,98,7,4938,4977,4645,332,21
Siskiyou,12,2022-03-12,17,17,16,1,400,404,386,18,0
Solano,12,2022-03-12,244,244,231,13,12980,13085,12418,667,44
Sonoma,12,2022-03-12,235,235,223,12,13967,14081,13354,727,16
Stanislaus,12,2022-03-12,245,245,226,19,10206,10289,9471,818,106
Sutter,12,2022-03-12,56,56,53,3,1805,1820,1716,104,0
Tehama,12,2022-03-12,27,27,25,2,997,1004,916,88,1
Trinity,12,2022-03-12,2,2,2,0,97,97,90,7,0
Tulare,12,2022-03-12,214,214,196,18,9773,9853,9041,812,37
Tuolumne,12,2022-03-12,29,29,27,2,1246,1257,1176,81,2
Ventura,12,2022-03-12,352,354,342,12,25149,25354,24507,847,40
Yolo,12,2022-03-12,132,132,126,6,21585,21762,20852,910,4
Yuba,12,2022-03-12,44,44,42,2,1446,1459,1383,76,12
Alameda,13,2022-03-19,693,700,680,20,67201,67844,65893,1951,58
Amador,13,2022-03-19,29,29,28,1,1388,1402,1333,69,2
Butte,13,2022-03-19,85,85,83,2,2984,3012,2938,74,17
Calaveras,13,2022-03-19,14,14,13,1,655,660,632,28,0
Colusa,13,2022-03-19,1,1,1,0,241,242,232,10,2
Contra Costa,13,2022-03-19,465,470,449,21,27734,28000,26744,1256,41
Del Norte,13,2022-03-19,19,19,18,1,1282,1295,1245,50,2
El Dorado,13,2022-03-19,41,41,39,2,2826,2852,2726,126,2
Fresno,13,2022-03-19,351,353,336,17,19954,20144,19170,974,101
Glenn,13,2022-03-19,8,8,8,0,339,340,326,14,1
Humboldt,13,2022-03-19,35,35,34,1,2378,2400,2304,96,7
Imperial,13,2022-03-19,62,62,59,3,4023,4061,3881,180,9
Inyo,13,2022-03-19,1,1,1,0,156,156,151,5,0
Kern,13,2022-03-19,218,218,209,9,19390,19575,18794,781,40
Kings,13,2022-03-19,76,76,72,4,4409,4450,4238,212,6
Lake,13,2022-03-19,20,20,19,1,1447,1461,1385,76,0
Lassen,13,2022-03-19,10,10,10,0,1528,1544,1489,55,0
Los Angeles,13,2022-03-19,3975,4014,3970,44,826122,834016,824906,9110,422
Madera,13,2022-03-19,45,45,43,2,3418,3451,3285,166,13
Marin,13,2022-03-19,148,148,142,6,6357,6418,6143,275,7
Mariposa,13,2022-03-19,8,8,8,0,246,247,235,12,0
Mendocino,13,2022-03-19,32,32,30,2,1498,1512,1412,100,5
Merced,13,2022-03-19,97,97,93,4,3902,3940,3777,163,16
Modoc,13,2022-03-19,2,2,2,0,51,51,49,2,0
Mono,13,2022-03-19,2,2,2,0,131,131,123,8,1
Monterey,13,2022-03-19,150,150,139,11,10216,10313,9556,757,19
Napa,13,2022-03-19,65,65,62,3,3532,3566,3426,140,8
Nevada,13,2022-03-19,26,26,25,1,1539,1555,1475,80,1
Orange,13,2022-03-19,753,760,731,29,98282,99222,95409,3813,132
Placer,13,2022-03-19,111,111,105,6,6548,6610,6253,357,40
Plumas,13,2022-03-19,2,2,2,0,223,224,212,12,0
Riverside,13,2022-03-19,672,679,645,34,54654,55175,52451,2724,98
Sacramento,13,2022-03-19,469,474,455,19,32734,33047,31754,1293,113
San Benito,13,2022-03-19,26,26,25,1,1401,1415,1370,45,2
San Bernardino,13,2022-03-19,486,491,477,14,51320,51812,50295,1517,86
San Diego,13,2022-03-19,1536,1550,1530,20,88318,89160,88042,1118,203
San Francisco,13,2022-03-19,653,660,622,38,33548,33869,31915,1954,40
San Joaquin,13,2022-03-19,231,231,221,10,15544,15692,15011,681,34
San Luis Obispo,13,2022-03-19,114,114,110,4,6674,6737,6508,229,3
San Mateo,13,2022-03-19,383,386,376,10,34158,34484,33589,895,28
Santa Barbara,13,2022-03-19,180,180,173,7,16141,16295,15652,643,17
Santa Clara,13,2022-03-19,1020,1031,1018,13,94807,95712,94483,1229,125
Santa Cruz,13,2022-03-19,212,213,206,7,20686,20882,20241,641,10
Shasta,13,2022-03-19,56,56,53,3,4332,4373,4151,222,1
Siskiyou,13,2022-03-19,9,9,9,0,360,364,352,12,1
Solano,13,2022-03-19,195,195,187,8,11622,11733,11283,450,22
Sonoma,13,2022-03-19,225,225,216,9,13338,13465,12944,521,14
Stanislaus,13,2022-03-19,155,155,146,9,8608,8689,8166,523,72
Sutter,13,2022-03-19,31,31,30,1,1488,1502,1437,65,0
Tehama,13,2022-03-19,9,9,8,1,926,935,872,63,1
Trinity,13,2022-03-19,1,1,1,0,96,96,90,6,0
Tulare,13,2022-03-19,130,130,122,8,8465,8546,8011,535,30
Tuolumne,13,2022-03-19,18,18,17,1,1166,1177,1119,58,2
Ventura,13,2022-03-19,288,289,282,7,23835,24063,23460,603,35
Yolo,13,2022-03-19,97,97,94,3,22344,22557,21848,709,4
Yuba,13,2022-03-19,34,34,33,1,1326,1338,1286,52,7
Alameda,14,2022-03-26,873,881,862,19,59330,59982,58689,1293,52
Amador,14,2022-03-26,11,11,11,0,1311,1326,1276,50,3
Butte,14,2022-03-26,68,68,67,1,2731,2761,2710,51,14
Calaveras,14,2022-03-26,14,14,14,0,601,608,588,20,0
Colusa,14,2022-03-26,4,4,4,0,197,198,192,6,0
Contra Costa,14,2022-03-26,505,511,494,17,24833,25107,24260,847,32
Del Norte,14,2022-03-26,17,17,16,1,1036,1047,1016,31,0
El Dorado,14,2022-03-26,50,50,48,2,2789,2819,2725,94,0
Fresno,14,2022-03-26,303,306,295,11,18563,18767,18083,684,95
Glenn,14,2022-03-26,7,7,7,0,308,310,301,9,0
Humboldt,14,2022-03-26,27,27,26,1,2594,2623,2544,79,5
Imperial,14,2022-03-26,54,54,52,2,3686,3728,3604,124,7
Inyo,14,2022-03-26,3,3,3,0,164,164,160,4,1
Kern,14,2022-03-26,154,154,149,5,18450,18651,18090,561,26
Kings,14,2022-03-26,65,65,63,2,4404,4452,4292,160,2
Lake,14,2022-03-26,13,13,12,1,1149,1162,1116,46,0
Lassen,14,2022-03-26,6,6,6,0,1361,1376,1340,36,0
Los Angeles,14,2022-03-26,4345,4392,4356,36,786574,795243,788764,6479,341
Madera,14,2022-03-26,24,24,23,1,3366,3404,3281,123,4
Marin,14,2022-03-26,167,167,162,5,5886,5950,5758,192,3
Mariposa,14,2022-03-26,6,6,6,0,178,178,171,7,0
Mendocino,14,2022-03-26,29,29,28,1,1290,1306,1240,66,0
Merced,14,2022-03-26,64,64,62,2,3331,3369,3264,105,12
Modoc,14,2022-03-26,2,2,2,0,52,52,50,2,0
Mono,14,2022-03-26,3,3,3,0,132,132,126,6,0
Monterey,14,2022-03-26,165,166,157,9,9445,9550,9019,531,19
Napa,14,2022-03-26,62,62,60,2,3328,3365,3266,99,1
Nevada,14,2022-03-26,25,25,24,1,1476,1492,1434,58,1
Orange,14,2022-03-26,797,806,783,23,90128,91122,88493,2629,100
Placer,14,2022-03-26,113,113,108,5,6158,6225,5971,254,33
Plumas,14,2022-03-26,2,2,2,0,272,275,264,11,0
Riverside,14,2022-03-26,520,527,507,20,44551,45042,43372,1670,75
Sacramento,14,2022-03-26,463,468,454,14,31674,32023,31080,943,96
San Benito,14,2022-03-26,10,10,10,0,1305,1320,1288,32,0
San Bernardino,14,2022-03-26,493,498,487,11,41170,41623,40709,914,69
San Diego,14,2022-03-26,1328,1342,1330,12,74026,74839,74139,700,155
San Francisco,14,2022-03-26,770,779,745,34,32747,33108,31666,1442,30
San Joaquin,14,2022-03-26,191,191,185,6,16609,16792,16245,547,31
San Luis Obispo,14,2022-03-26,98,98,95,3,5878,5944,5793,151,5
San Mateo,14,2022-03-26,511,518,508,10,34363,34741,34064,677,28
Santa Barbara,14,2022-03-26,120,120,116,4,8878,8976,8711,265,21
Santa Clara,14,2022-03-26,1227,1241,1229,12,90992,91993,91113,880,102
Santa Cruz,14,2022-03-26,136,136,133,3,18709,18915,18481,434,7
Shasta,14,2022-03-26,41,41,39,2,3902,3944,3794,150,8
Siskiyou,14,2022-03-26,8,8,8,0,305,308,300,8,0
Solano,14,2022-03-26,157,157,152,5,10900,11020,10702,318,26
Sonoma,14,2022-03-26,232,232,225,7,8218,8310,8069,241,14
Stanislaus,14,2022-03-26,127,127,121,6,8025,8113,7744,369,41
Sutter,14,2022-03-26,28,28,27,1,1516,1532,1482,50,0
Tehama,14,2022-03-26,14,14,13,1,808,817,775,42,2
Trinity,14,2022-03-26,0,0,0,0,102,102,97,5,0
Tulare,14,2022-03-26,95,95,90,5,7870,7958,7582,376,19
Tuolumne,14,2022-03-26,9,9,9,0,1113,1127,1085,42,3
Ventura,14,2022-03-26,332,336,330,6,21740,21980,21568,412,23
Yolo,14,2022-03-26,97,97,95,2,17163,17352,16944,408,3
Yuba,14,2022-03-26,34,34,33,1,1254,1269,1231,38,3
Alameda,15,2022-04-02,955,967,952,15,58341,59064,58111,953,37
Amador,15,2022-04-02,4,4,4,0,1178,1192,1158,34,1
Butte,15,2022-04-02,51,51,50,1,2483,2514,2479,35,10
Calaveras,15,2022-04-02,12,12,12,0,586,593,579,14,0
Colusa,15,2022-04-02,4,4,4,0,199,201,196,5,0
Contra Costa,15,2022-04-02,541,548,534,14,24540,24843,24214,629,20
Del Norte,15,2022-04-02,11,11,11,0,1126,1141,1116,25,0
El Dorado,15,2022-04-02,52,52,51,1,2778,2811,2741,70,2
Fresno,15,2022-04-02,197,198,193,5,17049,17260,16787,473,75
Glenn,15,2022-04-02,5,5,5,0,261,262,256,6,0
Humboldt,15,2022-04-02,21,21,21,0,2510,2541,2484,57,5
Imperial,15,2022-04-02,55,55,54,1,3448,3491,3404,87,6
Inyo,15,2022-04-02,8,8,8,0,182,183,180,3,0
Kern,15,2022-04-02,163,163,159,4,17195,17407,17014,393,23
Kings,15,2022-04-02,49,49,48,1,4156,4208,4095,113,3
Lake,15,2022-04-02,12,12,12,0,985,998,969,29,0
Lassen,15,2022-04-02,4,4,4,0,1218,1233,1209,24,0
Los Angeles,15,2022-04-02,5035,5097,5066,31,731916,741026,736560,4466,288
Madera,15,2022-04-02,28,28,27,1,3276,3316,3226,90,5
Marin,15,2022-04-02,155,155,151,4,6555,6636,6476,160,2
Mariposa,15,2022-04-02,5,5,5,0,215,217,211,6,0
Mendocino,15,2022-04-02,26,26,25,1,1252,1267,1218,49,0
Merced,15,2022-04-02,58,58,57,1,3285,3325,3247,78,4
Modoc,15,2022-04-02,4,4,4,0,42,42,41,1,0
Mono,15,2022-04-02,1,1,1,0,154,154,149,5,0
Monterey,15,2022-04-02,127,127,122,5,7539,7633,7313,320,11
Napa,15,2022-04-02,59,59,58,1,3245,3286,3214,72,3
Nevada,15,2022-04-02,28,28,27,1,1401,1419,1378,41,0
Orange,15,2022-04-02,901,913,893,20,88470,89567,87627,1940,72
Placer,15,2022-04-02,124,124,120,4,6577,6659,6455,204,29
Plumas,15,2022-04-02,4,4,4,0,233,235,228,7,0
Riverside,15,2022-04-02,604,611,594,17,39276,39762,38651,1111,51
Sacramento,15,2022-04-02,430,435,425,10,32761,33166,32433,733,63
San Benito,15,2022-04-02,13,13,13,0,1229,1244,1221,23,0
San Bernardino,15,2022-04-02,585,592,582,10,41528,42043,41352,691,35
San Diego,15,2022-04-02,1504,1522,1511,11,65974,66791,66325,466,133
San Francisco,15,2022-04-02,961,972,940,32,28737,29092,28134,958,25
San Joaquin,15,2022-04-02,208,208,203,5,16037,16234,15834,400,16
San Luis Obispo,15,2022-04-02,101,101,99,2,5599,5668,5560,108,4
San Mateo,15,2022-04-02,650,657,647,10,29624,29992,29555,437,16
Santa Barbara,15,2022-04-02,177,177,173,4,15222,15412,15070,342,11
Santa Clara,15,2022-04-02,1403,1421,1411,10,91243,92372,91710,662,102
Santa Cruz,15,2022-04-02,189,190,187,3,20062,20309,19958,351,5
Shasta,15,2022-04-02,25,25,24,1,3526,3569,3467,102,5
Siskiyou,15,2022-04-02,4,4,4,0,313,317,311,6,0
Solano,15,2022-04-02,148,148,145,3,10209,10335,10111,224,26
Sonoma,15,2022-04-02,287,291,285,6,10644,10775,10540,235,9
Stanislaus,15,2022-04-02,100,100,97,3,7810,7906,7634,272,25
Sutter,15,2022-04-02,23,23,22,1,1272,1288,1256,32,0
Tehama,15,2022-04-02,4,4,4,0,746,755,726,29,0
Trinity,15,2022-04-02,1,1,1,0,77,77,75,2,0
Tulare,15,2022-04-02,54,54,52,2,7606,7699,7424,275,15
Tuolumne,15,2022-04-02,11,11,11,0,972,984,957,27,1
Ventura,15,2022-04-02,297,301,297,4,20904,21163,20867,296,22
Yolo,15,2022-04-02,64,64,63,1,28217,28567,28059,508,1
Yuba,15,2022-04-02,12,12,12,0,1023,1035,1012,23,4
Alameda,16,2022-04-09,1385,1404,1387,17,48755,49441,48847,594,49
Amador,16,2022-04-09,7,7,7,0,1099,1114,1090,24,1
Butte,16,2022-04-09,36,36,36,0,2088,2117,2095,22,8
Calaveras,16,2022-04-09,10,10,10,0,643,652,640,12,0
Colusa,16,2022-04-09,4,4,4,0,195,198,194,4,0
Contra Costa,16,2022-04-09,627,635,623,12,19555,19832,19457,375,23
Del Norte,16,2022-04-09,7,7,7,0,982,995,979,16,1
El Dorado,16,2022-04-09,51,51,50,1,2570,2606,2557,49,1
Fresno,16,2022-04-09,197,198,194,4,16691,16926,16579,347,64
Glenn,16,2022-04-09,3,3,3,0,229,231,227,4,0
Humboldt,16,2022-04-09,38,38,37,1,2329,2362,2322,40,7
Imperial,16,2022-04-09,25,25,25,0,3433,3481,3416,65,3
Inyo,16,2022-04-09,5,5,5,0,199,201,198,3,0
Kern,16,2022-04-09,148,148,146,2,17196,17438,17145,293,20
Kings,16,2022-04-09,33,33,32,1,4206,4265,4179,86,3
Lake,16,2022-04-09,19,19,19,0,848,861,842,19,0
Lassen,16,2022-04-09,1,1,1,0,1301,1318,1298,20,1
Los Angeles,16,2022-04-09,6391,6481,6452,29,749590,760162,756725,3437,262
Madera,16,2022-04-09,29,29,28,1,3153,3198,3133,65,3
Marin,16,2022-04-09,190,191,188,3,5444,5521,5421,100,5
Mariposa,16,2022-04-09,7,7,7,0,245,249,244,5,0
Mendocino,16,2022-04-09,30,30,29,1,1152,1168,1135,33,0
Merced,16,2022-04-09,64,64,63,1,3305,3351,3292,59,10
Modoc,16,2022-04-09,1,1,1,0,50,50,49,1,0
Mono,16,2022-04-09,3,3,3,0,135,135,132,3,0
Monterey,16,2022-04-09,114,114,110,4,7161,7262,7033,229,12
Napa,16,2022-04-09,109,109,107,2,3082,3126,3075,51,2
Nevada,16,2022-04-09,34,34,33,1,1508,1529,1496,33,2
Orange,16,2022-04-09,1099,1114,1096,18,54172,54936,54046,890,79
Placer,16,2022-04-09,116,116,113,3,6221,6308,6163,145,23
Plumas,16,2022-04-09,5,5,5,0,260,264,258,6,0
Riverside,16,2022-04-09,726,736,721,15,37711,38243,37442,801,37
Sacramento,16,2022-04-09,493,499,491,8,31224,31663,31139,524,48
San Benito,16,2022-04-09,18,18,18,0,1186,1203,1187,16,0
San Bernardino,16,2022-04-09,815,827,817,10,41857,42447,41926,521,32
San Diego,16,2022-04-09,1819,1845,1835,10,73517,74553,74167,386,111
San Francisco,16,2022-04-09,1147,1162,1133,29,30147,30571,29818,753,27
San Joaquin,16,2022-04-09,233,236,232,4,15608,15827,15536,291,19
San Luis Obispo,16,2022-04-09,109,109,107,2,5010,5080,5007,73,2
San Mateo,16,2022-04-09,832,845,836,9,30505,30935,30598,337,6
Santa Barbara,16,2022-04-09,247,252,248,4,15188,15401,15146,255,9
Santa Clara,16,2022-04-09,1635,1658,1649,9,79310,80427,79998,429,89
Santa Cruz,16,2022-04-09,275,279,275,4,8149,8263,8156,107,6
Shasta,16,2022-04-09,19,19,19,0,3305,3352,3280,72,3
Siskiyou,16,2022-04-09,1,1,1,0,315,319,315,4,0
Solano,16,2022-04-09,227,230,226,4,9620,9754,9596,158,17
Sonoma,16,2022-04-09,403,410,403,7,10564,10712,10537,175,6
Stanislaus,16,2022-04-09,127,127,124,3,7865,7976,7770,206,21
Sutter,16,2022-04-09,23,23,23,0,1324,1343,1318,25,0
Tehama,16,2022-04-09,10,10,10,0,758,770,748,22,0
Trinity,16,2022-04-09,0,0,0,0,82,82,80,2,0
Tulare,16,2022-04-09,45,45,44,1,7907,8019,7804,215,7
Tuolumne,16,2022-04-09,16,16,16,0,1076,1091,1068,23,1
Ventura,16,2022-04-09,300,305,302,3,18063,18316,18125,191,20
Yolo,16,2022-04-09,97,97,96,1,18604,18867,18617,250,1
Yuba,16,2022-04-09,14,14,14,0,1074,1089,1071,18,4
Alameda,17,2022-04-16,1767,1796,1780,16,54507,55392,54895,497,41
Amador,17,2022-04-16,7,7,7,0,1135,1153,1135,18,2
Butte,17,2022-04-16,47,47,47,0,2047,2079,2063,16,5
Calaveras,17,2022-04-16,15,15,15,0,616,626,618,8,0
Colusa,17,2022-04-16,4,4,4,0,169,171,169,2,0
Contra Costa,17,2022-04-16,1007,1024,1010,14,24944,25350,24991,359,29
Del Norte,17,2022-04-16,12,12,12,0,1022,1036,1023,13,0
El Dorado,17,2022-04-16,59,59,58,1,2357,2395,2361,34,0
Fresno,17,2022-04-16,197,201,198,3,13920,14146,13929,217,48
Glenn,17,2022-04-16,3,3,3,0,237,241,238,3,0
Humboldt,17,2022-04-16,78,78,77,1,1974,2007,1982,25,6
Imperial,17,2022-04-16,41,41,40,1,3350,3405,3357,48,3
Inyo,17,2022-04-16,0,0,0,0,152,154,152,2,0
Kern,17,2022-04-16,130,130,128,2,13370,13587,13416,171,19
Kings,17,2022-04-16,38,38,37,1,3615,3674,3619,55,2
Lake,17,2022-04-16,19,19,19,0,815,829,815,14,2
Lassen,17,2022-04-16,2,2,2,0,1316,1338,1323,15,0
Los Angeles,17,2022-04-16,7545,7667,7641,26,370536,376542,375267,1275,213
Madera,17,2022-04-16,23,23,23,0,2603,2644,2604,40,3
Marin,17,2022-04-16,284,291,287,4,6106,6206,6122,84,5
Mariposa,17,2022-04-16,11,11,11,0,257,262,258,4,0
Mendocino,17,2022-04-16,42,42,41,1,1302,1323,1295,28,4
Merced,17,2022-04-16,73,73,72,1,3158,3211,3169,42,9
Modoc,17,2022-04-16,1,1,1,0,36,37,36,1,0
Mono,17,2022-04-16,13,13,13,0,170,172,169,3,0
Monterey,17,2022-04-16,130,130,127,3,6341,6443,6291,152,6
Napa,17,2022-04-16,141,141,139,2,2696,2739,2706,33,1
Nevada,17,2022-04-16,42,42,41,1,1240,1259,1238,21,2
Orange,17,2022-04-16,1341,1362,1345,17,82116,83446,82433,1013,67
Placer,17,2022-04-16,152,152,149,3,4701,4777,4695,82,25
Plumas,17,2022-04-16,7,7,7,0,209,213,209,4,0
Riverside,17,2022-04-16,845,858,845,13,37129,37731,37140,591,45
Sacramento,17,2022-04-16,666,677,669,8,27817,28269,27920,349,53
San Benito,17,2022-04-16,24,24,24,0,1181,1200,1188,12,0
San Bernardino,17,2022-04-16,1020,1036,1027,9,39253,39889,39522,367,43
San Diego,17,2022-04-16,1877,1907,1900,7,68401,69509,69239,270,96
San Francisco,17,2022-04-16,1327,1350,1325,25,30536,31034,30463,571,32
San Joaquin,17,2022-04-16,220,224,221,3,14846,15086,14879,207,13
San Luis Obispo,17,2022-04-16,138,140,139,1,4857,4936,4883,53,3
San Mateo,17,2022-04-16,1058,1075,1066,9,29929,30415,30169,246,11
Santa Barbara,17,2022-04-16,329,335,331,4,14849,15089,14902,187,8
Santa Clara,17,2022-04-16,2071,2104,2096,8,74210,75412,75111,301,74
Santa Cruz,17,2022-04-16,415,423,419,4,12638,12842,12715,127,4
Shasta,17,2022-04-16,27,27,27,0,2836,2883,2837,46,4
Siskiyou,17,2022-04-16,4,4,4,0,321,325,322,3,1
Solano,17,2022-04-16,236,240,237,3,9051,9197,9086,111,10
Sonoma,17,2022-04-16,482,491,485,6,11406,11591,11450,141,15
Stanislaus,17,2022-04-16,145,146,143,3,7857,7984,7830,154,19
Sutter,17,2022-04-16,20,20,20,0,1181,1200,1184,16,0
Tehama,17,2022-04-16,7,7,7,0,649,659,645,14,1
Trinity,17,2022-04-16,0,0,0,0,69,69,68,1,0
Tulare,17,2022-04-16,71,71,70,1,6823,6933,6793,140,13
Tuolumne,17,2022-04-16,26,26,26,0,1060,1077,1060,17,0
Ventura,17,2022-04-16,355,362,359,3,15788,16044,15919,125,9
Yolo,17,2022-04-16,111,111,110,1,18747,19052,18864,188,2
Yuba,17,2022-04-16,21,21,21,0,1004,1020,1007,13,1
Alameda,18,2022-04-23,2248,2291,2276,15,55663,56738,56360,378,53
Amador,18,2022-04-23,18,18,18,0,1320,1344,1328,16,0
Butte,18,2022-04-23,36,36,36,0,2188,2230,2217,13,9
Calaveras,18,2022-04-23,22,22,22,0,610,622,616,6,0
Colusa,18,2022-04-23,3,3,3,0,175,179,177,2,0
Contra Costa,18,2022-04-23,1357,1384,1369,15,25367,25857,25584,273,31
Del Norte,18,2022-04-23,18,18,18,0,1068,1088,1078,10,1
El Dorado,18,2022-04-23,99,99,98,1,2663,2715,2687,28,0
Fresno,18,2022-04-23,328,334,330,4,15699,16001,15818,183,36
Glenn,18,2022-04-23,4,4,4,0,254,259,257,2,0
Humboldt,18,2022-04-23,171,174,172,2,2755,2807,2781,26,4
Imperial,18,2022-04-23,53,53,52,1,3331,3395,3359,36,5
Inyo,18,2022-04-23,6,6,6,0,183,187,186,1,2
Kern,18,2022-04-23,218,223,221,2,16985,17311,17149,162,21
Kings,18,2022-04-23,54,54,53,1,4408,4492,4442,50,2
Lake,18,2022-04-23,15,15,15,0,794,809,799,10,2
Lassen,18,2022-04-23,0,0,0,0,1523,1552,1539,13,0
Los Angeles,18,2022-04-23,10672,10879,10852,27,854172,870637,868453,2184,218
Madera,18,2022-04-23,30,30,30,0,2828,2882,2849,33,2
Marin,18,2022-04-23,348,355,351,4,6080,6198,6136,62,9
Mariposa,18,2022-04-23,15,15,15,0,213,218,215,3,0
Mendocino,18,2022-04-23,64,64,63,1,1192,1215,1196,19,1
Merced,18,2022-04-23,85,85,84,1,2910,2967,2938,29,6
Modoc,18,2022-04-23,1,1,1,0,35,36,35,1,0
Mono,18,2022-04-23,4,4,4,0,88,88,87,1,0
Monterey,18,2022-04-23,253,258,253,5,7378,7519,7386,133,4
Napa,18,2022-04-23,203,207,205,2,3322,3386,3355,31,0
Nevada,18,2022-04-23,47,47,46,1,1345,1372,1355,17,3
Orange,18,2022-04-23,1816,1850,1833,17,83537,85150,84384,766,66
Placer,18,2022-04-23,204,209,206,3,5684,5794,5720,74,25
Plumas,18,2022-04-23,2,2,2,0,233,238,235,3,0
Riverside,18,2022-04-23,1183,1206,1192,14,38925,39674,39211,463,44
Sacramento,18,2022-04-23,930,948,939,9,30647,31238,30951,287,52
San Benito,18,2022-04-23,33,33,33,0,1134,1157,1148,9,0
San Bernardino,18,2022-04-23,1279,1303,1294,9,41834,42640,42349,291,31
San Diego,18,2022-04-23,2718,2773,2765,8,72270,73664,73452,212,97
San Francisco,18,2022-04-23,1823,1858,1832,26,31010,31610,31175,435,32
San Joaquin,18,2022-04-23,352,359,355,4,15213,15505,15346,159,13
San Luis Obispo,18,2022-04-23,190,194,192,2,4985,5081,5041,40,5
San Mateo,18,2022-04-23,1384,1410,1402,8,31626,32235,32040,195,19
Santa Barbara,18,2022-04-23,350,357,354,3,14658,14940,14802,138,7
Santa Clara,18,2022-04-23,2816,2869,2861,8,68850,70178,69971,207,83
Santa Cruz,18,2022-04-23,456,464,461,3,19434,19809,19667,142,2
Shasta,18,2022-04-23,50,50,49,1,3053,3112,3075,37,0
Siskiyou,18,2022-04-23,8,8,8,0,325,330,327,3,0
Solano,18,2022-04-23,403,410,406,4,10090,10285,10193,92,11
Sonoma,18,2022-04-23,623,635,629,6,11566,11788,11681,107,18
Stanislaus,18,2022-04-23,203,208,205,3,7440,7583,7474,109,21
Sutter,18,2022-04-23,33,33,33,0,1307,1332,1318,14,0
Tehama,18,2022-04-23,15,15,15,0,658,670,659,11,1
Trinity,18,2022-04-23,2,2,2,0,77,77,76,1,0
Tulare,18,2022-04-23,81,81,80,1,6943,7077,6971,106,12
Tuolumne,18,2022-04-23,34,34,34,0,1105,1126,1113,13,1
Ventura,18,2022-04-23,554,566,563,3,18596,18955,18845,110,16
Yolo,18,2022-04-23,182,186,185,1,18476,18833,18695,138,0
Yuba,18,2022-04-23,34,34,34,0,1084,1104,1094,10,1
Alameda,19,2022-04-30,3054,3128,3112,16,69130,70807,70453,354,43
Amador,19,2022-04-30,32,32,32,0,1344,1377,1365,12,0
Butte,19,2022-04-30,88,88,88,0,2283,2338,2328,10,4
Calaveras,19,2022-04-30,32,32,32,0,736,753,747,6,0
Colusa,19,2022-04-30,4,4,4,0,219,223,221,2,0
Contra Costa,19,2022-04-30,1684,1725,1711,14,28699,29394,29162,232,42
Del Norte,19,2022-04-30,37,37,37,0,1205,1236,1228,8,0
El Dorado,19,2022-04-30,115,118,117,1,2747,2814,2792,22,3
Fresno,19,2022-04-30,456,468,464,4,16950,17361,17213,148,39
Glenn,19,2022-04-30,4,4,4,0,244,251,249,2,0
Humboldt,19,2022-04-30,203,209,208,1,2906,2976,2955,21,7
Imperial,19,2022-04-30,111,112,111,1,3685,3774,3744,30,2
Inyo,19,2022-04-30,5,5,5,0,207,212,211,1,0
Kern,19,2022-04-30,278,285,283,2,17905,18338,18209,129,15
Kings,19,2022-04-30,45,45,45,0,4735,4850,4809,41,3
Lake,19,2022-04-30,28,28,28,0,1022,1046,1036,10,1
Lassen,19,2022-04-30,9,9,9,0,1606,1647,1637,10,0
Los Angeles,19,2022-04-30,13617,13950,13924,26,915271,937460,935704,1756,226
Madera,19,2022-04-30,67,67,66,1,3225,3303,3275,28,3
Marin,19,2022-04-30,380,389,386,3,6386,6541,6492,49,9
Mariposa,19,2022-04-30,7,7,7,0,239,245,243,2,0
Mendocino,19,2022-04-30,48,48,47,1,1255,1286,1271,15,0
Merced,19,2022-04-30,116,118,117,1,3248,3327,3303,24,6
Modoc,19,2022-04-30,0,0,0,0,44,45,44,1,0
Mono,19,2022-04-30,4,4,4,0,81,81,80,1,0
Monterey,19,2022-04-30,326,333,329,4,8330,8531,8418,113,8
Napa,19,2022-04-30,215,221,219,2,3492,3577,3553,24,5
Nevada,19,2022-04-30,69,69,68,1,1505,1542,1528,14,2
Orange,19,2022-04-30,2440,2499,2482,17,87492,89616,89012,604,83
Placer,19,2022-04-30,263,270,267,3,6278,6429,6367,62,27
Plumas,19,2022-04-30,7,7,7,0,253,259,256,3,0
Riverside,19,2022-04-30,1750,1792,1777,15,41880,42897,42523,374,41
Sacramento,19,2022-04-30,1232,1263,1254,9,32551,33343,33114,229,51
San Benito,19,2022-04-30,44,44,44,0,1203,1233,1226,7,0
San Bernardino,19,2022-04-30,1336,1367,1360,7,42556,43588,43366,222,37
San Diego,19,2022-04-30,3709,3800,3792,8,71313,73041,72884,157,97
San Francisco,19,2022-04-30,2282,2337,2313,24,35024,35876,35507,369,44
San Joaquin,19,2022-04-30,474,487,483,4,15170,15534,15415,119,17
San Luis Obispo,19,2022-04-30,254,260,258,2,5146,5270,5239,31,9
San Mateo,19,2022-04-30,1677,1717,1709,8,36018,36890,36724,166,20
Santa Barbara,19,2022-04-30,387,396,393,3,15586,15964,15854,110,9
Santa Clara,19,2022-04-30,3866,3959,3950,9,95253,97563,97348,215,86
Santa Cruz,19,2022-04-30,634,650,647,3,22264,22805,22683,122,3
Shasta,19,2022-04-30,59,59,58,1,3420,3501,3470,31,7
Siskiyou,19,2022-04-30,11,11,11,0,321,328,326,2,0
Solano,19,2022-04-30,571,586,582,4,11360,11636,11558,78,14
Sonoma,19,2022-04-30,761,779,774,5,12392,12693,12607,86,19
Stanislaus,19,2022-04-30,275,282,279,3,8274,8473,8381,92,20
Sutter,19,2022-04-30,49,49,49,0,1277,1307,1297,10,0
Tehama,19,2022-04-30,17,17,17,0,676,693,685,8,0
Trinity,19,2022-04-30,1,1,1,0,84,84,83,1,0
Tulare,19,2022-04-30,137,141,139,2,7123,7294,7212,82,10
Tuolumne,19,2022-04-30,81,81,80,1,1234,1264,1253,11,5
Ventura,19,2022-04-30,656,673,670,3,19435,19904,19818,86,16
Yolo,19,2022-04-30,240,247,246,1,19182,19650,19542,108,2
Yuba,19,2022-04-30,36,36,36,0,1041,1067,1060,7,2
Alameda,20,2022-05-07,3912,4044,4029,15,70023,72355,72087,268,68
Amador,20,2022-05-07,12,12,12,0,1400,1447,1438,9,0
Butte,20,2022-05-07,116,121,121,0,2380,2459,2451,8,4
Calaveras,20,2022-05-07,26,26,26,0,692,716,712,4,1
Colusa,20,2022-05-07,3,3,3,0,216,223,222,1,0
Contra Costa,20,2022-05-07,2317,2394,2380,14,30546,31562,31376,186,50
Del Norte,20,2022-05-07,42,42,42,0,1226,1266,1260,6,0
El Dorado,20,2022-05-07,166,172,171,1,2813,2906,2889,17,4
Fresno,20,2022-05-07,654,676,672,4,17837,18430,18313,117,32
Glenn,20,2022-05-07,6,6,6,0,229,237,236,1,0
Humboldt,20,2022-05-07,297,306,304,2,3267,3376,3358,18,4
Imperial,20,2022-05-07,109,112,111,1,3751,3875,3852,23,1
Inyo,20,2022-05-07,18,18,18,0,200,206,205,1,0
Kern,20,2022-05-07,421,436,434,2,18495,19109,19009,100,23
Kings,20,2022-05-07,89,92,91,1,4932,5095,5063,32,2
Lake,20,2022-05-07,30,30,30,0,1007,1041,1034,7,1
Lassen,20,2022-05-07,2,2,2,0,1681,1736,1728,8,0
Los Angeles,20,2022-05-07,17169,17743,17718,25,907300,937396,936091,1305,248
Madera,20,2022-05-07,130,136,135,1,3754,3879,3855,24,3
Marin,20,2022-05-07,631,652,648,4,7591,7845,7801,44,12
Mariposa,20,2022-05-07,25,25,25,0,271,280,278,2,0
Mendocino,20,2022-05-07,88,90,89,1,1234,1274,1263,11,1
Merced,20,2022-05-07,177,183,182,1,3419,3533,3514,19,5
Modoc,20,2022-05-07,2,2,2,0,38,39,38,1,0
Mono,20,2022-05-07,10,10,10,0,126,130,129,1,0
Monterey,20,2022-05-07,437,452,448,4,9203,9507,9413,94,8
Napa,20,2022-05-07,225,232,231,1,3250,3359,3342,17,2
Nevada,20,2022-05-07,99,102,101,1,1635,1690,1679,11,3
Orange,20,2022-05-07,3321,3432,3415,17,90672,93689,93219,470,108
Placer,20,2022-05-07,459,474,471,3,6697,6918,6869,49,27
Plumas,20,2022-05-07,12,12,12,0,275,284,282,2,0
Riverside,20,2022-05-07,2337,2415,2399,16,44885,46375,46073,302,43
Sacramento,20,2022-05-07,1958,2023,2013,10,36274,37482,37290,192,70
San Benito,20,2022-05-07,62,62,62,0,1433,1479,1473,6,0
San Bernardino,20,2022-05-07,1751,1811,1804,7,45164,46664,46487,177,38
San Diego,20,2022-05-07,4879,5043,5035,8,85699,88545,88404,141,94
San Francisco,20,2022-05-07,2816,2910,2888,22,37411,38658,38361,297,52
San Joaquin,20,2022-05-07,671,694,690,4,15781,16304,16212,92,14
San Luis Obispo,20,2022-05-07,286,295,294,1,5191,5364,5340,24,2
San Mateo,20,2022-05-07,2127,2197,2190,7,36731,37950,37823,127,27
Santa Barbara,20,2022-05-07,579,599,596,3,15274,15780,15699,81,14
Santa Clara,20,2022-05-07,5384,5563,5554,9,102383,105778,105605,173,110
Santa Cruz,20,2022-05-07,692,716,713,3,23025,23791,23697,94,5
Shasta,20,2022-05-07,91,95,94,1,3455,3567,3543,24,7
Siskiyou,20,2022-05-07,13,13,13,0,292,302,301,1,0
Solano,20,2022-05-07,806,833,829,4,12175,12581,12518,63,19
Sonoma,20,2022-05-07,1143,1182,1176,6,13908,14370,14297,73,23
Stanislaus,20,2022-05-07,382,395,392,3,8631,8915,8843,72,27
Sutter,20,2022-05-07,45,45,45,0,1523,1573,1564,9,0
Tehama,20,2022-05-07,26,26,26,0,692,716,710,6,1
Trinity,20,2022-05-07,2,2,2,0,68,68,67,1,0
Tulare,20,2022-05-07,172,179,178,1,7581,7831,7765,66,12
Tuolumne,20,2022-05-07,80,82,81,1,1329,1373,1364,9,1
Ventura,20,2022-05-07,1044,1080,1077,3,20817,21508,21439,69,16
Yolo,20,2022-05-07,325,336,335,1,19398,20049,19967,82,1
Yuba,20,2022-05-07,63,63,63,0,1210,1250,1244,6,2
Alameda,21,2022-05-14,4543,4808,4795,13,73910,78187,77971,216,69
Amador,21,2022-05-14,45,48,48,0,1680,1778,1769,9,1
Butte,21,2022-05-14,157,165,165,0,2555,2701,2695,6,6
Calaveras,21,2022-05-14,30,30,30,0,745,788,785,3,2
Colusa,21,2022-05-14,4,4,4,0,201,212,211,1,0
Contra Costa,21,2022-05-14,2940,3115,3101,14,32112,33970,33821,149,55
Del Norte,21,2022-05-14,110,116,116,0,1743,1844,1837,7,0
El Dorado,21,2022-05-14,218,232,231,1,3002,3175,3161,14,6
Fresno,21,2022-05-14,917,971,966,5,18413,19485,19393,92,44
Glenn,21,2022-05-14,11,11,11,0,243,255,254,1,0
Humboldt,21,2022-05-14,268,283,282,1,3196,3380,3367,13,10
Imperial,21,2022-05-14,191,202,201,1,4183,4423,4404,19,4
Inyo,21,2022-05-14,20,20,20,0,225,238,237,1,1
Kern,21,2022-05-14,546,577,575,2,19426,20545,20465,80,20
Kings,21,2022-05-14,161,171,170,1,5245,5546,5520,26,0
Lake,21,2022-05-14,53,55,55,0,1118,1182,1176,6,0
Lassen,21,2022-05-14,14,14,14,0,1683,1778,1772,6,0
Los Angeles,21,2022-05-14,18744,19834,19813,21,917778,970363,969357,1006,318
Madera,21,2022-05-14,163,173,172,1,3586,3794,3776,18,3
Marin,21,2022-05-14,703,745,742,3,8054,8523,8487,36,11
Mariposa,21,2022-05-14,27,27,27,0,349,370,368,2,0
Mendocino,21,2022-05-14,88,94,93,1,1321,1398,1389,9,2
Merced,21,2022-05-14,255,270,269,1,3802,4023,4007,16,8
Modoc,21,2022-05-14,1,1,1,0,39,41,40,1,0
Mono,21,2022-05-14,9,9,9,0,116,124,123,1,0
Monterey,21,2022-05-14,475,502,498,4,9394,9925,9852,73,10
Napa,21,2022-05-14,285,301,300,1,3493,3699,3685,14,3
Nevada,21,2022-05-14,126,133,132,1,1832,1939,1929,10,3
Orange,21,2022-05-14,4047,4286,4270,16,92983,98376,98009,367,88
Placer,21,2022-05-14,606,642,639,3,7334,7758,7717,41,37
Plumas,21,2022-05-14,41,43,43,0,256,271,270,1,1
Riverside,21,2022-05-14,2829,2997,2983,14,46090,48749,48513,236,59
Sacramento,21,2022-05-14,2724,2886,2875,11,38161,40378,40225,153,71
San Benito,21,2022-05-14,101,106,106,0,1522,1610,1605,5,3
San Bernardino,21,2022-05-14,2154,2280,2274,6,46721,49422,49282,140,47
San Diego,21,2022-05-14,5914,6261,6254,7,91421,96709,96594,115,111
San Francisco,21,2022-05-14,3250,3437,3417,20,38700,40930,40695,235,63
San Joaquin,21,2022-05-14,1082,1146,1141,5,17879,18906,18826,80,12
San Luis Obispo,21,2022-05-14,346,367,366,1,5761,6090,6070,20,2
San Mateo,21,2022-05-14,2594,2745,2738,7,39367,41642,41538,104,37
Santa Barbara,21,2022-05-14,771,814,811,3,16379,17323,17257,66,10
Santa Clara,21,2022-05-14,6515,6897,6889,8,109460,115753,115612,141,124
Santa Cruz,21,2022-05-14,883,934,931,3,24844,26280,26202,78,4
Shasta,21,2022-05-14,113,119,118,1,3702,3912,3893,19,6
Siskiyou,21,2022-05-14,17,17,17,0,383,405,404,1,1
Solano,21,2022-05-14,1082,1147,1143,4,13271,14044,13992,52,24
Sonoma,21,2022-05-14,1418,1502,1496,6,15188,16066,16006,60,23
Stanislaus,21,2022-05-14,631,668,664,4,9644,10194,10133,61,35
Sutter,21,2022-05-14,99,105,105,0,1750,1850,1842,8,0
Tehama,21,2022-05-14,20,20,20,0,796,843,837,6,2
Trinity,21,2022-05-14,4,4,4,0,68,73,72,1,0
Tulare,21,2022-05-14,280,296,294,2,7826,8271,8219,52,11
Tuolumne,21,2022-05-14,93,98,98,0,1438,1519,1512,7,2
Ventura,21,2022-05-14,1331,1411,1408,3,22799,24119,24061,58,25
Yolo,21,2022-05-14,453,480,479,1,21364,22620,22552,68,2
Yuba,21,2022-05-14,104,109,109,0,1247,1320,1315,5,2
Alameda,22,2022-05-21,4775,6932,6917,15,71549,100397,100180,217,92
Amador,22,2022-05-21,39,52,52,0,1492,2057,2049,8,0
Butte,22,2022-05-21,240,322,321,1,2606,3603,3596,7,7
Calaveras,22,2022-05-21,46,60,60,0,739,1036,1033,3,0
Colusa,22,2022-05-21,5,8,8,0,215,295,294,1,0
Contra Costa,22,2022-05-21,3201,4484,4469,15,32829,46622,46462,160,76
Del Norte,22,2022-05-21,120,143,143,0,1477,1976,1970,6,0
El Dorado,22,2022-05-21,263,390,389,1,3084,4375,4360,15,4
Fresno,22,2022-05-21,1299,1892,1885,7,19378,28172,28068,104,66
Glenn,22,2022-05-21,15,20,20,0,262,342,341,1,0
Humboldt,22,2022-05-21,195,269,268,1,2617,3690,3679,11,13
Imperial,22,2022-05-21,232,334,333,1,4278,5930,5910,20,4
Inyo,22,2022-05-21,22,32,32,0,231,329,328,1,0
Kern,22,2022-05-21,695,970,967,3,18679,25582,25504,78,39
Kings,22,2022-05-21,229,322,321,1,5335,7392,7365,27,0
Lake,22,2022-05-21,63,93,93,0,1175,1709,1702,7,0
Lassen,22,2022-05-21,32,46,46,0,1630,2194,2188,6,0
Los Angeles,22,2022-05-21,20993,29549,29525,24,403929,474443,474055,388,385
Madera,22,2022-05-21,169,246,245,1,3502,5025,5007,18,2
Marin,22,2022-05-21,714,1013,1010,3,8347,12150,12110,40,16
Mariposa,22,2022-05-21,24,39,39,0,309,469,467,2,0
Mendocino,22,2022-05-21,101,141,140,1,1534,2279,2267,12,5
Merced,22,2022-05-21,322,438,437,1,3806,5298,5281,17,3
Modoc,22,2022-05-21,2,2,2,0,35,50,49,1,0
Mono,22,2022-05-21,11,21,21,0,137,204,203,1,0
Monterey,22,2022-05-21,480,678,674,4,9181,12762,12689,73,11
Napa,22,2022-05-21,229,347,346,1,3745,5390,5374,16,5
Nevada,22,2022-05-21,125,185,184,1,1718,2437,2427,10,1
Orange,22,2022-05-21,4528,6415,6396,19,88673,123686,123325,361,112
Placer,22,2022-05-21,707,992,988,4,7486,10463,10420,43,39
Plumas,22,2022-05-21,22,28,28,0,253,346,345,1,0
Riverside,22,2022-05-21,3379,4932,4913,19,46394,65169,64922,247,79
Sacramento,22,2022-05-21,3149,4474,4461,13,37540,52363,52207,156,116
San Benito,22,2022-05-21,143,214,213,1,1514,2175,2170,5,0
San Bernardino,22,2022-05-21,2325,3281,3274,7,44153,61225,61090,135,51
San Diego,22,2022-05-21,7597,10873,10863,10,94238,132428,132305,123,142
San Francisco,22,2022-05-21,3152,4510,4490,20,39499,56617,56363,254,94
San Joaquin,22,2022-05-21,1209,1702,1696,6,19215,26522,26435,87,26
San Luis Obispo,22,2022-05-21,511,707,705,2,6463,8993,8970,23,11
San Mateo,22,2022-05-21,2577,3687,3680,7,37941,52986,52883,103,47
Santa Barbara,22,2022-05-21,936,1342,1338,4,17577,24867,24793,74,20
Santa Clara,22,2022-05-21,6580,9636,9627,9,106655,148919,148777,142,129
Santa Cruz,22,2022-05-21,412,598,597,1,7680,10726,10701,25,13
Shasta,22,2022-05-21,145,185,184,1,3105,3991,3976,15,7
Siskiyou,22,2022-05-21,14,22,22,0,299,423,422,1,1
Solano,22,2022-05-21,1300,1841,1836,5,13367,18882,18827,55,27
Sonoma,22,2022-05-21,1303,1800,1795,5,14891,21116,21054,62,36
Stanislaus,22,2022-05-21,718,1027,1022,5,9781,13638,13575,63,42
Sutter,22,2022-05-21,128,209,208,1,1700,2449,2441,8,0
Tehama,22,2022-05-21,49,61,61,0,650,851,847,4,1
Trinity,22,2022-05-21,3,3,3,0,70,92,91,1,0
Tulare,22,2022-05-21,412,595,592,3,8360,11302,11247,55,22
Tuolumne,22,2022-05-21,129,188,187,1,1526,2201,2193,8,1
Ventura,22,2022-05-21,1501,2131,2127,4,22385,31885,31825,60,36
Yolo,22,2022-05-21,471,695,693,2,21600,31623,31548,75,2
Yuba,22,2022-05-21,137,200,199,1,1357,1963,1957,6,6
